,name,age,anual_salary,credit_card_number,credit_score,credit_limitation,transaction_status,partial_payment,credit_balance
0,Kylian Mbappé,30,2243900,4469166045790095,187,2885378,2035231,204,2035027
1,Erling Haaland,62,4015200,4404181833044165,496,7399452,6869268,0,6869268
2,Kevin De Bruyne,53,1612000,6256117018495183,313,3700709,888126,88813,799313
3,Lionel Messi,37,4509500,5910104057399827,424,6946687,5897568,58976,5838592
4,Karim Benzema,66,2194200,6706387783382719,470,5629187,3882799,389,3882410
5,Thibaut Courtois,46,778600,4787153470899439,216,2122116,808174,80818,727356
6,Harry Kane,39,660900,3309827474045573,179,1728661,1417412,142,1417270
7,Robert Lewandowski,35,1248500,8179186252892675,218,2353561,51457,515,50942
8,Mohamed Salah,58,3669700,7356971747235309,499,6641689,1102013,1103,1100910
9,Rúben Dias,52,985900,6074522592072106,257,2555206,437250,43725,393525
10,Vini Jr.,33,1339600,4850363064109935,197,2338389,766488,0,766488
11,Rodri,22,1293300,6472706999655031,114,1592281,34157,3416,30741
12,Neymar Jr,57,506200,8903623748396646,230,1853334,775102,0,775102
13,Marc-André ter Stegen,38,1356600,4592252075794159,178,2022687,486377,486377,0
14,Virgil van Dijk,44,3749800,9681383841937155,468,6728934,2396232,240,2395992
15,Alisson,67,2821100,5625667940121976,503,6202994,567920,567920,0
16,Casemiro,62,435500,4842500122570170,267,2150726,1592608,159261,1433347
17,Bruno Fernandes,59,2834500,7071928943480212,418,5371557,3088577,30886,3057691
18,Antoine Griezmann,61,3549700,3104624080046870,524,7264401,1101444,110145,991299
19,Victor Osimhen,52,4720400,8107955175422572,540,8487842,1004022,0,1004022
20,Bernardo Silva,26,609800,9604986909904369,76,747858,465386,46539,418847
21,Federico Valverde,33,3137400,9653428140618461,341,5071544,4699058,0,4699058
22,Ederson,58,1551800,5926121122865864,317,3597726,1612356,16124,1596232
23,Joshua Kimmich,50,1847200,9661748821217834,347,4055123,3378824,338,3378486
24,Jan Oblak,53,414500,6874838598199182,228,1871947,1781191,17812,1763379
25,Luka Modrić,23,318400,5206851397555333,52,349120,330025,3301,326724
26,Frenkie de Jong,40,4178900,6134404096285743,460,6619728,895553,0,895553
27,Lautaro Martínez,69,4006400,7295053650858080,572,8006395,7777165,0,7777165
28,Martin Ødegaard,63,3419800,7686553692321262,552,6632363,2336641,234,2336407
29,Mike Maignan,23,3601300,5785759953654015,296,4686816,3498784,34988,3463796
30,Marquinhos,61,518700,6038002463951014,234,1996604,807862,807862,0
31,Gregor Kobel,62,1500200,9310862430401953,350,3832334,110950,11095,99855
32,Heung Min Son,31,1654000,5214080867545928,158,2480892,1379501,1379501,0
33,Gianluigi Donnarumma,65,437000,4696258587314764,307,2570592,1089965,1089965,0
34,Manuel Neuer,27,510800,8004271703319746,55,534868,94832,949,93883
35,Ousmane Dembélé,65,2960200,9322954507793163,481,5840082,4311281,432,4310849
36,Bukayo Saka,63,981400,3641695356184924,342,3055959,1058006,106,1057900
37,Jude Bellingham,27,4296700,9077123561412954,398,5992833,3676360,0,3676360
38,Rafael Leão,52,1575600,4684242947662942,310,3412509,1294242,0,1294242
39,Pedri,70,1802400,5032788964441985,432,4560585,3998427,0,3998427
40,Matthijs de Ligt,29,1289500,4480948276787532,130,1741415,971667,972,970695
41,Sandro Tonali,70,3438300,5353460932801747,595,7436740,1829923,182993,1646930
42,Riyad Mahrez,45,3761100,7324391010748963,433,6047272,5275225,527523,4747702
43,Jamal Musiala,33,2543400,7334107846522814,280,4263444,2798703,279871,2518832
44,Nicolò Barella,48,712900,7545894092175135,189,1790272,475616,0,475616
45,Ronald Araujo,42,2364100,8797829575407273,311,4154506,2872201,2873,2869328
46,Paulo Dybala,69,2199100,4000480226083459,426,4643470,2951354,295136,2656218
47,İlkay Gündoğan,67,1656600,4288716083619315,414,4701764,4400930,4401,4396529
48,Sergej Milinković-Savić,44,1500400,6709762089548023,281,3311206,1338612,13387,1325225
49,Khvicha Kvaratskhelia,33,633200,3591363299119560,105,1076951,710017,710017,0
50,Andrew Robertson,62,3084500,7643785360768179,482,6183602,4829841,483,4829358
51,Parejo,53,3362900,4123460493977796,484,6575588,2054688,20547,2034141
52,Sadio Mané,52,370700,3508006473351870,200,1585678,266838,26684,240154
53,Toni Kroos,22,2527700,4293937177692182,192,3486533,213587,0,213587
54,Éder Militão,32,1647700,9375034120414086,160,2298026,2227698,223,2227475
55,Christopher Nkunku,64,4424100,3230663375275804,641,8962682,3370985,33710,3337275
56,N'Golo Kanté,31,4078000,9732990846383215,408,6402546,4058233,0,4058233
57,João Cancelo,51,3329200,6299259404062433,453,6178721,1625866,16259,1609607
58,Cristiano Ronaldo,33,3214700,4215159387556238,361,5269894,4971512,498,4971014
59,Trent Alexander-Arnold,35,4374200,7948510010414761,383,6087523,654855,6549,648306
60,Wojciech Szczęsny,23,3785400,3065334220640214,304,5102061,1223288,0,1223288
61,Jack Grealish,67,1181700,3539375590444341,349,3521286,10174,10174,0
62,Marcos Acuña,55,3701000,5927555392210663,492,6709302,6260520,6260520,0
63,David Alaba,36,2832900,9843343211100033,345,4800779,2126049,212605,1913444
64,Iago Aspas,55,3544900,5977773189004553,457,6712809,6041689,6042,6035647
65,Alessandro Bastoni,38,4209100,9852500212876457,428,6648746,4715874,0,4715874
66,Domenico Berardi,65,3253200,5480001129338880,495,6015460,1227703,1227703,0
67,Yassine Bounou,61,4634000,9787271568083272,611,8562039,6431111,643112,5787999
68,Hakan Çalhanoğlu,43,1183200,8185348693456232,220,2513169,924456,925,923531
69,Kingsley Coman,63,4788900,4740420671631355,698,9799811,4632514,0,4632514
70,Giovanni Di Lorenzo,45,665000,7750247246800818,196,1843548,1504627,151,1504476
71,Phil Foden,51,4544900,4644264576049228,504,7506313,3203402,321,3203081
72,Leon Goretzka,56,2418700,7551459417373232,380,5009587,3169534,3170,3166364
73,Theo Hernández,51,1998500,3274292067393454,336,4059578,267035,0,267035
74,Ciro Immobile,43,848800,7256250042391471,171,1856731,854967,0,854967
75,Jules Koundé,70,427700,4893319988888596,261,2067156,194597,0,194597
76,Aymeric Laporte,69,4532400,5459713544933093,662,9113667,6513353,0,6513353
77,Emiliano Martínez,28,1641200,8038849019652147,186,2342559,1645450,16455,1628995
78,Keylor Navas,52,2928300,5334310175989426,380,5093420,4047305,0,4047305
79,André Onana,34,959500,4458476644991970,153,1646127,1285401,129,1285272
80,Thomas Partey,44,2337000,8040596603009564,309,4008668,3097594,0,3097594
81,Marcus Rashford,35,2247700,9775902334583956,246,3575400,254091,25410,228681
82,Declan Rice,37,4984700,6765369114539968,450,7853143,217169,0,217169
83,Antonio Rüdiger,37,2779100,5655658228563070,333,4638698,4487754,0,4487754
84,Rodrygo,37,1500000,3588860656754098,204,2691122,1701087,1701087,0
85,John Stones,62,1597400,3975124157514517,392,4280262,576155,57616,518539
86,Diogo Jota,69,2236500,3596795839897221,496,5875550,5121690,0,5121690
87,Kevin Trapp,34,1204300,4190278801192156,198,2203032,1661984,1662,1660322
88,Kieran Trippier,29,2818600,7554578949934156,247,3913536,327427,327427,0
89,Raphaël Varane,66,3857500,5497389465722712,648,8020916,253259,2533,250726
90,Florian Wirtz,23,4966100,4871215404604145,442,7606013,740191,0,740191
91,Thiago,51,2023300,5675887067017500,375,4478886,1542883,15429,1527454
92,Ismaël Bennacer,61,4464900,6059954258902749,619,8210481,6293733,6293733,0
93,Julian Brandt,40,1547000,6101826912225187,232,2739338,1669452,0,1669452
94,Yannick Carrasco,57,646900,9906797474890459,276,2280976,613594,0,613594
95,Koen Casteels,28,4821700,5909409931066884,385,6932981,4258771,4258771,0
96,Federico Chiesa,61,706400,9917568885615037,320,3011629,1169580,0,1169580
97,Thiago Silva,56,3230400,4743399388018140,442,5528659,3077239,307724,2769515
98,Rúben Neves,62,3371900,6856432136717350,457,6097426,5178828,5179,5173649
99,Rodrigo Javier De Paul,32,2805500,5504980940530573,265,4478803,4033373,4033373,0
100,Memphis Depay,37,550500,3121181552079423,144,1323340,342439,3425,339014
101,Moussa Diaby,26,2650600,7690766530492519,234,3639715,2231976,22320,2209656
102,Raphinha,47,1982200,3411228813976767,321,3666342,306093,306093,0
103,Luis Díaz,59,3911400,7495320678001480,512,6783747,2945716,0,2945716
104,Gabriel,30,2241800,7480376597002510,268,3611947,2110030,21101,2088929
105,Gabriel Jesus,46,1857100,6097800913942165,316,3599479,2550064,2551,2547513
106,Matthias Ginter,48,1669600,6668745751433090,271,3347383,756962,756962,0
107,Serge Gnabry,65,3379400,9120941117499510,580,6709932,1470992,148,1470844
108,Grimaldo,46,2869400,3126872035217040,346,4892271,929595,0,929595
109,Bruno Guimarães,49,1343600,5647440484707583,248,2870287,1342571,1343,1341228
110,Péter Gulácsi,64,4192100,7866798601048780,595,7540350,3708896,3709,3705187
111,Achraf Hakimi,49,1993500,7412070651190971,323,3899705,958749,0,958749
112,Fabinho,67,480700,9538324661594912,318,2698150,1328646,132865,1195781
113,Lucas Hernández,27,1981500,7019460175793459,205,2840604,470978,0,470978
114,Pierre-Emile Højbjerg,57,2834800,6756337933817645,462,5979087,5970313,0,5970313
115,Reece James,61,4413000,6586572953159834,611,8812285,1197708,1198,1196510
116,Kim Min Jae,51,1157300,5368023533629158,249,2758046,631864,632,631232
117,Randal Kolo Muani,36,4792700,4311993347219551,429,7468858,6701062,670107,6030955
118,Kalidou Koulibaly,31,801300,8372848506531735,128,1358193,268301,26831,241470
119,Marcos Llorente,69,4237000,4672533956633425,692,8543303,7890352,78904,7811448
120,Stanislav Lobotka,25,3047600,6566361521566595,280,4668556,3941448,395,3941053
121,Romelu Lukaku,53,4229900,8008340663426626,511,7529554,3234455,0,3234455
122,James Maddison,46,4064700,6778992522520341,447,6925687,4263909,427,4263482
123,Gabriel Martinelli,43,346900,4493584980278727,174,1348315,331044,0,331044
124,Lisandro Martínez,40,3065200,6194124122954928,369,5273530,270895,27090,243805
125,Mikel Merino,22,4332000,6056446195918659,370,5959491,1240765,1241,1239524
126,Thomas Müller,66,4561400,4996100581004733,629,9203174,3713540,0,3713540
127,Nick Pope,59,2108900,6244212744445499,352,4108905,3039408,0,3039408
128,Adrien Rabiot,46,2025800,7488463897225262,323,4103093,646361,0,646361
129,Aaron Ramsdale,69,811500,5306504597683042,326,3202158,2184802,0,2184802
130,Álex Remiro,59,463500,4408409964217568,282,2178240,1767879,0,1767879
131,Koke,33,3002600,3753754937639017,300,4533560,3184644,0,3184644
132,Luis Alberto,32,2288900,4255349079407018,224,3117435,1276682,12767,1263915
133,Leroy Sané,63,4119600,6799395319755296,581,8248750,3774943,3774943,0
134,Bremer,50,485200,7564527921966199,215,1919341,1183820,1183820,0
135,Milan Škriniar,49,4524400,5791642491028754,549,7714186,1882493,189,1882304
136,Chris Smalling,61,4031100,9097949231193121,508,6982570,4422526,4422526,0
137,Yann Sommer,56,3167200,9143186860114399,439,5356300,3938493,0,3938493
138,Niklas Süle,48,3476000,4819163157070060,490,6616092,2660510,266051,2394459
139,Aurélien Tchouaméni,22,4992500,4372859451078278,368,7142349,2262109,22622,2239487
140,Fikayo Tomori,38,4578200,5321479560722300,418,6924484,4357607,4358,4353249
141,Kyle Walker,22,4990400,8394666741321770,378,7237723,6260275,6261,6254014
142,Francesco Acerbi,28,1698200,9520450129466275,186,2632179,1563649,1564,1562085
143,Jordi Alba,35,1325400,4491453732743654,216,2673353,2580627,259,2580368
144,Marco Asensio,50,2953600,3633687395851402,367,5210151,4078575,0,4078575
145,Wissam Ben Yedder,30,1730400,6849290807501100,168,2308563,625415,0,625415
146,Sven Botman,41,3468500,9478430408824799,396,6024333,4571719,4571719,0
147,Marcelo Brozović,30,1516700,9558131807776463,168,2426260,2390809,239081,2151728
148,Sergio Busquets,46,2708800,8889214918714613,325,4749703,2838573,0,2838573
149,Emre Can,26,1902100,8886370981808394,212,2870670,2407174,241,2406933
150,Andreas Christensen,24,2848900,8111867376112832,209,3859662,2914613,0,2914613
151,Sergi Darder,40,2345700,3007883527857917,299,4146993,309629,309629,0
152,Alphonso Davies,50,2918200,9626281718962923,345,5045735,569731,0,569731
153,Ángel Di María,47,1894300,4173530170970631,323,3843741,842610,843,841767
154,Edin Džeko,65,4127600,7474031206094167,520,7694013,4220529,422053,3798476
155,Christian Eriksen,53,2442900,9111185250798521,389,4919021,2687265,0,2687265
156,Nabil Fekir,28,747900,9272769654310301,77,927501,120040,121,119919
157,Enzo Fernández,24,768900,6418790956960730,85,1016703,52000,5200,46800
158,Nacho Fernández,67,2363200,5478059507490972,463,4910126,701470,7015,694455
159,Rafa,55,2764500,9123237396463327,454,5440156,5079760,0,5079760
160,Jorginho,54,2917100,3948898510626386,404,5613986,1593195,1593195,0
161,Pau Torres,26,4458300,6566872300157359,339,5778086,339923,0,339923
162,Jeremie Frimpong,25,1074300,9397668620200260,111,1534303,44185,4419,39766
163,Cody Gakpo,70,4015100,6454512251627919,619,7837877,699731,6998,692733
164,José María Giménez,64,3592700,5645957993794374,533,7172727,3436951,3437,3433514
165,Sébastien Haller,60,528900,5889448605130687,235,2037265,1076395,107640,968755
166,Jonas Hofmann,35,3361000,3739867832289971,337,5280198,3737616,3738,3733878
167,Mats Hummels,59,3269600,9550829519644346,480,6604280,4803243,48033,4755210
168,Borja Iglesias,29,2243300,4585168350663947,225,3362536,535642,5357,530285
169,Filip Kostić,44,4834100,5822889783749885,523,8296889,4216092,421610,3794482
170,Alexandre Lacazette,63,1487800,9162115928728603,351,3861571,2894645,2894645,0
171,Konrad Laimer,57,884000,6557766250174477,250,2349966,1840945,184095,1656850
172,Hugo Lloris,44,2962700,3206123115127637,347,4963110,2103225,0,2103225
173,Gianluca Mancini,22,2598600,8332602813813732,228,3635029,1285357,128536,1156821
174,Alex Meret,49,2032900,6014215023607157,299,3588995,3147438,31475,3115963
175,Morata,26,690700,4807059553339374,85,931933,464828,4649,460179
176,Gerard Moreno,64,1425500,6762365981217431,358,3828392,1734988,173499,1561489
177,Dani Olmo,60,4677100,3248774705965173,619,9206894,6202922,0,6202922
178,Willi Orban,54,2575600,7482764239600989,364,4641409,178372,179,178193
179,Oyarzabal,46,528300,3862887057151385,195,1669692,1626190,1626190,0
180,Gavi,63,3371800,9248994374616786,571,6985005,850433,8505,841928
181,Palhinha,43,2617500,6389871954750716,357,4855682,1043067,10431,1032636
182,Benjamin Pavard,28,1968400,8165848380140829,218,2999402,2875694,28757,2846937
183,Lorenzo Pellegrini,59,410700,8375864763078647,250,2119224,1767095,176710,1590385
184,Marco Reus,65,4270600,5621102975965569,622,7926912,3487150,349,3486801
185,Guido Rodríguez,64,3651900,4203737600931474,593,7855670,5030521,50306,4980215
186,Alessio Romagnoli,24,1909100,8512532259386318,190,2725226,935267,0,935267
187,William Saliba,64,4496800,8112511414166438,604,7844574,815818,816,815002
188,Patrik Schick,42,4094000,7264995856536263,417,6915758,5876760,5877,5870883
189,Nico Schlotterbeck,68,974100,3512346171048887,353,3278122,1534298,1534298,0
190,Luke Shaw,65,1761200,7692678265644721,399,4210030,695907,695907,0
191,Unai Simón,58,2454500,9701307998807672,433,5610994,4558480,4559,4553921
192,Raheem Sterling,42,490500,5469706767385408,143,1213596,887653,0,887653
193,Dušan Vlahović,60,4288600,6013199413476559,584,8296992,2072725,20728,2051997
194,André-Franck Zambo Anguissa,59,3960300,8624056911016746,580,7237955,6594727,0,6594727
195,Piotr Zieliński,42,4388600,4154008305481682,521,7390524,4912307,0,4912307
196,Manuel Akanji,65,2155200,9660680647594423,395,4569917,1138377,0,1138377
197,Robert Andrich,45,3385900,6621084239893037,394,5877465,4554487,0,4554487
198,Joelinton,47,1225300,8914458169719617,252,2732606,2553747,255375,2298372
199,Roberto Firmino,41,741600,5701748280568214,148,1354558,396555,0,396555
200,Rodrigo Bentancur,65,496600,6697040460021950,303,2620671,234015,23402,210613
201,Eduardo Camavinga,61,3511200,7697580431219852,499,6375153,4319078,4319078,0
202,Carvajal,24,2637600,7684355190986089,216,3823240,3063696,0,3063696
203,Ángel Correa,50,583400,9065843589477419,239,2000637,900897,900897,0
204,Ricardo Horta,52,4026300,9483521216072076,480,6314143,5712346,571235,5141111
205,Otávio,66,2791900,7274359832459683,529,6293471,4478462,0,4478462
206,Stefan de Vrij,58,2787600,8093190175032863,425,5212700,3936702,39368,3897334
207,Boulaye Dia,27,4440200,7421005119659749,415,6868802,390248,39025,351223
208,Federico Dimarco,58,2580600,7490346552996563,484,5866138,290280,29028,261252
209,Youssef En-Nesyri,48,4136200,7995182373119008,441,6401339,159116,0,159116
210,Mark Flekken,26,1378700,5416309465215323,157,2171770,619900,6199,613701
211,Seko Fofana,57,4428200,9874968369440314,542,7698657,7373326,0,7373326
212,Javi Galán,53,4055200,6950489225558054,529,7441908,7263591,726360,6537231
213,David García,35,3429400,3452813518720826,389,5737127,2617406,261741,2355665
214,Gayà,48,4704200,7479278229221139,524,7509508,6295844,630,6295214
215,Olivier Giroud,38,782800,3310355091107522,159,1560418,882657,8827,873830
216,Mario Götze,32,300900,5787735453892167,108,767869,414602,0,414602
217,Vincenzo Grifo,26,4847700,8643934871307707,471,7622881,2423141,0,2423141
218,Raphaël Guerreiro,41,594300,9241445123938727,169,1428129,205873,206,205667
219,Joško Gvardiol,65,3601600,3700155493616665,463,6709051,542682,543,542139
220,Kai Havertz,34,4713000,5658522412457494,450,6699303,810774,0,810774
221,Mario Hermoso,63,894300,3609804881275340,329,3201026,1072522,1073,1071449
222,Franck Yannick Kessié,46,3937800,5285015070758935,458,7087855,3749088,375,3748713
223,Presnel Kimpembe,50,3368400,9143833620361695,508,6993422,1912088,0,1912088
224,Orkun Kökçü,52,2204400,6844866819476678,325,3984653,1296485,1296485,0
225,Mateo Kovačić,23,2430700,4916607299235393,181,3283115,2425045,2426,2422619
226,Robin Le Normand,68,3594900,7831867638025341,542,6580612,4157118,4158,4152960
227,Jeremías Conan Ledesma,35,1086300,8774185953758910,172,1877572,1316916,1316916,0
228,Thomas Lemar,55,706500,8365290755661822,297,2489067,2156328,215633,1940695
229,Dominik Livaković,40,2117400,9154831834561445,236,3382805,2824775,2824775,0
230,Manuel Locatelli,47,4185900,5833093079555951,464,7311284,3200712,32008,3168704
231,Anthony Lopes,23,4942600,6018303920176756,370,6914000,2596599,2597,2594002
232,Alexis Mac Allister,62,2242600,4621121909161799,457,4754697,248348,249,248099
233,Donyell Malen,36,4301100,6851988484013021,456,6818023,5620121,0,5620121
234,Iñigo Martínez,26,2040500,9398420176104542,207,3181741,1147203,11473,1135730
235,Joselu,41,673900,8338452632393936,161,1577550,196713,196713,0
236,Noussair Mazraoui,58,1158000,5751699559492674,298,2918890,2233028,2233028,0
237,Diogo Costa,64,3634000,5743024848426241,565,7196822,6259454,62595,6196859
238,Édouard Mendy,36,1399000,7938710096818333,199,2537307,537047,53705,483342
239,Ferland Mendy,65,4162500,9825162365547819,616,8527039,3289033,328904,2960129
240,Nahuel Molina,58,1405300,5306860275904291,343,3695092,2059641,2059641,0
241,João Mário,70,2358700,5016935559447624,504,5627423,4579788,4579788,0
242,Darwin Núñez,68,2955400,4550737675275517,571,6481257,948055,9481,938574
243,Loïs Openda,30,2769300,3033379411826902,248,3874192,89199,0,89199
244,Nicolás Otamendi,61,3801600,6104071396793517,497,6334255,2742011,0,2742011
245,Isi Palazón,69,3874300,6911990404768475,626,8026482,7206293,72063,7134230
246,Pedro Gonçalves,49,1428700,8258409222242163,226,2705016,2057989,20580,2037409
247,Jordan Pickford,26,2018600,5176502274621992,211,3041197,2682329,0,2682329
248,Ivan Provedel,52,2476600,9140282038191701,384,4784787,2369145,0,2369145
249,Fernando,51,3448500,3221419453820396,450,6398512,3376409,0,3376409
250,Cristian Romero,55,1346700,6517934163248163,305,3169825,1574783,1574783,0
251,Jadon Sancho,61,2202600,6362185647774656,433,5078284,3217058,0,3217058
252,Stefan Savić,68,1766300,7781272382605537,386,4028936,2425883,0,2425883
253,Fabian Schär,22,2676800,8420812594366841,196,3370194,1265722,127,1265595
254,Dominik Szoboszlai,26,1598200,8186050702955416,144,2247860,1812281,1813,1810468
255,Dušan Tadić,59,3195700,7483494407354475,533,6651698,1953838,1954,1951884
256,Mehdi Taremi,48,4173400,5578455768429375,501,7206905,2824364,28244,2796120
257,Nuno Mendes,63,4621500,7827306528543220,555,7968128,1781685,17817,1763868
258,Youri Tielemans,69,3213300,7662671129182537,591,7333833,4287955,0,4287955
259,Lucas Torreira,68,3359200,3056934349296047,521,6748485,6569833,6570,6563263
260,Ferran Torres,27,355100,9948537400000593,80,626400,485479,48548,436931
261,Viktor Tsygankov,25,4979600,7436887906999330,420,6915572,5514434,5515,5508919
262,Enes Ünal,67,4698300,6897319802140677,620,8650904,4776120,477612,4298508
263,Dayot Upamecano,37,4073600,3470634300301152,460,7101269,1216320,1216320,0
264,Guglielmo Vicario,22,2661200,4384807114891218,182,3389631,707013,707013,0
265,Timo Werner,28,1756400,8770761571623536,146,2391188,1612021,1612021,0
266,Callum Wilson,38,2340900,6494905834380022,299,4029202,3768196,3768196,0
267,Granit Xhaka,55,3543000,3593773669858739,495,6528257,2823891,283,2823608
268,Mattia Zaccagni,42,986200,8741617311484866,203,2046084,853098,853098,0
269,Nathan Aké,61,4535900,4805663490264357,623,8337820,5014408,5014408,0
270,Ali Al Musrati,44,3100500,5335922100311318,350,4712286,1297223,0,1297223
271,Raúl Albiol,44,438400,4327413434214267,151,1257843,424240,0,424240
272,Toby Alderweireld,36,1894800,9803287817163920,219,3312975,1208265,0,1208265
273,Miguel Almirón,46,4074000,5550474540595700,456,6824661,5634142,56342,5577800
274,Edson Álvarez,55,4796400,6092419937987987,568,8272311,2831020,284,2830736
275,Yeray,25,969700,8994460222483205,91,1239287,134454,134454,0
276,Maximilian Arnold,50,2601900,3208833303495130,357,4935622,212001,212001,0
277,Kepa,36,468200,8692972351145508,125,1084845,255901,25591,230310
278,Balde,69,2798600,9475532440387780,482,6126600,1876306,1876306,0
279,Steven Berghuis,60,3345200,9916906948084899,459,5695716,1895381,189539,1705842
280,Benjamin Bourigeaud,62,1174200,4959040935095998,336,3593224,1230810,1231,1229579
281,Davide Calabria,66,4762900,4024468941378488,607,8273864,4276095,4277,4271818
282,Etienne Capoue,41,2363100,4002642539162146,305,4210656,2402765,240277,2162488
283,Ben Chilwell,27,1305200,6707198245107224,126,1780177,529078,52908,476170
284,Samuel Chukwueze,62,450100,8862749615761562,311,2583038,405107,0,405107
285,Jonathan Clauss,45,2407600,3793496968517919,344,4776015,66938,670,66268
286,Sebastián Coates,36,3317300,6805666458418044,337,5230960,2381537,239,2381298
287,Lucas Paquetá,37,2305100,3350185160010307,286,3871490,1341739,135,1341604
288,Bryan Cristante,49,4900000,8012757446167607,498,8149046,4119844,4120,4115724
289,Danilo,64,3949500,9794559819991126,602,7867085,574028,5741,568287
290,Arnaut Danjuma,70,4030800,3232663027659376,600,7941376,4817371,4817371,0
291,Rui Silva,28,1103500,7915832834004037,117,1486707,72993,730,72263
292,Jonathan David,30,4872300,9795998602529787,429,7193284,4374250,0,4374250
293,Fred,44,4714100,4763951248737612,503,7774961,1090094,1090094,0
294,Rui Patrício,45,1385900,8642758994028030,260,2761665,1743998,174400,1569598
295,Denzel Dumfries,65,4158500,6111450557704065,559,7687609,5998563,0,5998563
296,Lewis Dunk,39,4358800,8563716036017430,495,7395595,6456963,0,6456963
297,João Félix,69,4114200,3690412296020470,612,8056293,7482123,0,7482123
298,Beto,59,3381900,9350534606565367,463,6020730,1083038,109,1082929
299,Nicolás González,49,1801100,6813410117886063,289,3627450,1125674,112568,1013106
300,Danilo Pereira,37,2551500,3793423195784414,287,3965023,1422618,143,1422475
301,Lukáš Hrádecký,39,3136300,4047086520880338,343,5202558,2687823,0,2687823
302,Lorenzo Insigne,57,4943600,9458739100919679,618,8677715,7136417,0,7136417
303,Alexander Isak,29,2371000,3374606216123440,220,3664484,1637498,16375,1621123
304,Daichi Kamada,36,2425500,9049597624885794,275,3919524,1059472,1059472,0
305,Simon Kjær,67,2945900,7881174853422932,514,6601766,2292277,229228,2063049
306,Ibrahima Konaté,56,2182000,8611366399671552,383,4347667,3051505,306,3051199
307,Geoffrey Kondogbia,36,4851800,9626492885308415,515,7743199,5532965,0,5532965
308,Andrej Kramarić,49,2137600,7432012410138181,304,3824976,1509066,151,1508915
309,Dejan Kulusevski,28,2469800,8965717158351457,196,3486751,1267689,1267689,0
310,Gaëtan Laborde,66,3404100,4019569583968317,567,7352621,4120497,412050,3708447
311,Bernd Leno,50,4065000,7097015764236768,479,6790915,2486963,248697,2238266
312,Pepe,43,4280000,9756050300130755,474,6583366,6090324,609033,5481291
313,Giovani Lo Celso,47,818200,6997706320083926,206,2070611,168969,169,168800
314,Ademola Lookman,39,757500,6809377845462196,158,1617695,467000,467,466533
315,Hirving Lozano,67,1462000,7403892892960104,389,3839012,2904220,2905,2901315
316,Reinildo,46,1273500,4314372950911184,205,2410109,758937,0,758937
317,Antony,63,1494300,5858673999963817,327,3731465,148561,148561,0
318,Nemanja Matić,46,1193200,3048810059428151,276,2871430,1431148,1432,1429716
319,Brais Méndez,69,1622900,6387919340896594,407,4435986,2178094,218,2177876
320,Dries Mertens,22,4508000,9147117662099098,334,6039277,4666684,4666684,0
321,Arkadiusz Milik,32,2940200,5197134959271239,276,4120521,985683,985683,0
322,Henrikh Mkhitaryan,37,1969300,3512490808950037,246,3533769,1197241,11973,1185268
323,Mason Mount,41,1888800,5657829566656838,255,3305281,2540210,2540210,0
324,Muniain,32,4042300,4859384316613050,361,6162443,1374900,137490,1237410
325,Guillermo Ochoa,30,450100,9388052803656291,95,752646,333928,3340,330588
326,Felipe Anderson,70,2196600,3008352346267767,503,5438239,560296,56030,504266
327,Matteo Politano,32,740800,4918543320676355,130,1404347,903865,903865,0
328,Pedro Porro,59,1928700,3825904338004385,404,4689656,1337254,13373,1323881
329,Ivan Rakitić,61,941200,8947810295458526,342,3216673,2032852,2033,2030819
330,Amir Rrahmani,55,1247300,6536726940220422,323,3157269,461597,0,461597
331,Fabián Ruiz,26,974500,5498922340775602,101,1260224,55004,0,55004
332,Gerónimo Rulli,42,755100,9597065330226650,177,1726114,793719,0,793719
333,Allan Saint-Maximin,69,2836000,8132530238483325,472,5491486,3117921,3117921,0
334,Brice Samba,37,4625300,4620386418257569,410,6972372,6005101,601,6004500
335,Sancet,68,330300,8349040563853991,326,2641296,2207718,0,2207718
336,Ibrahim Sangaré,53,1552900,9108965921505491,300,3268495,2225239,2225239,0
337,Diego Carlos,29,4021800,9833380981338492,365,5815239,2268137,2269,2265868
338,Xaver Schlager,25,453100,4834764600854626,44,392991,1906,1906,0
339,Kasper Schmeichel,40,772200,4481512947938711,163,1556816,731304,0,731304
340,William Carvalho,28,2508700,9084436068896514,204,3205443,1097289,1097289,0
341,Malcom,61,2868600,4278548394796902,446,5498339,1018014,10181,1007833
342,Mário Rui,39,1034400,5407729697943806,181,1983506,1912767,191277,1721490
343,Ellyes Skhiri,48,1074300,7621679341605130,261,2656239,944101,9442,934659
344,Anderson Talisca,45,4951700,7566097529577557,551,7417000,804569,0,804569
345,Jonathan Tah,32,3711500,4160611711625971,335,5206856,1670748,167075,1503673
346,Edmond Tapsoba,58,709000,5239271148096715,281,2481279,926919,92692,834227
347,Martin Terrier,30,3197600,4960034836695664,305,5112420,4820623,4820623,0
348,Leandro Trossard,50,839000,4335859967910082,230,2126747,1561812,1561812,0
349,Manuel Ugarte,25,1589400,3946243943259346,160,2232565,1488696,0,1488696
350,Lucas Vázquez,65,1461300,6454025435755845,324,3638676,3265069,3266,3261803
351,Odisseas Vlachodimos,66,2571300,7487308436015133,464,5841850,1971185,1971185,0
352,Iñaki Williams,26,527900,8291609782392464,86,796488,496187,0,496187
353,Wilfried Zaha,35,1289700,5596382149059346,191,2431587,2374336,2375,2371961
354,Duván Zapata,56,2935700,9231040357971810,423,5302712,2448461,0,2448461
355,Tammy Abraham,24,3374300,8338493240982143,275,4814425,2413797,24138,2389659
356,Adán,62,2130100,5991174744832110,392,4606905,630154,6302,623852
357,Karim Adeyemi,44,3863200,8207348809903019,439,6359155,3944418,0,3944418
358,Isco,39,1123000,4598962670975104,181,1983290,948209,0,948209
359,Julián Álvarez,64,3257300,9187977476865279,524,6915195,4664630,0,4664630
360,Sofyan Amrabat,38,2293100,7068432132548198,281,3839999,1622315,1622315,0
361,Pepê,30,3532600,8442376968455944,320,5536871,2760582,0,2760582
362,Mauro Arambarri,63,4114300,8850151039761014,590,7781459,5395637,0,5395637
363,Marko Arnautović,67,4641800,3007118955422526,616,8972476,7822302,7822302,0
364,Pierre-Emerick Aubameyang,25,1423900,6785203407479192,142,2057476,1729467,173,1729294
365,Ezequiel Ávila,23,2372000,5011186739110929,216,3225423,948421,94843,853578
366,Edgar Badia,27,777800,4611184873120785,91,1057322,297472,29748,267724
367,Harvey Barnes,27,1728400,7765404738759872,171,2529633,1810597,182,1810415
368,Oliver Baumann,55,3160800,4971362202178147,433,5453990,590339,590339,0
369,Fran Beltrán,62,2550700,9400420756905887,470,5711980,161749,16175,145574
370,Ramy Bensebaini,67,726800,9405405635397696,360,3293146,2799581,280,2799301
371,Álex Berenguer,57,3842200,7324029012767818,518,7084158,670088,670088,0
372,Cristiano Biraghi,46,2906600,8177431541401258,393,5036921,4780669,4780669,0
373,Leonardo Bonucci,52,2531200,9746434818004770,432,5162444,361273,0,361273
374,Claudio Bravo,38,2165300,6141261084441027,255,3516525,2111126,21112,2090014
375,Emiliano Buendía,22,2896300,3537504825121895,246,4097963,895510,896,894614
376,Moisés Caicedo,58,4211100,5787402936666229,571,8312317,727563,727563,0
377,Giorgio Chiellini,45,4730100,4037904343620700,573,7775317,1802661,18027,1784634
378,Francis Coquelin,53,4212600,9504332202614255,559,8277606,7775429,77755,7697674
379,Juan Cuadrado,70,2289100,8604218243504530,443,5167577,3895352,3895352,0
380,Diogo Dalot,60,1126300,6839272019185571,297,2972912,607551,0,607551
381,Kevin Danso,36,4833400,9122527369208945,432,7445488,1103223,111,1103112
382,Matteo Darmian,62,1247300,8308044774939199,344,3408076,456320,0,456320
383,Richarlison,70,3916600,5692725554805859,572,7656659,3326330,332633,2993697
384,De Marcos,40,3650300,3843067977419463,419,6316158,4451778,0,4451778
385,Marten de Roon,70,307100,8972573029479257,273,1923430,1469600,0,1469600
386,Deulofeu,60,1530100,9853212427747895,332,3792069,983927,98393,885534
387,Brahim,63,2952800,7452681258247096,423,5819872,4127712,412772,3714940
388,Marko Dmitrović,23,627600,5567633671104008,76,822307,25086,25086,0
389,Marcus Edwards,54,3901700,4370068101440117,473,6511167,1883481,1884,1881597
390,Eljif Elmas,58,4001100,6515091435910711,559,7672701,4968178,4969,4963209
391,Aritz Elustondo,66,2781100,8524001728369922,492,6238341,2663037,266304,2396733
392,Wataru Endo,35,1014100,3857772867083842,141,1627834,1175531,1175531,0
393,Pervis Estupiñán,63,4130700,7829502760939019,582,7765281,5823463,583,5822880
394,Suso,44,2206500,8496658647567835,349,4338351,3606703,36068,3570635
395,Youssouf Fofana,47,3761700,6894105160776631,451,6237295,5067086,5067086,0
396,Emil Forsberg,66,4869000,3104070956687643,649,8443449,2131008,214,2130794
397,Juan Foyth,25,2542200,7842229652696449,269,3922401,3188009,3189,3184820
398,Davide Frattesi,66,1483300,3884223304793441,369,4154938,1171324,117133,1054191
399,Niclas Füllkrug,39,1770500,4219085798210568,223,2755273,883022,0,883022
400,Aleix García,50,4618200,4922728706039930,596,8134454,7661698,767,7660931
401,Nuno Santos,70,3264700,9927291545735218,531,6372054,4955392,0,4955392
402,Nemanja Gudelj,41,2781700,9755864392419225,306,4451671,4390096,439010,3951086
403,Dávid Hancko,46,1366700,3213627858136665,257,2940947,2274547,2275,2272272
404,Jordan Henderson,32,2098300,9544976746346832,245,3572170,53368,53368,0
405,Ibañez,35,3337900,5978584519695290,370,5714060,632132,632132,0
406,Mauro Icardi,53,2395800,7757340389768230,324,4168956,1326618,1326618,0
407,Joan Jordán,59,3716600,3832895806534918,534,6765056,5204713,0,5204713
408,Boubacar Kamara,55,2896500,4385583006464256,487,5924751,1204702,121,1204581
409,Teun Koopmeiners,52,4471000,3195696927226467,531,7540888,5117520,0,5117520
410,Takefusa Kubo,30,2290900,6767290976816838,237,3707545,187794,18780,169014
411,Erik Lamela,45,4933600,3816170971014396,552,8360522,5923631,593,5923038
412,Armand Laurienté,42,1472400,3767826614464999,233,2705511,1270412,1271,1269141
413,Matheus,27,2227100,8374247155084999,226,3130378,26925,2693,24232
414,Victor Lindelöf,50,634800,6903899018237355,194,1684849,291128,292,290836
415,Pau López,51,4798300,7514276290408588,532,7453043,5429724,542973,4886751
416,Vitinha,44,2776200,4554615095529935,361,5203436,3932618,394,3932224
417,Giorgi Mamardashvili,26,1370000,4186803279775045,146,1809483,150564,150564,0
418,Anthony Martial,55,2850600,7136273631918054,427,5009269,241902,242,241660
419,Arnau Martínez,59,4154500,5135664365140646,528,7760009,6407949,640795,5767154
420,Adam Marušić,59,4593100,7139665803098913,562,8652243,845198,8452,836746
421,Joel Matip,37,922400,4001593985937114,191,1878380,1748227,175,1748052
422,Chancel Mbemba,47,2570000,8476082194725989,316,4497213,567531,56754,510777
423,Facundo Medina,32,1251900,9582573398943633,171,1958969,1718213,171822,1546391
424,Arthur Cabral,27,3565700,5967420024539970,341,5598645,4860300,487,4859813
425,Simon Mignolet,64,1005300,5131384105982570,358,3287272,815059,81506,733553
426,Kaoru Mitoma,65,3907800,5382495205529986,556,7248609,969835,0,969835
427,Álex Moreno,65,4735000,7566899115498481,601,8813363,6077550,6078,6071472
428,Florentino,70,4153100,3335701523918680,643,8577068,8503848,8504,8495344
429,Hany Mukhtar,69,1756000,6170721821005136,437,4937663,299666,0,299666
430,Vedat Muriqi,31,4990100,7566535084624247,441,7950684,4306400,4306400,0
431,Fernando Muslera,56,383900,6853630530481317,205,1640658,1248642,124865,1123777
432,Jesús Navas,37,4021400,5509296627366989,394,6025960,1167873,1167873,0
433,David Neres,61,4277000,5796122510414366,520,7265300,1565732,156574,1409158
434,Saúl,51,3103100,6932222574016355,432,5476882,1504853,150486,1354367
435,Lucas Ocampos,60,4358000,8361103435975299,591,8469898,3309996,331,3309665
436,Jonas Omlin,49,1357300,7242729321132827,304,2958203,2186218,218622,1967596
437,David Ospina,38,4384400,4875647961019094,431,7001899,3218955,0,3218955
438,Exequiel Palacios,51,548700,7859053911935063,216,1857940,487026,0,487026
439,Mario Pašalić,54,4895500,8739784037322307,565,8649858,3039512,0,3039512
440,Gonçalo Ramos,30,3743100,6209293535748879,361,5966327,577181,57719,519462
441,Luiz Felipe,28,3061300,5931808705418625,239,4143620,1784839,0,1784839
442,David Raya,42,1154900,8881241960207085,226,2334598,2039521,2040,2037481
443,Sergi Roberto,26,1091300,9313769462536290,119,1556844,706721,706721,0
444,Oriol Romeu,56,1186500,8397396203431983,288,2995403,1912001,0,1912001
445,Valentin Rongier,57,3701400,7394266518257218,505,7047346,1626450,163,1626287
446,Marcel Sabitzer,25,2430800,8382626055754941,246,3654028,3310339,3311,3307028
447,Téji Savanier,67,1643500,9707220937527887,413,4178873,4145560,415,4145145
448,David Soria,63,887300,4915056597962378,278,2501947,1795402,1796,1793606
449,Leonardo Spinazzola,62,3052800,5411976485075329,522,6445822,561714,562,561152
450,Nicolás Tagliafico,38,1647900,9657434341345563,229,2944279,2732370,0,2732370
451,Kieran Tierney,52,2461200,7325042654077109,372,4754191,310275,3103,307172
452,Rafael Tolói,30,1468100,3897596301412448,158,2226809,506531,507,506024
453,Hamari Traoré,56,3438900,3823337142404298,531,6772985,5358886,5359,5353527
454,André Silva,31,588600,7652062017746141,121,1160952,893398,893398,0
455,Carlos Vela,62,3734400,3793561330043531,501,6469786,5145044,514505,4630539
456,Jordan Veretout,33,969800,3375232069790826,172,1915615,1888119,18882,1869237
457,Jonathan Viera,59,1577200,4461129436720393,324,3774707,2840458,2841,2837617
458,Aaron Wan-Bissaka,43,2652400,6819501110315100,350,4534536,2576604,0,2576604
459,Ollie Watkins,61,2468200,4147848316942606,426,5051151,3512154,3512154,0
460,Julian Weigl,56,2487800,6719924681724738,362,4611608,785768,785768,0
461,Benjamin White,37,4204500,8980383488157477,447,6438121,1336127,1337,1334790
462,Georginio Wijnaldum,49,877700,8759201032897522,206,1907576,178861,1789,177072
463,Nicolò Zaniolo,63,2229000,4305722752114935,454,5334028,1894393,0,1894393
464,Oleksandr Zinchenko,36,3199100,3764382419551684,333,5131823,3265804,326581,2939223
465,Hakim Ziyech,46,2616700,6259110855574640,336,4392818,3989165,3990,3985175
466,Zubeldia,45,4035800,5149998404012741,503,7464872,6054710,60548,5994162
467,Zubimendi,39,1807600,6792144731879669,239,3340166,1581458,1581458,0
468,Vincent Aboubakar,28,2262900,3817497324529482,205,3463757,3325473,333,3325140
469,Nayef Aguerd,61,443400,5155518019093912,261,2080617,749589,749589,0
470,Joseph Aidoo,67,1010400,7006536489840207,317,2896651,1376013,137602,1238411
471,Ludovic Ajorque,44,1485000,4433618062634173,244,2668729,1316348,1317,1315031
472,Thiago Almada,48,4833100,3711215160345547,507,8151484,3235852,324,3235528
473,Marcos Alonso,41,1259300,8468176683778803,198,2264680,1231884,0,1231884
474,Benjamin André,28,1323100,8568690152866979,158,2031652,141836,141836,0
475,Emil Audero,65,3483500,8035510843478307,536,6344497,4608382,4608382,0
476,Fredrik Aursnes,24,2559100,4549864574573661,256,3806418,2173536,2174,2171362
477,Azpilicueta,59,399700,7438502352348839,288,2467329,1640461,165,1640296
478,Alexander Bah,53,4249200,9007774157410925,459,7030540,649184,0,649184
479,Leon Bailey,25,3576000,9321250634319315,277,5104874,1508700,15087,1493613
480,Ridle Baku,38,1250400,5933905769024144,187,2162294,933157,0,933157
481,Folarin Balogun,24,1936000,8925670167819562,169,2627624,1047244,104725,942519
482,Éver Banega,35,318700,4932172586555456,94,624982,230652,0,230652
483,Ricardo Pereira,22,1927000,9489213967012659,164,2528868,1375438,1376,1374062
484,Marc Bartra,60,455500,5421809451972117,253,1933796,1204482,121,1204361
485,Christoph Baumgartner,54,3286000,9261562539618595,427,6004855,3079817,3080,3076737
486,Walter Benítez,32,2722400,9907486893992354,302,4267696,741064,742,740322
487,Yuri Berchiche,26,1392600,4873916446636718,133,1877920,633984,0,633984
488,Steven Bergwijn,53,3001700,4538241920133414,408,5393081,336773,3368,333405
489,Gonçalo Inácio,28,578500,5349460732726335,70,719883,116829,116829,0
490,Yves Bissouma,54,2089900,8152707746630923,421,5038840,4938724,0,4938724
491,Sacha Boey,52,3841000,3888685117401032,481,6967265,2672777,2672777,0
492,Giacomo Bonaventura,70,4590100,8419148540177502,672,8887690,1684394,169,1684225
493,Jarrod Bowen,47,4540200,4724859398973968,454,7485238,1841632,18417,1823215
494,Dan Burn,67,1454000,8009479095383364,374,3709296,2225352,0,2225352
495,Rémy Cabella,23,1101100,8361775139184611,103,1328203,138547,1386,137161
496,Antonio Candreva,49,3069300,6961402606629598,388,5268559,1780606,1781,1778825
497,Marco Carnesecchi,33,1921400,5117266809044939,201,2788152,600910,6010,594900
498,Nicolò Casale,60,3768300,8396110833398327,581,7028100,6061428,606143,5455285
499,Matty Cash,61,1774800,3264761786166574,372,4419216,3047522,305,3047217
500,Valentin Castellanos,29,667900,3270417349658695,93,908745,409692,0,409692
501,Catena,70,4947100,8720842504615696,744,9567744,8708701,0,8708701
502,Edinson Cavani,69,2619500,4467901511477304,557,6407673,5484099,0,5484099
503,Dani Ceballos,64,3165200,4762442180360715,479,6464644,81140,0,81140
504,Patrick Ciurria,51,1729300,7188669741613109,325,3438793,2214042,22141,2191901
505,Andrea Consigli,69,1468100,5426518306648445,425,4397531,4188429,4188429,0
506,Cucurella,46,1366800,9248443841903278,229,2630699,760019,7601,752418
507,Romarinho,37,1490500,3948642987255248,209,2802147,1422533,1423,1421110
508,Luuk de Jong,43,3932100,5705886994504628,466,7020115,6976543,69766,6906777
509,Raúl de Tomás,39,1409400,7918747877243540,184,2329841,1036176,1037,1035139
510,Thomas Delaney,35,2867700,9488287938835348,297,4766531,646985,6470,640515
511,Kerem Demirbay,54,2653200,4603978569201467,384,5289952,3158138,3159,3154979
512,Michele Di Gregorio,45,420800,7989885827812839,156,1215474,135639,0,135639
513,Lucas Digne,50,401400,8331502147081177,179,1443619,1111748,11118,1100630
514,Stole Dimitrievski,53,3560200,4985153658849748,441,5952435,5837361,5838,5831523
515,Axel Disasi,35,3961500,3158952362463172,438,7134620,4519102,45192,4473910
516,Angeliño,31,1461500,5322412320043590,158,2189247,2072868,0,2072868
517,Eberechi Eze,43,2996800,4358885786102277,352,5167432,2327264,233,2327031
518,Łukasz Fabiański,55,3276900,4891564487627701,476,5906766,3931788,393179,3538609
519,Ignacio Fernández,24,1768200,3023185059414388,177,2779584,1587658,0,1587658
520,Wesley Fofana,34,1099600,6363258768223205,166,1917185,1293163,1293163,0
521,Przemysław Frankowski,69,491500,3670452853875424,364,2745981,162665,1627,161038
522,Gonçalo Guedes,42,775800,8875656374209195,188,1841833,1009990,101,1009889
523,Álvaro García,29,2234500,8515091065420814,257,3679444,755638,75564,680074
524,Lutsharel Geertruida,41,1294500,6677899415509797,225,2618736,2470954,0,2470954
525,Carles Gil,58,2437200,9428099622653883,387,4980505,294665,0,294665
526,Alexandr Golovin,67,2415100,8056587906446714,467,5266178,608719,0,608719
527,Joe Gomez,68,1082700,3272183989895338,394,3800286,333274,0,333274
528,Moi Gómez,36,3589600,3620973590295545,423,6292058,3141628,315,3141313
529,Edgar,24,3443000,7274496351043163,276,4489914,1045587,0,1045587
530,Robin Gosens,41,4009200,6874389719885104,428,6334314,4082911,4083,4078828
531,Amine Gouiri,69,2978500,4782973140672709,546,6356770,1433861,1433861,0
532,Ryan Gravenberch,40,409400,6810756358091977,154,1295353,1286723,1286723,0
533,Michael Gregoritsch,41,2740700,4852091233823181,333,4818482,1416498,1416498,0
534,Marcelo Grohe,39,3856200,7382671377229134,421,5790054,1055143,10552,1044591
535,Mattéo Guendouzi,48,1103900,8191447265802258,257,2625457,1051436,0,1051436
536,Christian Günter,67,576200,4741072326032962,305,2422827,422975,4230,418745
537,Dean Henderson,53,1376500,3304563963913370,325,3427338,249447,250,249197
538,Ander Herrera,53,4534400,8054633368589902,588,8408120,3944759,39448,3905311
539,Sergio Herrera,45,4690100,9881774011837986,486,7456286,113820,114,113706
540,Piero Hincapié,25,437600,3323397156499269,74,643037,370721,370721,0
541,Juanmi,23,2681700,5296211336835941,236,3660437,862785,863,861922
542,Kevin Kampl,50,2397500,4112663196126504,360,4636821,4051368,40514,4010854
543,Lukas Klostermann,63,779200,9967455399915740,292,2709256,1398069,1399,1396670
544,Ezri Konsa,40,3871900,5829533717407626,463,7039283,2803664,28037,2775627
545,Mohammed Kudus,44,568500,9613563572398844,203,1841377,1090055,110,1089945
546,Manuel Lazzari,63,2055900,8260210420297788,392,4643623,2928079,0,2928079
547,Philipp Lienhart,30,2113400,3481780738998763,241,3481720,2891938,28920,2863018
548,Renan Lodi,23,4493200,9436281704702528,409,6697746,5474339,54744,5419595
549,David López,23,1284500,7384149534606361,120,1821571,203526,0,203526
550,Matheus Nunes,53,566600,8096765959863721,270,2421592,1811952,1811952,0
551,Robert Sánchez,64,3643900,4862555891936083,543,6784833,6000826,0,6000826
552,Harry Maguire,65,3644300,3891052138310531,505,7015156,511065,5111,505954
553,Lovro Majer,65,687700,8052748133040275,310,2633226,2432903,2432903,0
554,José Sá,34,4081200,8458681518050654,347,5906557,2643847,2644,2641203
555,Steve Mandanda,28,614500,5989516740169180,61,683375,333474,0,333474
556,Solly March,69,3897900,3201849623684752,548,6869290,3380961,0,3380961
557,John McGinn,69,410400,5974544510937826,332,2600404,2465339,247,2465092
558,Callum McGregor,57,4377300,8194674827282946,583,7576852,3788037,37881,3750156
559,Scott McTominay,41,4921400,6450297396876141,542,7726139,4143619,41437,4102182
560,Ben Mee,47,4043900,8610758167526181,433,6951628,4083785,409,4083376
561,Nikola Milenković,65,1840600,4460594679710667,407,4286297,1486336,0,1486336
562,Tyrone Mings,65,2490900,3737970406687461,503,5888490,1749004,0,1749004
563,Aleksandar Mitrović,47,3572000,3330166303460977,442,6429668,1723537,173,1723364
564,Gonzalo Montiel,56,1725400,9965398204237096,372,3888638,2706037,271,2705766
565,Morales,54,3355800,8582159845421744,470,6445857,3074712,307472,2767240
566,Nordi Mukiele,25,450900,8753314421680809,52,452401,170898,170898,0
567,Luis Muriel,52,503900,9192240636869712,219,1901005,1299384,1299384,0
568,Juan Musso,45,666500,5307702017081239,191,1880060,1448681,1449,1447232
569,Wilfred Ndidi,24,3324200,3065818576391670,280,4595228,827337,828,826509
570,Florian Neuhaus,67,3070400,7422997622909851,494,6287569,5355752,0,5355752
571,Alex Telles,55,2226000,5129736262450446,371,4476871,2192993,0,2192993
572,Stefan Ortega,33,2018500,8296616803467261,235,3072768,2701300,271,2701029
573,Ayoze Pérez,67,3174800,5085885520320142,516,6055820,3291288,0,3291288
574,Mattia Perin,24,2921100,6799558503477599,285,4216805,998097,999,997098
575,Ivan Perišić,53,607100,8299096139330364,270,2393379,18703,1871,16832
576,Kalvin Phillips,58,4877300,8968372537609948,594,8337914,6452901,645291,5807610
577,Ethan Pinnock,58,3951400,5618781104660408,552,6990907,11397,11397,0
578,Yeremy Pino,34,1507800,5968442354631643,211,2623434,419483,0,419483
579,Christian Pulisic,35,4646400,3536264962617058,402,7245598,2195027,2196,2192831
580,Giacomo Raspadori,36,1966200,7284025445308297,277,3601251,833862,0,833862
581,Matheus Reis,39,4668600,8265549303775660,505,7603497,2297478,22975,2274503
582,Emanuel Reynoso,64,551300,5160243709715046,341,2763883,562366,5624,556742
583,Lucas Robertone,63,3188000,3263099377223545,521,6663359,3504105,35042,3469063
584,Sebastian Rode,26,4720100,3160230096224566,438,7143346,3313341,0,3313341
585,Pedro,49,1797200,9212354236928824,307,3378566,377875,37788,340087
586,Kaku,42,1011900,4633795618182845,193,2112144,381400,382,381018
587,Frederik Rønnow,35,1629200,4835352959705464,237,3051038,854156,8542,845614
588,Perr Schuurs,40,1466200,5131774531409429,192,2388818,809773,0,809773
589,Matz Sels,39,4258900,4584633646325340,439,7140463,4978061,4979,4973082
590,Marco Silvestri,31,2736100,9350310100571425,262,3918244,3642454,36425,3606029
591,Mohamed Simakan,55,4599300,5058552199663996,541,7882686,2412871,2413,2410458
592,Xavi Simons,34,4151000,8737221451859662,361,6277456,1282100,129,1281971
593,Douglas Luiz,29,2755100,4498672074411818,256,4003198,3325823,332583,2993240
594,Carlos Soler,24,1979000,9405623403526624,185,2902757,2039649,20397,2019252
595,Alexander Sørloth,26,2629800,8303561170076873,231,3641692,3387225,0,3387225
596,Tomáš Souček,51,4066000,5748408289583695,436,6311326,56567,566,56001
597,Josip Šutalo,42,1462000,8751794156755133,230,2762000,554280,555,553725
598,James Tarkowski,42,3635000,7171697605568304,443,6226962,787800,788,787012
599,Pietro Terracciano,27,2407600,7737973585859433,238,3772393,1841991,184200,1657791
600,Teddy Teuma,47,4690200,3384515654821118,529,7711727,1856372,18564,1837808
601,Khéphren Thuram,57,899100,6519798895760423,320,2929557,972941,972941,0
602,Marcus Thuram,25,3899700,6860477733771698,374,6179715,4010527,402,4010125
603,Jurriën Timber,47,759900,3307362851042249,222,2154498,2139735,213974,1925761
604,Jean-Clair Todibo,53,2931600,3522809735944224,430,5936285,199960,199960,0
605,Corentin Tolisso,45,1788300,6274349122476267,269,3299231,1612663,1613,1611050
606,Óliver Torres,66,2639300,7042161630479249,508,5929559,2411223,242,2410981
607,Gernot Trauner,54,1165000,8981886425341641,290,2864603,2531849,253185,2278664
608,Samuel Umtiti,50,369500,5269946922240197,194,1455934,1364448,1365,1363083
609,Lars Unnerstall,22,1609900,7493696134913463,133,2253333,2002302,201,2002101
610,Hans Vanaken,36,543900,3371956031610039,134,1281750,677093,67710,609383
611,Jan Vertonghen,70,4067000,3366509914446402,646,8297483,7575987,0,7575987
612,Edin Višća,58,3378800,5587338785373923,526,6794880,1163502,0,1163502
613,Vivian,22,2246200,6878566623832405,190,2957461,2829040,0,2829040
614,Kevin Volland,37,3041700,5292454724902478,360,5047541,2936914,29370,2907544
615,Nico Williams,58,3726600,3423236347383565,549,7442941,3257730,32578,3225152
616,Axel Witsel,49,1471500,4054281305766085,323,3505657,3355744,3355744,0
617,Denis Zakaria,55,3675900,4520759918379778,527,7220325,1755135,1755135,0
618,Davide Zappacosta,66,2088700,7549969011304711,461,5110849,4358216,0,4358216
619,Lucas Zelarayán,63,1793100,4771441173436670,411,4472759,1124382,112439,1011943
620,Carlos Augusto,37,3912200,5855467045934403,413,6845531,5247717,52478,5195239
621,Kurt Zouma,28,2168700,7900382973991387,193,2779071,919135,0,919135
622,Salis Abdul Samed,40,972000,3002194869517171,179,1972630,1452858,14529,1438329
623,Tyler Adams,59,4055100,5118104813429306,530,6844770,3480986,348099,3132887
624,Pizzi,63,2293600,5245012314261996,449,5472717,133362,134,133228
625,Rodrigo Aliendro,48,1804100,7891875694054015,331,3811834,2999831,0,2999831
626,Joachim Andersen,28,4285800,7311386670952320,366,6533206,2037821,203783,1834038
627,Michail Antonio,52,4647100,5558944936551064,569,8338973,7842286,784229,7058057
628,Alphonse Areola,22,2883600,3053408608054729,225,3857844,1400250,1400250,0
629,Gabriel Paulista,51,2660300,7934856505337199,372,5084112,1102320,1102320,0
630,Serge Aurier,57,314600,5062206535271626,266,1905154,865312,0,865312
631,Sardar Azmoun,48,3585500,9839119315915187,432,5962252,685890,686,685204
632,Benoît Badiashile,64,503400,7376136134272686,340,2843706,1420424,142043,1278381
633,Simon Banza,68,3138400,8061230832466342,597,6743114,2215380,0,2215380
634,Antonín Barák,63,3067700,5418010170536164,508,6539133,4976201,49763,4926438
635,Sheraldo Becker,22,4263500,4973128393436556,367,6318034,2916139,2917,2913222
636,Héctor Bellerín,32,1552400,4883368379247184,204,2693613,2561977,2562,2559415
637,Andrea Belotti,35,3805000,9685435608499885,391,5613867,1715269,1715269,0
638,Saïd Benrahma,32,2634500,6227334039319652,275,4367939,1016820,10169,1006651
639,Mergim Berisha,57,4236000,8037449421020767,610,8043709,7936676,0,7936676
640,Federico Bernardeschi,28,2113700,5118773383308696,179,2843965,1797785,1797785,0
641,Justin Bijlow,62,3410400,8624058616381777,541,7285822,5268554,52686,5215868
642,Andre Blake,62,3694200,7199736081617846,529,7446928,2245585,2246,2243339
643,Ludovic Blas,42,2531700,3545947527874271,291,4382007,4056663,405667,3650996
644,Denis Bouanga,28,4135300,7526572470742800,324,6094519,3617620,0,3617620
645,Jean Butez,46,1962000,5074138161620763,333,3721623,3031169,30312,3000857
646,Nélson Semedo,27,4488400,8394035265919817,389,7007620,289621,28963,260658
647,Uğurcan Çakır,56,2594900,5159722943159614,466,5836710,2268456,22685,2245771
648,Mohamed Camara,45,4775500,6793898528710633,531,8100675,2127590,213,2127377
649,Maxence Caqueret,49,1519400,6638691135515079,289,3151860,2559864,0,2559864
650,Matheus Cunha,59,3746300,6189563882117245,574,6783283,3862182,386219,3475963
651,Gedson Fernandes,49,2324900,7461036845184723,341,4138495,3404855,3404855,0
652,Gaetano Castrovilli,47,2817400,3666940175024792,427,5295410,2579697,25797,2553900
653,Lucas Chevalier,54,898500,6857962138645699,228,2345640,1597042,0,1597042
654,Eric Maxim Choupo-Moting,34,2449500,7738038855403901,289,4093185,1560686,156069,1404617
655,Jasper Cillessen,55,4257400,4152815570796000,537,7740901,6120191,612020,5508171
656,Jordy Clasie,26,1568900,3689760762602309,154,2239227,213520,0,213520
657,Santi Comesaña,67,4036300,5684240372969242,632,8394261,5947920,5947920,0
658,Igor Coronado,45,1752000,8036578054126595,271,3558562,3427536,342754,3084782
659,Dante,27,2487400,5098429127330318,239,3735237,3172945,317295,2855650
660,Vladimír Coufal,23,3546500,5429385101352600,301,5202247,5121835,512184,4609651
661,Gustavo Cuéllar,69,1135400,7260735961935154,347,3504727,1410924,1410924,0
662,José Fonte,41,2493800,4414321494833979,344,4666122,1650323,1650323,0
663,Mahmoud Dahoud,22,4584900,4955570470281682,369,7148296,4874163,487417,4386746
664,Felipe,65,1546900,9252407947993423,344,3546563,1295779,129578,1166201
665,Nicolás De la Cruz,30,513400,3878234600341578,86,813263,162378,163,162215
666,Evanilson,68,2265300,3440249204426683,471,5516777,4396483,0,4396483
667,Habib Diallo,46,3611000,9251014338816497,417,6164060,5779207,0,5779207
668,Issa Diop,35,4676100,9144913565417774,392,6766200,6127566,61276,6066290
669,Ritsu Doan,68,2844200,8839009879514834,494,6034428,5553602,556,5553046
670,Danilho Doekhi,29,1215400,8890592515928773,145,1971203,1521589,1522,1520067
671,Oscar,26,1605600,9240879839838420,126,2068190,746855,0,746855
672,Cheick Doucouré,37,2761400,7400408661855995,304,4381769,1043000,104300,938700
673,Sebastián Driussi,38,2561400,7921633131976236,261,3994263,3102490,311,3102179
674,Martin Dúbravka,59,2535800,9415860405611316,409,5107118,2040789,0,2040789
675,Munir,69,4920900,3423621510182075,681,9956952,3387763,0,3387763
676,Stephan El Shaarawy,47,1044600,6616854218022420,245,2465706,2426226,242623,2183603
677,Breel Embolo,33,3061800,9483823018142817,300,4824627,1768443,176845,1591598
678,Alfonso Espino,30,2686800,3072467692696973,254,3655837,1360799,1360799,0
679,Ansu Fati,30,2932100,4389572629192215,279,4409938,4020362,40204,3980158
680,Aitor,37,3366500,3411950296627677,357,5348916,3318004,0,3318004
681,Remo Freuler,67,2818000,9989180445092333,471,5907796,4639599,0,4639599
682,Conor Gallagher,46,3581700,3469511345040250,450,6705715,6449408,64495,6384913
683,Rubén García,45,814700,6651418870424242,209,2085804,378018,0,378018
684,Fran García,38,2610200,9841822701504246,282,4440533,3309055,331,3308724
685,Pepelu,26,2433700,4852291966425501,192,3428798,82079,821,81258
686,Paulo Gazzaniga,50,2471000,4511265397539949,367,4644406,45884,0,45884
687,Rachid Ghezzal,56,2005400,5734591131129384,331,4167768,959729,959729,0
688,Samuel Gigot,60,3133000,4797816441993386,462,5890846,2991384,2991384,0
689,Santiago Giménez,49,1587900,5511866523310624,273,3220536,90479,905,89574
690,Ismaily,47,4539900,3854587833464983,495,6785880,546640,0,546640
691,Jonathan Gradit,25,4867400,6900713059203736,425,7040475,2170066,2170066,0
692,Pascal Groß,43,1828300,7402704798818194,277,3232976,199820,19982,179838
693,Guaita,27,538100,9603136628249518,67,611436,55234,0,55234
694,Marc Guéhi,50,4831000,4749941800220241,559,7858811,3279860,328,3279532
695,Amadou Haidara,56,1526100,4274556193965685,313,3372344,2029259,203,2029056
696,Reo Hatate,65,3113000,9747224026768586,519,6588659,2404090,0,2404090
697,Hans Hateboer,25,2673300,6014994323451729,240,4150838,1438536,0,1438536
698,Thorgan Hazard,32,1819800,6530807010640445,197,2734113,1716895,172,1716723
699,Ahmed Hegazi,31,3234700,4499385991091238,297,4752480,4197998,41980,4156018
700,Benjamin Henrichs,23,489500,8296785760219823,63,563303,147878,148,147730
701,Rico Henry,27,1483100,3952485105679012,163,2079536,1297554,12976,1284578
702,Héctor Herrera,59,1898000,3225049322351419,372,4351980,1937801,0,1937801
703,Junya Ito,57,1903200,3307454776904945,348,3935810,1381223,1381223,0
704,Nicolas Jackson,26,354600,8835648647184330,33,207366,55159,552,54607
705,Florian Kainz,62,1220700,9770931552140978,351,3625651,2721866,2722,2719144
706,Pierre Kalulu,69,1150600,7631439043984835,376,3401686,1124388,0,1124388
707,Rick Karsdorp,37,2236400,6781150004180310,244,3306104,932371,932371,0
708,Moise Kean,55,2446600,9658799395047254,418,4950975,524066,52407,471659
709,Naby Keïta,22,2895200,9917573840744102,231,4004849,1600326,16004,1584322
710,Sead Kolašinac,70,3147700,9036058283116819,577,6534317,4827517,0,4827517
711,Rade Krunić,69,2848200,4773234960238582,468,5685471,4544188,4544188,0
712,Kodjo Fo-Doh Laba,50,4999800,8919024130973254,551,8196940,770792,7708,763084
713,Alban Lafont,49,1226100,4201767987237335,266,2605006,2373003,2373003,0
714,Noa Lang,68,968800,7913940874406971,343,3280799,3042199,304220,2737979
715,Lee Jae Sung,50,2324300,9716245758194799,340,4673694,1676944,1676944,0
716,Lee Kang In,46,1833100,7350672477727338,269,3357603,1744546,174455,1570091
717,Emerson Royal,59,4466900,3501074993357575,548,7881615,5228809,52289,5176520
718,Mario Lemina,48,4044600,7557358709152858,465,6643405,1135754,11358,1124396
719,Alex Sandro,60,3609500,4045877401829594,518,6609994,5254535,526,5254009
720,Sean Longstaff,44,3114200,8427227383172492,403,5997138,2464068,2464068,0
721,Maxime Lopez,33,3547500,4851754937991987,363,5199978,1505544,151,1505393
722,Dejan Lovren,30,3283900,4697642836372219,302,4590940,3767335,376734,3390601
723,Dodi Lukébakio,25,2423000,7135419857960463,184,3220646,309152,3092,306060
724,Renato Sanches,40,1732500,9945806629711105,234,3018132,806978,0,806978
725,Pablo Maffeo,30,2833100,6230285315220460,268,4155807,3741722,3741722,0
726,Nemanja Maksimović,49,2352900,5619954042479093,347,4346733,4041595,4042,4037553
727,Tyrell Malacia,66,1360400,3247986330451522,367,3751733,3021681,3022,3018659
728,Ruslan Malinovskyi,47,3738600,8804779507914447,403,6423371,776645,777,775868
729,Agustín Marchesín,50,3501200,3709649356926383,444,6202823,6095460,6096,6089364
730,Fernando,66,2619800,4162976481639513,437,5464665,4648185,0,4648185
731,Konstantinos Mavropanos,68,1473200,8902301058740169,416,4388904,1620291,16203,1604088
732,Philipp Max,43,4159200,4132528713607662,425,6613686,6255580,0,6255580
733,Bryan Mbeumo,43,4299800,7374371949736366,476,6475935,5306118,5307,5300811
734,Junior Messias,40,3701800,4396341542281020,363,5337587,2249766,225,2249541
735,Luis Milla,66,2368000,7538957911355159,416,4880174,2426608,2426608,0
736,Moncayola,40,3278500,6495269581606093,356,5420808,4791524,47916,4743608
737,Hidemasa Morita,57,375000,3605981011251502,261,2009064,1130450,0,1130450
738,Neto,56,4838000,5776626563617634,576,8302149,1291537,1291537,0
739,Yvon Mvogo,34,2295800,7200669600780879,257,3853281,10182,0,10182
740,Galeno,41,976900,7069771533288538,183,1988004,1675332,1675332,0
741,Marcão,55,2515400,7938461907674625,419,4988678,1918950,1919,1917031
742,Fran Navarro,55,3725700,7648848501358687,505,6828748,1934063,1934063,0
743,Evan Ndicka,27,3710300,8245184164721949,305,5020638,4878752,488,4878264
744,Tanguy Ndombele,26,1252300,9823546213063038,111,1494363,1227927,12280,1215647
745,Victor Nelsson,70,2766900,8577654205337291,519,5931947,2149810,215,2149595
746,Jota,48,1053900,5993672277208558,231,2286133,883102,8832,874270
747,M'Bala Nzola,29,2828000,8603978179543890,278,4510750,1999259,199926,1799333
748,Michael Olise,55,1002900,9305753951935736,301,2728257,1823496,1824,1821672
749,Caio Henrique,37,498000,8471000229553694,162,1419625,267225,2673,264552
750,Mathías Olivera,23,1870200,4068339823520846,152,2594121,706810,707,706103
751,Riccardo Orsolini,52,3999800,7813336376297294,507,7243053,6862832,686284,6176548
752,Salih Özcan,50,4583300,6022469118641650,473,7599554,4718350,471835,4246515
753,Vangelis Pavlidis,48,3528400,9551979629752965,457,6673276,4349103,435,4348668
754,Pedraza,61,3669400,5956827368816488,547,7020601,307949,30795,277154
755,Nicolas Pépé,25,1537300,4296315390645985,143,2232529,1279830,1279830,0
756,Matteo Pessina,33,3494900,5630229146370139,359,5991654,52582,5259,47323
757,Quinn,23,586300,6908488826746783,52,538624,454031,0,454031
758,Predrag Rajković,69,2258200,4230250429367010,447,5030417,2817923,0,2817923
759,Arthur,57,2760900,5596152635599365,455,5465710,4428952,4428952,0
760,Jacob Ramsey,28,2488300,3026349738823113,206,3147476,1739407,174,1739233
761,David Raum,43,4000300,7564112691516209,474,6493001,3736947,374,3736573
762,Reguilón,53,2083200,8247795703289779,393,4294057,3545313,355,3544958
763,Tijjani Reijnders,62,3884800,5457357360909842,550,7883395,7000396,7001,6993395
764,Sérgio Oliveira,62,4635600,6098033791081490,564,8101716,550942,0,550942
765,Giovanni Reyna,31,4951900,6667657179229739,418,7184059,6231185,6231185,0
766,André Almeida,45,4426600,5485235156864534,466,7402510,5186827,518683,4668144
767,Dani Rodríguez,33,2691600,9639648542203920,304,4483485,2180549,0,2180549
768,Sergio Romero,30,1182700,3440423885703264,136,1800149,214900,0,214900
769,Mathew Ryan,32,2160600,7099163275287172,217,3325893,440812,0,440812
770,Alexis Saelemaekers,64,2834100,3877730786367388,452,6007528,3698731,369874,3328857
771,Antonio Sanabria,44,688700,4988478566767935,171,1695218,1071122,1072,1070050
772,Pablo Sarabia,41,3064300,9186741867391093,390,5193046,3122282,312229,2810053
773,Gianluca Scamacca,54,1417800,8407942706638154,327,3250449,2001870,2002,1999868
774,Stefano Sensi,38,4213300,3633092661947331,408,6668886,1490871,14909,1475962
775,Giovanni Simeone,57,1730100,8672645750087414,324,3771704,141627,14163,127464
776,Luis Sinisterra,45,2032200,6773831637233864,303,3567247,1429242,14293,1414949
777,Emile Smith Rowe,52,1987900,4112669556286495,362,4245007,4244977,42450,4202527
778,Borna Sosa,54,2810200,8364738952707926,398,5173402,3725123,373,3724750
779,Djibril Sow,24,4366200,6875574251012707,358,6392792,6085362,0,6085362
780,Taras Stepanenko,68,564200,5329931878088705,287,2503846,1545180,155,1545025
781,Lars Stindl,57,2067900,8200640282437702,415,4887939,3379979,33800,3346179
782,Renato Tapia,54,3602500,9260952588004006,443,6616968,6443353,645,6442708
783,António Silva,70,2949400,7736578621954586,558,6534875,2649672,2650,2647022
784,James Tavernier,40,938400,3365349581872941,166,1759474,1386820,139,1386681
785,Adrien Thomasson,54,434800,9493141742227664,225,1809477,1456209,0,1456209
786,Takehiro Tomiyasu,35,4440300,4592527369768340,417,6521519,6335901,0,6335901
787,Óscar Trejo,65,1698000,4063158696088202,387,4066377,2675361,0,2675361
788,Mike Trésor,35,541400,3999720286537514,106,996303,174541,1746,172795
789,Cengiz Ünder,59,1683400,8290341696821627,323,3841658,3644749,0,3644749
790,Myrto Uzuni,58,2277900,5487812297079273,439,5311771,1016702,102,1016600
791,Micky van de Ven,39,4779700,4398424249468052,497,7579918,3065851,30659,3035192
792,Branco van den Boomen,65,1745400,3677621201087568,425,4391893,2282747,0,2282747
793,Jamie Vardy,27,2056400,3592998626486817,208,3149135,831133,832,830301
794,Joey Veerman,57,2313200,6002970244973427,394,4641209,1220173,1221,1218952
795,Gabri Veiga,63,4561400,3579094304655148,679,8783713,1677092,1677092,0
796,Joël Veltman,40,1713500,8214901731606998,224,3063726,397378,3974,393404
797,Vesga,66,435800,5257456886491853,349,2828473,1493183,149319,1343864
798,Nikola Vlašić,34,4013400,6172680067395216,381,6364761,1169634,1170,1168464
799,Elye Wahi,54,2169000,3445043257850951,363,4457545,2030134,2031,2028103
800,James Ward-Prowse,61,2108100,4487679649877517,440,4609417,2822418,2822418,0
801,Adam Webster,48,2005800,7631950375107661,314,3810531,1001496,100150,901346
802,Joe Willock,61,1556200,5260341511310488,353,3997275,2138656,0,2138656
803,Patrick Wimmer,45,2909500,5130254306802048,346,4923003,3426663,3426663,0
804,Marius Wolf,25,4506000,6488594744140032,434,7403406,4273926,428,4273498
805,Yunis Abdelhamid,26,1235400,5408391254111489,107,1501074,1124822,11249,1113573
806,Luciano Acosta,49,2756800,7934257088453691,392,5348433,1584720,15848,1568872
807,Tosin Adarabioyo,22,1429800,5095833241137192,100,1649689,1065273,1066,1064207
808,Amine Adli,34,4664600,9875025145540340,418,7367854,4577245,0,4577245
809,Kerem Aktürkoğlu,44,2658700,3673117040502782,309,4317822,3104395,3104395,0
810,Salem Al Dawsari,46,1269000,9549185401386945,240,2656066,1012784,101279,911505
811,Nadiem Amiri,59,4396400,6696380294331504,622,8290054,2454922,2455,2452467
812,Stephen Eustáquio,45,2637800,5216633850236187,348,4610343,663612,664,662948
813,Luís Maximiano,22,3005200,7466757741007375,224,4082838,1299418,12995,1286423
814,Franco Armani,31,1841900,4836523930487278,168,2636702,1436361,1436361,0
815,Taiwo Awoniyi,68,1575400,9622549555095551,444,4442094,4251693,42517,4209176
816,Loïc Badé,30,2935400,3696422700687421,288,4744362,3776141,378,3775763
817,Tommaso Baldanzi,59,3159400,9543059186373672,484,6471387,2505272,2505272,0
818,Iván Balliu,42,4468800,6288851772536327,471,7206967,4303421,0,4303421
819,Jonathan Bamba,23,717700,7900740293502097,65,795036,61869,0,61869
820,Igor Paixão,66,1768200,4194142943297143,383,4315717,437609,437609,0
821,Esequiel Barco,25,3675500,3915247049919090,299,5121646,1096977,1097,1095880
822,Abdülkerim Bardakçı,67,602700,3175750938133083,339,3022007,908175,9082,899093
823,Musa Barrow,52,3480500,9638239075670698,488,5952010,3994622,0,3994622
824,Michy Batshuayi,52,860700,8490348025865162,242,2274460,508845,0,508845
825,Ihlas Bebou,49,873200,8560191807372154,245,2401466,314725,0,314725
826,Juan Bernat,23,4410900,8179197294930494,319,5652258,1538073,1538073,0
827,Philip Billing,65,2727400,6885852398164593,471,5739033,342663,342663,0
828,Janis Blaswich,46,632200,4860017914664684,225,2122763,30596,0,30596
829,Daley Blind,70,751400,9898463510228742,362,3240869,1487324,148733,1338591
830,Willian,25,425100,6456270239886243,55,417489,149363,150,149213
831,Fabio Borini,61,1914100,9155062110798490,410,4692260,3374721,0,3374721
832,Lucas Boyé,55,1336300,3679812512933414,336,3260143,85954,8596,77358
833,Martin Braithwaite,59,4454000,9217016017383970,607,8364311,7165887,717,7165170
834,Ante Budimir,35,610000,7310245290669677,144,1267830,197191,197191,0
835,Santiago Bueno,40,4230800,8127999582039197,418,6667157,4280066,428007,3852059
836,Alessandro Buongiorno,23,3779400,9064269041604087,343,5348985,4704270,0,4704270
837,Dominic Calvert-Lewin,33,2352100,5543356622349631,265,3946625,1168200,117,1168083
838,Gianluca Caprari,67,859800,5922091978699970,373,3227707,582697,5827,576870
839,Timothy Castagne,42,4801100,8657322432787215,554,8107158,4910642,49107,4861535
840,Danilo Cataldi,24,1735900,5072078511157679,143,2477833,319347,31935,287412
841,Franco Cervi,68,4825200,9847259302829791,683,9069553,3072852,30729,3042123
842,Trevoh Chalobah,29,1049500,8879031953591716,141,1690375,730485,7305,723180
843,Viktor Claesson,43,2026500,4656515799874929,311,3827121,2417803,242,2417561
844,Dodô,32,1475900,6938396198394185,160,2045443,1332631,1333,1331298
845,Joaquín Correa,25,3279700,6898145416759791,276,4699318,1646623,16467,1630156
846,Jaume Costa,68,3975200,6636504682767372,560,7764486,7654110,76542,7577568
847,Aaron Cresswell,52,1368500,8456780576933523,263,2768879,1012656,0,1012656
848,Danilo D'Ambrosio,29,1921600,3039017966893402,240,3313806,1052896,1053,1051843
849,Ben Davies,52,2183000,9066909199138129,343,4290418,13007,1301,11706
850,Craig Dawson,35,1497000,8981177809233970,201,2587304,668663,6687,661976
851,De Frutos,25,1391200,8204986574043573,116,1721631,540999,5410,535589
852,Vanderson,49,2310900,7642684146830527,334,4149396,2296096,0,2296096
853,Michael,23,2726600,5754253335662328,257,4202371,12837,1284,11553
854,Merih Demiral,50,1208900,9435115207658066,303,2952892,14430,14430,0
855,Paulinho,64,1590800,8006630138922663,357,3743333,2880685,0,2880685
856,Samuel Lino,22,1711300,3928211225552260,158,2578009,333755,33376,300379
857,Eric Dier,29,4481500,8070453051677201,426,6632199,2737179,0,2737179
858,Sofiane Diop,67,3058500,8398739148859351,572,7067462,1706658,170666,1535992
859,Yehvann Diouf,58,4822400,3184116531980264,536,7672634,779806,7799,772007
860,Dakonam Djené,53,3354400,7537028039136898,446,6172101,53967,0,53967
861,Berat Djimsiti,39,3216200,3744898675327726,375,5292664,3269263,0,3269263
862,Jérémy Doku,46,4249600,9887056576200179,495,7114568,2664162,0,2664162
863,Nicolás Domínguez,22,2492100,9781650481504614,214,3587880,3488309,34884,3453425
864,Éderson,52,1572500,5272517346790891,310,3423373,3105750,3106,3102644
865,Abdoulaye Doucouré,29,2025700,5454382846452589,184,2911185,2197683,220,2197463
866,Bartłomiej Drągowski,39,2910800,3765202199864859,329,4841548,291643,291643,0
867,Marvin Ducksch,33,1906200,9419076460767235,251,3153034,421630,42163,379467
868,Harvey Elliott,55,4555400,9057952770352090,580,8165987,2011628,2012,2009616
869,Nico Elvedi,25,2237300,8308519716418235,200,3045314,1812558,0,1812558
870,Gonzalo Escalante,50,2595700,7664222847688733,387,5235242,1390571,1391,1389180
871,Nicolò Fagioli,53,2807600,5014721004479562,404,5635019,3217752,322,3217430
872,Romain Faivre,31,2704500,8317058636537510,239,3862752,2321838,0,2321838
873,Fábio Vieira,64,3306700,6673134405543118,511,6411371,4452362,0,4452362
874,Jordan Ferri,48,4157600,4552630374059467,509,7189216,2428339,0,2428339
875,Pablo Fornals,32,1996900,5692385984749136,220,3199937,819380,81938,737442
876,Kyogo Furuhashi,59,907400,3691862627364969,303,2841355,1576963,15770,1561193
877,Levi García,29,3965000,5575807526204162,343,5517399,3874196,0,3874196
878,Raúl García,23,4672200,7896183300444692,325,5759948,5374486,0,5374486
879,Rodrigo Garro,70,3856600,8289785778007897,607,8111722,2362076,0,2362076
880,Yannick Gerhardt,46,4392500,5597889525271000,495,7291400,6889051,688906,6200145
881,Morgan Gibbs-White,30,996200,4784655188357271,123,1510610,1396039,140,1395899
882,Rafał Gikiewicz,69,735600,5168162750774576,292,2729856,1993286,19933,1973353
883,Bryan Gil,59,2422800,3054175900896099,442,5084840,322571,322571,0
884,Maximiliano Gómez,54,646000,8696947487215633,230,2036005,1275338,1275338,0
885,Leandro González Pirez,57,1723500,3075952141926108,349,4180081,1174053,11741,1162312
886,Demarai Gray,42,2961700,5063244689891657,358,4872604,4061433,0,4061433
887,Marko Grujić,47,3586000,8573000502912401,420,6185495,3224855,3225,3221630
888,Idrissa Gueye,52,870400,4181029337716432,213,2013895,65692,65692,0
889,Pape Gueye,24,338400,5913139853204940,46,313228,152082,153,151929
890,Serhou Guirassy,67,2817300,9720341111253893,536,6352421,4190589,4191,4186398
891,Arda Güler,58,1115900,9726394669746292,293,3047032,172767,1728,171039
892,Guruzeta,46,2920200,4468333645340476,387,5085398,3040431,3041,3037390
893,Abderrazak Hamdallah,40,4807900,4560322577949767,554,7732838,6632353,0,6632353
894,Javier Hernández,49,3222600,7945179171380316,392,5675470,2123374,2124,2121250
895,Bryan Heynen,60,1205800,5143312152632663,310,2987627,376701,0,376701
896,Morten Hjulmand,42,3335300,3342040257834641,399,5591382,4330827,43309,4287518
897,Adam Hložek,51,921900,7870710724379256,240,2297985,1989711,19898,1969813
898,Andreas Pereira,44,3470000,4960862394896404,418,5733580,4088832,40889,4047943
899,Tomáš Holeš,41,1239600,7932266558774716,231,2482969,2360694,237,2360457
900,Timo Hübers,56,612100,5074358224953364,258,2323756,1515955,0,1515955
901,Jonathan Ikoné,60,3934200,8225165434084473,582,7172610,6812207,6812207,0
902,Illarramendi,35,4230100,7930284994304833,423,6490660,4628357,4628357,0
903,Danny Ings,65,1651200,8392963304264380,426,4280028,3308739,331,3308408
904,Ko Itakura,60,4174600,8350620639816845,592,8249398,5511358,5512,5505846
905,Vincent Janssen,23,4303300,6288418576525756,389,6398148,982764,982764,0
906,Adnan Januzaj,66,1096300,6861648318285045,371,3766132,855316,856,854460
907,Sequeira,62,3481100,7268987176158751,562,6976636,3338777,334,3338443
908,Curtis Jones,49,1389500,4896328172209576,306,3206052,1294137,0,1294137
909,Luka Jović,59,4154600,5060869816746664,568,8047195,2420430,0,2420430
910,Josip Juranović,49,4057900,8094037858432604,522,7365472,1690749,169075,1521674
911,Ferdi Kadıoğlu,31,688400,9402101596269040,85,902270,772135,773,771362
912,Saša Kalajdžić,55,1217900,9964294767173451,278,2845577,418206,419,417787
913,Jesper Karlsson,59,2989600,5195856862993114,480,6122861,2071241,2071241,0
914,Michael Keane,42,2351400,8735516511911348,317,4286827,3877057,0,3877057
915,Justin Kluivert,37,1588000,6176030341797370,212,2817946,2326558,0,2326558
916,Robin Knoche,40,1735100,7802981903926198,273,3449778,2603253,261,2602992
917,Dominik Kohr,33,3337800,9513325889664116,290,5156355,3978810,3979,3974831
918,Ghislain Konan,42,2696200,3744311058343374,333,4457160,2098299,210,2098089
919,Kouadio Manu Koné,58,1847200,9500410613352525,421,4385607,3344803,0,3344803
920,Christian Kouamé,44,632500,3516559845038793,204,1768760,425556,0,425556
921,Christoph Kramer,43,3258300,8050458312209461,361,5236092,5167919,0,5167919
922,Ladislav Krejčí,22,1843200,7075294949962024,146,2587502,2165813,217,2165596
923,Enzo Le Fée,58,2457600,6123856987996748,469,5443669,4844114,4844114,0
924,Florian Lejeune,53,1316700,3016618037448231,248,2701929,1761382,1762,1759620
925,Clément Lenglet,38,2533500,7132780907839691,283,4107273,125515,0,125515
926,Jefferson Lerma,44,4646300,4150906494324519,536,7862707,5550363,5550363,0
927,Jesper Lindstrøm,33,2327400,7303967840539503,230,3376174,3349279,3350,3345929
928,Marko Livaja,64,3183100,4356761299375675,538,6723841,597389,597389,0
929,Diego Llorente,27,2674400,3119338486275514,248,3883583,3437455,3437455,0
930,Ruben Loftus-Cheek,46,1983900,6672122820437462,286,3597662,3439834,3440,3436394
931,Pedro Neto,24,793600,8991359526692238,82,942394,471653,4717,466936
932,Castello Lukeba,54,3912200,4655151874338547,493,7081715,6148379,0,6148379
933,Saša Lukić,53,338000,4994590680346218,230,1762849,1661872,1662,1660210
934,André Horta,62,708600,7992739803192930,295,2480463,2440882,0,2440882
935,Darwin Machís,27,882600,5515411643359313,97,1252050,46782,46782,0
936,Noni Madueke,43,4489100,7838325591718837,489,6863200,3853160,3854,3849306
937,Joakim Mæhle,34,2684000,4763471139669844,261,4064679,19081,19081,0
938,Marcano,38,1649400,4875914006066326,227,2865129,713645,7137,706508
939,Guillermo Maripán,66,2469600,6670393521055385,490,5795338,2008490,200849,1807641
940,Lucas Martínez Quarta,27,1303800,8775113919367128,155,1906537,1418442,0,1418442
941,Jordi Masip,63,3127800,6240958676027013,525,6175027,1466324,0,1466324
942,Clinton Mata,54,4770500,8847794783643499,588,8783583,2678302,0,2678302
943,Melendo,23,2309000,4283093472130504,186,3086045,1782319,17824,1764495
944,Domingos Duarte,46,4316800,3691608495053531,468,6819890,5411810,5411810,0
945,Pere Milla,44,1535000,3619147774474650,244,3027121,2575698,25757,2549941
946,James Milner,48,4243900,3527240652164989,517,7160117,4698846,4699,4694147
947,Yerry Mina,53,776400,8569032416121688,221,2229940,1997153,1997153,0
948,Rafa Mir,56,593400,5973977164379799,251,2115665,702804,703,702101
949,Alexey Miranchuk,27,4152600,9243270856465123,401,6350344,5684008,569,5683439
950,Miranda,43,3107500,8376629069544072,398,5608583,3262140,32622,3229518
951,Terem Moffi,66,3341100,7013207132218983,508,6716104,2638064,2638064,0
952,Johan Mojica,27,3304600,7048773653535101,313,5195853,3728786,37288,3691498
953,César Montes,31,3757000,7781752274915662,347,5528492,5332064,533207,4798857
954,Lorenzo Montipò,56,3333500,9667627693970708,462,5737901,4249580,0,4249580
955,Trincão,44,2243300,3490264023332051,328,3902867,2508396,251,2508145
956,Youssoufa Moukoko,58,4599100,4058494671518975,514,7541299,6943384,6943384,0
957,Marshall Munetsi,34,4972700,3224409193879659,487,8315476,2938545,2939,2935606
958,Daniel Muñoz,64,1055900,5289608747531338,373,3690422,2170661,2171,2168490
959,Rodrigo Becão,50,2292100,7162266052145407,401,4991647,333345,0,333345
960,João Mário,37,3015200,3871327531578900,332,4759367,2255189,2256,2252933
961,Moussa Niakhaté,32,2186200,7908954903423262,224,3226354,2127382,2127382,0
962,Felix Nmecha,37,4642700,9023866233876294,488,7098314,2978071,297808,2680263
963,Lukas Nmecha,27,408600,6026291874673800,80,627718,278097,0,278097
964,Christian Nørgaard,54,4357700,6962530085571089,520,7663015,4496968,44970,4451998
965,Unai Núñez,30,2801000,6365254272505039,281,4395371,3367606,0,3367606
966,Anthony Nwakaeme,38,1187100,5520555493103066,229,2427306,1913819,192,1913627
967,Brian Oliván,39,2732300,9249800411532348,339,4865070,360372,0,360372
968,Emerson,67,4461600,5380720106895088,675,8967784,5418067,541807,4876260
969,Leandro Paredes,40,2840600,9020945056926199,332,5060132,2629125,262913,2366212
970,Fabiano Parisi,66,4680400,8482949525183236,670,9208300,3298280,0,3298280
971,Jiří Pavlenka,29,4765300,4139801659966217,385,7266179,2341978,0,2341978
972,Enzo Pérez,38,3405600,7393937504374936,353,5636148,1793204,1793204,0
973,Andrea Petagna,28,3284000,3283875270832519,290,4860761,4470377,448,4469929
974,Orbelín Pineda,28,1496000,7320432848766068,173,2215799,1549718,154972,1394746
975,Alassane Plea,41,3690700,5112239816767153,446,6272431,178233,178233,0
976,Stefan Posch,40,3922100,8276718712070632,443,6715193,3658820,366,3658454
977,Yaroslav Rakitskyi,34,4514100,6378814338058162,481,6765361,19753,19753,0
978,Ante Rebić,69,4789600,6617849897945144,633,8426421,4251312,425132,3826180
979,Nathan Redmond,31,1088000,8570117450226581,167,1923669,1540385,1541,1538844
980,Pepe Reina,42,4328400,7502431994881517,510,7296486,4215878,0,4215878
981,Thierry Correia,53,4140600,7472882364681389,513,7369522,447193,448,446745
982,Mateo Retegui,40,4341500,4426482205275839,458,7364747,6082912,60830,6022082
983,Diego Rico,67,1238100,5827586967341370,348,3454464,1068019,0,1068019
984,Manuel Riemann,44,743900,7008948007418232,204,2009001,1138710,114,1138596
985,Riquelme,50,2747600,8012475756874235,386,5330435,5308227,530823,4777404
986,Fábio Cardoso,50,4259100,8970303226560316,531,7512082,6302580,6303,6296277
987,Marcos Rojo,29,3795000,3080824378761635,318,5336150,4978609,0,4978609
988,Luiz Henrique,33,2840000,4023712318123525,261,4397956,2417790,242,2417548
989,Nicolò Rovella,25,3846700,4496781653303549,370,6225836,3443370,344337,3099033
990,Raúl Ruidíaz,39,3541400,8800636684536269,397,5541995,3030589,304,3030285
991,Julian Ryerson,49,730000,3028051879625693,199,1883995,833736,834,832902
992,Youssouf Sabaly,38,3993300,6858060952476835,407,6421942,4525355,452536,4072819
993,Umar Sadiq,52,4971900,4344917771228351,577,8300396,1278710,1279,1277431
994,Davinson Sánchez,64,2614800,3749782755618402,473,5234730,1307170,1308,1305862
995,Rodri,38,1197800,5024531991404021,192,2313982,1810321,182,1810139
996,Baptiste Santamaria,23,3927300,4911384583132780,311,5497895,3681849,0,3681849
997,Marvin Schwäbe,65,4816200,3657276376390938,694,9106192,5304722,53048,5251674
998,Mykola Shaparenko,28,3312100,5426583304931072,312,4859698,1219536,12196,1207340
999,Oliver Skipp,61,1646900,4995914040413685,332,3860124,736135,737,735398
1000,Łukasz Skorupski,32,2480800,6345392908794492,233,3674338,593512,59352,534160
1001,Andreas Skov Olsen,54,634500,7831583572669484,247,2175846,210429,210429,0
1002,Manor Solomon,23,3277100,6796432821927855,261,4576055,19792,198,19594
1003,Florian Sotoca,40,3627700,9394056111144974,370,5459565,4082981,0,4082981
1004,Çağlar Söyüncü,53,747000,5521751787101184,259,2381187,1907625,191,1907434
1005,Marco Sportiello,66,1767600,4726167793707046,417,4626078,3280680,3280680,0
1006,Jeremiah St. Juste,45,1130800,7657850012878690,230,2443211,504554,504554,0
1007,Nicolae Stanciu,26,551300,6025751239793249,95,828906,43236,0,43236
1008,Gabriel Strefezza,35,4667100,6152971668488122,439,6600397,1366902,1366902,0
1009,Cristhian Stuani,22,2004100,4698624705441387,143,2507797,1774647,1774647,0
1010,Damián Suárez,29,2952400,6591821753081790,275,4013543,2868254,2868254,0
1011,Sebastian Szymański,31,487200,5109751062840410,117,1054543,204082,0,204082
1012,André Gomes,46,4775600,3663162749431155,561,7885624,3151901,3152,3148749
1013,Arthur Theate,66,1369400,5036384411655863,390,3912270,2452878,0,2452878
1014,Malick Thiaw,42,1813700,6856347335993867,274,3532668,1988766,1988766,0
1015,Lucas Torró,35,1556200,4156021093407643,202,2726029,1666370,16664,1649706
1016,Lucas Tousart,70,4506400,7863147538308785,652,8205490,7490766,7491,7483275
1017,Manu Trigueros,25,3654400,5228369120838623,335,5521189,3015699,3015699,0
1018,Christopher Trimmel,28,2570000,3349287769804514,238,3649996,810695,81070,729625
1019,Anatoliy Trubin,36,4348200,6961099411944234,382,6368788,5391680,0,5391680
1020,Konstantinos Tsimikas,42,2427700,9910265646323096,320,4346716,658743,659,658084
1021,Bruma,37,2055100,7372059027952320,273,3645803,1094268,10943,1083325
1022,Matt Turner,56,3580100,6896527876080508,508,6669525,4831210,0,4831210
1023,Destiny Udogie,54,2239600,9596346340820958,338,4543697,107508,1076,106432
1024,Martin Valjent,23,1224400,4884236695305690,104,1543525,1438237,144,1438093
1025,Donny van de Beek,31,3729600,4712384763940146,318,5377895,281960,281960,0
1026,Matías Vecino,45,330600,6184261170980330,153,1094738,541189,0,541189
1027,Wout Weghorst,60,314700,9730121964481804,256,1939220,112519,11252,101267
1028,Mitchell Weiser,50,1806900,3304637533812365,321,3841462,2042236,2042236,0
1029,Yoane Wissa,38,2677700,9841423516618797,301,4203287,4149197,414920,3734277
1030,Laurent Abergel,70,330100,8003654300862073,333,2697686,2454253,0,2454253
1031,Ruben Aguilar,24,1296700,6130487277536167,110,1592011,109172,1092,108080
1032,Ai Kesen,48,3823600,5089067474122483,483,6589325,6061774,606178,5455596
1033,Chuba Akpom,70,3849200,5821790099897368,554,7263461,3398264,339827,3058437
1034,Omar Alderete,28,1083000,5051945595001544,136,1688366,1270235,0,1270235
1035,Helton Leite,44,4099800,3517000517838365,451,6501955,3955722,0,3955722
1036,Alexander Alvarado,53,3733200,5382359098604380,484,6674697,145625,145625,0
1037,Nordin Amrabat,52,3016000,6073797729027494,434,5396355,4515569,451557,4064012
1038,Houssem Aouar,53,1852400,5518992856779350,320,3585694,3089853,3089853,0
1039,Cristian Arango,42,373700,4400928786369093,159,1173299,212570,21257,191313
1040,Ludwig Augustinsson,34,4300900,6044279751242953,461,6870948,1672743,168,1672575
1041,Iddrisu Baba,56,3149800,4983323671584095,487,6257335,4534509,453451,4081058
1042,Álex Baena,48,2472600,8502834798268982,312,4196253,3028341,3028341,0
1043,Eric Bailly,38,2822200,8693114963878820,303,4583849,1400168,1400168,0
1044,Cédric Bakambu,36,2141100,3677202917957250,269,3553129,2233675,0,2233675
1045,Anastasios Bakasetas,52,2860800,5385473881200210,389,5351288,1723660,173,1723487
1046,Leonardo Balerdi,55,3181600,9715015916152904,457,6298683,4894094,0,4894094
1047,Bradley Barcola,56,3294100,5834645880001129,488,6350240,83555,836,82719
1048,Leandro Barreiro Martins,69,342800,5401534504604406,289,2160539,1141010,0,1141010
1049,Augusto Batalla,48,4769100,6825399509861752,608,9065764,2319186,23192,2295994
1050,Altay Bayındır,54,585800,8053471185399964,256,2260452,2018609,2018609,0
1051,Lucas Beltrán,68,2900400,8379422128076994,478,5806065,4777882,4778,4773104
1052,Marco Bizot,46,2008200,4335746129513148,304,3620502,2928041,293,2927748
1053,Willy Boly,31,1774200,5459295042396299,196,2768087,1490094,1491,1488603
1054,Sebastiaan Bornauw,57,4471000,7277318415940474,521,7667376,1471515,147152,1324363
1055,Rafael Santos Borré,27,1422000,8449309360139564,137,1932320,210812,0,210812
1056,Olivier Boscagli,68,3917000,5286115868566329,589,7790675,5290044,0,5290044
1057,Hicham Boudaoui,43,4734300,9520057937095675,477,7196482,3096439,0,3096439
1058,Aaron Boupendza,24,4257800,8486550588352542,304,5851825,4311529,0,4311529
1059,Malcom Braida,62,367600,9572558493389952,292,2188645,1288653,129,1288524
1060,Josip Brekalo,25,4413800,8466854032049215,369,6034705,39818,39818,0
1061,Alberto Brignoli,50,1018000,9058112158270284,276,2698664,981554,0,981554
1062,Brian Brobbey,44,4881500,7471108686815351,539,7658959,4247833,425,4247408
1063,John Brooks,26,896600,3902297910529430,92,1196256,1125332,11254,1114078
1064,Roman Bürki,35,4128900,5840058053879087,466,7428400,2616619,262,2616357
1065,Javier Burrai,32,4086100,5232710391822179,406,5973020,1735988,17360,1718628
1066,Vitaliy Buyalskyi,26,1622100,6253029738868617,174,2392553,1775822,0,1775822
1067,Anthony Caci,68,1036300,8194665612367534,368,3399735,3302190,331,3301859
1068,Duje Ćaleta-Car,57,3009800,9330452225163861,452,6104586,6063205,6063205,0
1069,Francesco Caputo,42,4290500,9982817609112046,461,7076896,2601142,2601142,0
1070,Cameron Carter-Vickers,70,4865100,3189887776593371,634,9344667,4926150,49262,4876888
1071,Vitinha,50,2908800,5246336276183560,376,5130624,841490,842,840648
1072,Carlos Júnior,38,1894100,5646240278601189,279,3588167,2189791,21898,2167893
1073,Milton Casco,42,4662100,9468544184899218,512,7893991,507156,508,506648
1074,Jonny,30,2830000,4549569692728555,252,3984283,2311636,0,2311636
1075,Zeki Çelik,34,1454500,8333626252636595,185,2174524,801581,80159,721422
1076,Václav Černý,33,792300,7112990341735362,125,1349641,844873,844873,0
1077,Conor Coady,46,3258400,9833666999827708,409,5563270,618240,6183,612057
1078,Nathan Collins,23,3271000,6931660846371400,264,4950390,4107164,4108,4103056
1079,Eray Cömert,36,4055000,6480757626841687,440,6354953,674330,675,673655
1080,Maxwel Cornet,63,4529300,5174122535910391,630,9177408,452477,452477,0
1081,Josh Cullen,26,1529900,9061793142490378,138,2022774,429119,4292,424827
1082,Eric Curbelo,23,3617300,4327926061383591,264,4811462,1723801,0,1723801
1083,Hugo Cuypers,69,862400,4492808188616308,404,3534620,204985,20499,184486
1084,Davidson,67,2800100,3553075408123917,520,6634660,359444,360,359084
1085,Willian José,30,1549000,8254176371427769,186,2257960,1921680,1922,1919758
1086,Mikkel Damsgaard,56,3089600,5127950359529595,471,6309294,5304751,530476,4774275
1087,Ignacio De Arruabarrena,45,693100,6452590754475077,187,1643489,1096286,1096286,0
1088,Bobby De Cordova-Reid,53,1992500,4381610720803741,297,3837412,2862991,2862991,0
1089,Charles De Ketelaere,39,4513900,5573346336420068,455,6895646,1547439,15475,1531964
1090,Mattia De Sciglio,59,4658700,9599302225693034,644,8587748,5236571,0,5236571
1091,Moussa Dembélé,68,1001100,7547525306221391,322,2892644,738504,738504,0
1092,Sergiño Dest,25,2065300,7625431942979204,193,2860145,2613335,2614,2610721
1093,Kiernan Dewsbury-Hall,60,538300,8535415392696054,249,2234881,1090168,10902,1079266
1094,Mouctar Diakhaby,24,3489100,5323141897913548,287,4616747,1625441,1625441,0
1095,Paulo Díaz,43,1383100,8600935977682390,259,2800057,854085,0,854085
1096,Dénes Dibusz,22,1885000,4748816921682959,127,2406767,502046,5021,497025
1097,Alexander Djiku,36,3822000,6076317748257938,383,5711072,2200967,2200967,0
1098,Oscar Dorley,23,407900,7462580420679949,40,341713,35053,0,35053
1099,Niklas Dorsch,38,894500,8987994920400462,185,1780474,1176150,0,1176150
1100,Igor,33,4228700,6357564577627554,387,6633418,981770,0,981770
1101,Maxime Dupé,28,4830000,8821038428575133,440,6885204,1476495,0,1476495
1102,Tiago Djaló,44,929300,8442675293249849,208,2038884,1162796,0,1162796
1103,Embarba,60,3344200,3330735137588645,486,6495014,1001619,1002,1000617
1104,Frank Fabra,67,2031100,8103849594410034,410,4983301,379395,0,379395
1105,Wout Faes,69,1376400,4267319483025009,408,4193647,1599003,15991,1583012
1106,Fayçal Fajr,41,614900,6592255232231882,157,1375498,832820,0,832820
1107,Wladimiro Falcone,41,1027400,9191600297104211,214,2050082,1508970,151,1508819
1108,Marco Davide Faraoni,46,4155500,6419629488665883,516,7182776,4247918,0,4247918
1109,Lorenzo Faravelli,36,1180400,5759082487382048,182,2151352,2066829,20669,2046160
1110,Christian Fassnacht,41,3381800,3824879127255947,388,5700083,5344465,53445,5291020
1111,Jesus Ferreira,51,4940600,6090862531671068,595,8397438,6437298,64373,6372925
1112,Nicolás Figal,32,3880600,9930472814162988,349,5447174,2055472,20555,2034917
1113,Fraser Forster,69,4582700,3240483119229972,642,9000394,4622446,4622446,0
1114,Angelo Fulgini,58,3458100,3720244473457822,523,7307287,6317459,63175,6254284
1115,Patric,36,2354700,5914424921984799,273,3775065,258301,2584,255717
1116,Mijat Gaćinović,33,2595100,5354361649915114,299,3970685,1836027,1837,1834190
1117,Kévin Gameiro,62,4889500,6090125426810231,618,9583223,1989154,1989154,0
1118,Dani García,64,1530600,6374307466851180,318,3219318,1012624,1013,1011611
1119,Johan Gastien,28,4683300,9155553493606845,436,7340094,6963407,69635,6893772
1120,Federico Gatti,41,2722000,9927961260174238,340,4430949,1401718,0,1401718
1121,Ryan Gauld,38,2037200,4294148312576686,263,3405682,492788,0,492788
1122,Dániel Gazdag,28,3441600,8821987399003101,331,5387236,3436503,344,3436159
1123,Adrià Pedrosa,32,848900,5399002395806033,133,1324142,341248,34125,307123
1124,Pierluigi Gollini,60,2422700,7092241221863816,421,4965373,4620683,463,4620220
1125,Angel Gomes,48,910600,8001142935382679,234,2231708,1637729,0,1637729
1126,João Gomes,45,2163100,9690337325927733,330,4200729,2631199,26312,2604887
1127,Nico González,65,4459900,7821840764234437,681,8687550,1678232,167824,1510408
1128,Craig Goodwin,48,3858700,7335623307285181,473,7158345,2336239,234,2336005
1129,Gorosabel,64,586700,3979124688905738,289,2424254,206302,0,206302
1130,Florian Grillitsch,60,2841200,6574480913602523,467,5834697,4652608,0,4652608
1131,Andrés Guardado,47,3045000,4560149861201118,416,5802329,3585553,35856,3549697
1132,Frédéric Guilbert,67,2152100,6180950994651623,446,5337777,2050769,206,2050563
1133,Malo Gusto,69,2118900,8855299532969840,428,5217909,388719,38872,349847
1134,Massadio Haïdara,66,2977800,9734425945532708,535,6175490,2018974,20190,1998784
1135,Marcel Halstenberg,50,1183300,8925114420057031,278,2837140,824051,8241,815810
1136,Lukáš Haraslín,26,4793100,9822587166911588,390,6269224,5860473,58605,5801868
1137,Amine Harit,51,1274300,3098847715715824,274,3133232,1148538,11486,1137052
1138,Jack Harrison,47,4609800,7668608978926880,554,8604149,5589826,0,5589826
1139,Trezeguet,35,2760000,6316404474684159,289,3913740,3363217,33633,3329584
1140,Cucho Hernández,62,4201800,6458787402251002,595,7838897,7612586,7613,7604973
1141,Aridane,40,1970400,9906355231508766,291,3689530,1341727,135,1341592
1142,Guido Herrera,64,2124800,3225057566464643,390,4657325,3268371,0,3268371
1143,Yangel Herrera,35,3613300,4621010822296755,391,6011864,2884508,28846,2855662
1144,Aaron Hickey,54,3114600,9130101778430659,473,6502748,6347447,0,6347447
1145,Marwin Hitz,47,634500,3854850354193956,219,2080144,123180,1232,121948
1146,Nicolas Höfler,29,3280300,7029423093054249,286,4495410,1238160,123816,1114344
1147,Rasmus Højlund,59,663200,5662764861160366,275,2480490,2086749,2086749,0
1148,Rob Holding,30,2252700,3291244025804989,252,3611078,2565228,25653,2539575
1149,Franck Honorat,39,3243000,9790350617124578,358,5453522,5262245,0,5262245
1150,Hwang Hee Chan,50,1887600,6410940817938164,311,3730961,3279598,32796,3246802
1151,Elseid Hysaj,37,429000,4051445894941759,124,948742,832029,8321,823708
1152,Kelechi Iheanacho,29,1154100,3856867796408234,128,1734914,435397,436,434961
1153,Ivan Ilić,58,4161000,9867655310894904,589,7912559,1469130,146913,1322217
1154,Sverrir Ingi Ingason,45,2611700,8459129910717132,323,4529102,4026240,40263,3985977
1155,Luka Ivanušec,53,1831800,9445825636708924,325,3564746,1446427,0,1446427
1156,Alex Iwobi,46,2846500,9925688457331641,358,4953972,4306975,43070,4263905
1157,Vitaly Janelt,51,4703800,4223724376157270,505,8253577,1742405,1743,1740662
1158,Mathias Jensen,55,3471600,6950501465390787,527,6703262,6281139,0,6281139
1159,Raúl Jiménez,46,3587800,4381629134649446,476,5908365,785288,7853,777435
1160,Brennan Johnson,53,3919000,6030034050338077,484,6823370,1326766,1326766,0
1161,Sam Johnstone,29,2928700,3019480615978241,258,3992505,3908529,391,3908138
1162,James Justin,27,4120700,6743180248667018,354,5863775,4542267,455,4541812
1163,Arnaud Kalimuendo,34,1917700,5645670326790457,255,3434343,2586176,259,2585917
1164,Thilo Kehrer,51,962000,8659528639324240,247,2320039,1151921,1152,1150769
1165,Ryan Kent,31,3929000,3159517586024050,346,5705269,1354142,13542,1340600
1166,Rani Khedira,44,3555000,6056328747845648,399,5599681,698424,699,697725
1167,Max Kilman,33,3916200,6531576008231714,404,6166151,3821430,383,3821047
1168,Davy Klaassen,38,1342100,8829507003400569,173,2152650,1217123,0,1217123
1169,Robin Koch,42,3377500,9550306108237381,433,6078771,1853303,185331,1667972
1170,Odilon Kossounou,36,3068300,4362806420906600,374,4939547,4337461,4338,4333123
1171,Alex Král,65,3751500,5502035880877243,533,7002592,1757794,176,1757618
1172,Max Kruse,37,2634000,4531137378940231,346,4860913,1958834,0,1958834
1173,Jan Kuchta,53,4356400,3543338143064451,529,7477558,5001859,0,5001859
1174,Maxence Lacroix,57,2771300,9960398027187915,452,5922282,2219932,221994,1997938
1175,Aïssa Laïdouni,68,2478400,5235846622422263,505,6001596,4397803,4397803,0
1176,Adam Lallana,29,1135600,5042431408868327,143,1754614,1406075,141,1405934
1177,Manuel Lanzini,65,4023200,9334714054715252,553,7277487,1243347,125,1243222
1178,Julien Laporte,60,3653200,3746962191172943,532,7197698,1713344,172,1713172
1179,Darko Lazović,41,3481700,5404722362339013,434,6189807,5665289,5665289,0
1180,Benjamin Lecomte,37,2687700,7354764249316054,332,4486859,4296912,4297,4292615
1181,Pierre Lees-Melou,52,3334200,3697519405604735,441,6117017,1139819,11399,1128420
1182,Chiquinho,60,2129900,3623302898526722,429,5137966,2797751,2798,2794953
1183,Dejan Ljubičić,70,4837900,7388768659655827,659,8400775,3691479,0,3691479
1184,Nicolás Lodeiro,40,2975300,3232891183701232,341,5117630,4914042,491405,4422637
1185,Deiver Machado,69,2550100,4979838275707138,476,5666368,2659437,2660,2656777
1186,Aïssa Mandi,62,1337400,5447247313345737,364,3778963,3002421,3002421,0
1187,Rolando Mandragora,48,2832600,6284907868017584,335,4616273,908749,9088,899661
1188,Orel Mangala,31,703400,3851048290271584,126,1243040,1207814,1207814,0
1189,Petros Mantalos,37,3627300,3890505486650351,379,5507856,2972168,29722,2942446
1190,Pablo Marí,49,2444500,3817522505858546,345,4337456,3311242,0,3311242
1191,Răzvan Marin,45,4926200,7764280213511893,545,8618061,5416409,542,5415867
1192,Óscar Valentín,37,4712500,8925361981476060,446,6882510,5694496,570,5693926
1193,Toni Martínez,48,3633800,5745722209411656,458,6206709,689291,6893,682398
1194,Arthur Masuaku,58,4881300,9900532159867978,644,8498470,6187050,619,6186431
1195,Azor Matusiwa,38,587800,5484344789816344,148,1359902,164693,1647,163046
1196,Mykola Matviienko,32,1191100,3251286189455319,161,1997267,1752626,175263,1577363
1197,Stephy Mavididi,40,3598200,7067113187317658,373,6084385,3514766,3514766,0
1198,Alexandru Maxim,32,3877100,4719481751926619,397,6147336,2739263,0,2739263
1199,Kevin Mbabu,37,2037700,7847547480239820,249,3157593,1242441,0,1242441
1200,Weston McKennie,65,1365200,8708507974393444,365,3859510,307889,30789,277100
1201,Dwight McNeil,43,3474000,7214904733385946,410,6070155,5705024,570503,5134521
1202,Brandon Mechele,38,4568800,7429122708375122,482,7429013,223104,223104,0
1203,Medrán,40,1889400,9648175745653841,278,3174115,1744565,175,1744390
1204,Birger Meling,39,1489200,5947233050819195,240,2898748,1000991,100100,900891
1205,Thomas Meunier,22,1832600,5769882461377743,103,2007258,611384,61139,550245
1206,Paulo Victor,53,2445400,3916996869077953,385,5010213,2239668,0,2239668
1207,Vanja Milinković-Savić,70,2207000,8785560817354588,420,4619732,1855930,1856,1854074
1208,João Paulo,59,1952000,3331370417174389,355,4096417,998409,100,998309
1209,Tyrick Mitchell,25,4201000,3472898265859498,317,5352348,1318800,13188,1305612
1210,Álvaro Montero,54,3227500,3583544225844400,480,6113123,5867642,5868,5861774
1211,Aníbal Moreno,66,717500,5999622603807005,368,3135198,2346807,23469,2323338
1212,Alberto Moreno,29,3844300,3279896217861930,366,6055437,2401699,2402,2399297
1213,Jacob Murphy,36,2377700,4415085947136088,294,4090223,132161,1322,130839
1214,Kosuke Nakamura,41,1875800,6314899673924623,257,3369484,2313843,23139,2290704
1215,Wendell,49,2373000,8869720203393615,324,3893027,400315,0,400315
1216,Sikou Niakaté,53,964000,6765661700550604,310,2830021,2620528,0,2620528
1217,Rasmus Nicolaisen,45,3274500,4474036556927890,393,5615077,286833,2869,283964
1218,Casper Nielsen,46,4730800,4574705279842045,481,7959482,3950564,0,3950564
1219,Andries Noppert,28,4717300,6397140785059659,349,6203095,5306021,5307,5300714
1220,Jean-Pierre Nsame,22,413100,4254156904175060,48,414143,314120,0,314120
1221,Alexander Nübel,46,2312200,4239218838368559,324,4233620,260028,0,260028
1222,Odriozola,46,1896800,5237537610989145,298,3688744,2627047,0,2627047
1223,Angelo Ogbonna,45,3439300,8288651541398582,425,5700361,2079777,207978,1871799
1224,Martín Ojeda,56,2124800,5730348867014392,369,4577841,2701651,271,2701380
1225,Noah Okafor,64,4009200,8656161512296649,580,8182413,3727682,3728,3723954
1226,Warmed Omari,34,3804200,8925457992983749,380,5472100,4242917,425,4242492
1227,Amadou Onana,58,4206800,6293170824711556,600,8006657,3279515,32796,3246719
1228,Karim Onisiwo,35,2104800,9964789353643615,273,3287849,167903,16791,151112
1229,Azzedine Ounahi,37,1877500,7224883468024695,250,3097718,1040969,1040969,0
1230,Magomed Ozdoev,49,3937600,4535198078890470,448,6810959,4323453,4323453,0
1231,Dorlan Pabón,57,678200,4544001827035698,284,2513967,939875,9399,930476
1232,Luan Peres,51,596700,5140592735096124,209,1941329,727443,728,726715
1233,Nehuén Pérez,24,4872300,6080048073851495,356,6622017,1949175,1950,1947225
1234,Rubén Pérez,52,2880000,8799838297267439,401,5637239,4887597,489,4887108
1235,Carles Pérez,28,3782400,7217352242609354,330,5430559,5429526,0,5429526
1236,Germán Pezzella,37,1426900,7894528286045417,214,2621866,403135,404,402731
1237,Diogo Leite,60,1660500,3983159223655331,326,3744762,415999,0,415999
1238,Tommaso Pobega,63,358200,3427310864871863,281,2306732,637555,638,636917
1239,Yussuf Poulsen,49,2838600,6057637718527822,427,5530355,5132498,5133,5127365
1240,Grischa Prömel,52,1112600,3642327481489337,274,2659244,734020,7341,726679
1241,Puado,37,1821000,4519411331532708,220,3115221,683811,683811,0
1242,Soufiane Rahimi,47,3626700,7233051211895436,465,6663098,1415800,142,1415658
1243,Milot Rashica,67,1456400,9634183465764412,338,3729931,2848748,2849,2845899
1244,Harrison Reed,27,3585900,8416742671611151,297,5272709,3651139,366,3650773
1245,Samuele Ricci,41,4656000,6623306591601125,493,7660723,5953239,5953239,0
1246,Mats Rits,22,1582000,9860109201931959,139,2052564,506005,5061,500944
1247,Antonee Robinson,39,4149000,5385275149945324,423,7083494,1876360,0,1876360
1248,Valentin Rosier,45,1852600,4142313411844581,286,3553447,1336585,133659,1202926
1249,Diego Rossi,42,439200,7804898926397715,138,1094711,703621,0,703621
1250,Jérôme Roussillon,58,4691500,4932696527117226,633,8266391,923487,0,923487
1251,Aitor Ruibal,56,4345200,7846105246191672,586,8499384,6813854,682,6813172
1252,Ruiz de Galarreta,37,531200,9151234141708759,151,1311476,235329,235329,0
1253,Abel Ruiz,36,1517600,6744596659537500,197,2664602,2586357,0,2586357
1254,Mohammed Salisu,52,2434400,3593972927557861,369,4618354,510978,5110,505868
1255,Roland Sallai,28,3353200,7492344318795861,267,4347351,4213663,4213663,0
1256,Morgan Sanson,47,2933000,7674771294269542,402,5362692,4433053,0,4433053
1257,Danilo,23,755700,5667173505784387,47,692943,591658,591658,0
1258,Fábio Martins,35,1170800,6514481265094914,155,1823924,250039,250039,0
1259,Zaidu Sanusi,65,3836000,7196613436355423,551,7485645,3409664,0,3409664
1260,Riccardo Saponara,58,3336700,5702766696460459,519,6506448,5923088,5923088,0
1261,Ismaïla Sarr,68,2580000,5153548239095610,457,5776623,2136639,214,2136425
1262,Jeffrey Schlupp,40,4931900,3179886821678279,504,8398032,7160117,0,7160117
1263,Nicolas Seiwald,67,2259300,4003871970126598,424,4747327,63267,6327,56940
1264,Marcos Senesi,33,966300,7734607698438459,151,1732835,1239240,0,1239240
1265,Suat Serdar,29,1517900,9627962870460633,184,2345509,1844043,0,1844043
1266,Petr Ševčík,42,919800,5726148386316907,174,1945472,1519610,1520,1518090
1267,Tuta,59,417300,6439346849366472,276,2081100,380972,0,380972
1268,Wilfried Singo,35,4449200,7573915833192595,466,7533735,6655169,6655169,0
1269,Danilo,59,1981000,5358876220993940,366,4245715,1539872,0,1539872
1270,Oumar Solet,69,684200,7363426060458906,323,2890576,1329936,0,1329936
1271,Junior Sornoza,25,4523700,9223806914588825,432,6906251,6415137,6416,6408721
1272,Riccardo Sottil,36,3362600,5643085898084599,380,5637158,5487748,549,5487199
1273,Willian Arão,37,4361400,8248732058675116,452,6960454,500744,5008,495736
1274,Stijn Spierings,41,2679800,5113094942170786,368,5140913,4388779,0,4388779
1275,Jindřich Staněk,62,4199900,9118705100964333,542,7392675,2098178,2099,2096079
1276,Renato Steffen,29,4847100,7088022348786199,398,6837419,2027780,20278,2007502
1277,Miroslav Stevanović,34,4667800,4975421774839696,507,7274830,4680218,0,4680218
1278,Yukinari Sugawara,57,4806400,5194634035725653,647,9130925,3320289,0,3320289
1279,Mattias Svanberg,67,2217800,4315591332547200,493,5318263,4760405,476041,4284364
1280,Jonas Svensson,39,798200,6810265595258305,171,1831950,1470284,0,1470284
1281,Attila Szalai,65,3914100,9865895328806918,589,7245466,6610920,6611,6604309
1282,Flavien Tait,66,2418900,6015677708519905,488,5739569,3456806,34569,3422237
1283,Matt Targett,41,874800,3513020871865334,170,1797046,436738,43674,393064
1284,David Carmo,61,4295300,9404924559250275,551,7717904,344789,0,344789
1285,Cristian Tello,49,4067100,4112410385835696,422,6874804,2862883,0,2862883
1286,Kenny Tete,35,1490900,6193825375102035,212,2856501,333933,3340,330593
1287,Tetê,68,2006200,8565558697738249,393,4676492,752927,7530,745397
1288,Jordan Teze,42,1532800,9001973898234576,236,2829665,2098867,209887,1888980
1289,Karl Toko Ekambi,30,4051100,8418494053237968,383,6349907,5303563,5303563,0
1290,Hamed Traorè,41,485700,7956576140663523,156,1406788,457523,45753,411770
1291,Adrien Truffert,52,4661500,6064364544524210,545,7510736,2571825,25719,2546106
1292,Álvaro Valles,55,1094600,7634905640146550,266,2815518,894449,89445,805004
1293,Patrick van Aanholt,25,3874900,8670243069420377,298,5454158,3961026,3962,3957064
1294,Alan Varela,54,4050400,4265662472388042,494,7224697,3145243,3146,3142097
1295,Nuno Tavares,69,3247100,6539539620478417,522,6772964,3530488,0,3530488
1296,Franco Vázquez,66,4200000,3816388039541528,562,7820808,3427628,342763,3084865
1297,Nacho Vidal,44,2406200,7656389871387702,330,4346446,7777,7777,0
1298,Lucas Villalba,47,4146700,8657605940073237,468,7071318,4817567,481757,4335810
1299,Kevin Vogt,67,475900,6342100267363691,279,2311735,1377553,138,1377415
1300,Kai Wagner,64,1287900,7820603246189934,352,3707937,1589300,15893,1573407
1301,Kyle Walker-Peters,49,2899400,8560675623173387,364,5107677,5090217,509022,4581195
1302,Daniel Wass,57,3884900,7758721441635860,581,7164236,3830853,383086,3447767
1303,Danny Welbeck,25,933200,7104143713115843,108,1279956,1160707,11608,1149099
1304,Silvan Widmer,30,3242400,4108813092259745,267,4340155,3032245,0,3032245
1305,Mats Wieffer,47,3953400,6529381049347491,501,6580495,2707565,2707565,0
1306,Owen Wijndal,51,4746000,6389295415683915,552,8381695,5472394,0,5472394
1307,Jonas Wind,25,731700,4197602347052874,83,959869,787216,787216,0
1308,Maximilian Wöber,60,3521100,4606929097243194,494,6601315,6088268,60883,6027385
1309,Ashley Young,24,1217900,8789497659355767,84,1411216,253778,254,253524
1310,Nicola Zalewski,27,2120300,5619754818057419,199,3094415,925700,0,925700
1311,Fernando Zampedri,66,356900,9342034072805869,271,2049513,2010509,0,2010509
1312,Robin Zentner,67,1266000,8647312844316717,354,3526449,259192,2592,256600
1313,Ramiz Zerrouki,63,1520700,7164100202483281,317,3494952,1919272,192,1919080
1314,Walker Zimmerman,45,4674100,6604033916359621,508,7758340,6046898,6047,6040851
1315,Andrija Živković,59,694800,3024605701897463,310,2928617,2374932,0,2374932
1316,Steven Zuber,44,4811900,3350570113364529,508,7891693,3336739,33368,3303371
1317,Zakaria Aboukhlal,67,4493500,9506836349580816,549,7245039,7121730,713,7121017
1318,Ché Adams,68,2403200,5087524708610984,510,5922755,4158880,41589,4117291
1319,Luis Advíncula,59,372800,9322726152465178,221,1658681,778899,0,778899
1320,Emmanuel Agbadou,67,2894900,3404657385105834,482,5669312,1806434,18065,1788369
1321,Anel Ahmedhodžić,43,3626100,6936138904622268,448,6678133,3243779,324378,2919401
1322,Rayan Aït-Nouri,68,1627300,4682207454740340,455,4512081,464977,0,464977
1323,Kristoffer Ajer,57,2318700,4477106704646161,349,4412069,4246485,4247,4242238
1324,Jean-Daniel Akpa Akpro,67,2622800,7100948230926411,472,5652913,4322862,4323,4318539
1325,Lucas Alario,52,1718900,5051448545126465,291,3258164,585487,0,585487
1326,Rubén Alcaraz,47,4049100,7561875875663647,494,7046252,3126536,0,3126536
1327,Dele Alli,66,374300,5853217931636921,251,2135341,350531,0,350531
1328,Juan Cruz,37,4444300,5295383227691487,417,6409336,4347781,0,4347781
1329,Vinícius,32,4802800,4800880222048484,505,8463574,4452322,44524,4407798
1330,Selim Amallah,30,4117300,5477296397382760,396,6682970,3906871,0,3906871
1331,Iago,57,2743400,8572416314230222,450,5365946,2815658,282,2815376
1332,Waldemar Anton,28,480900,8062614605098174,90,800612,314834,31484,283350
1333,Santiago Arias,32,441900,7730535040816524,107,851382,393469,3935,389534
1334,Gabriel Arias,32,2386200,7119193919763966,292,3980429,2317849,0,2317849
1335,Copete,38,2383300,5477552621735038,305,3921093,3027919,0,3027919
1336,Santiago Ascacíbar,64,2064100,5511931772900614,416,4820653,313444,313444,0
1337,Gabriel Ávalos,41,4321200,8519816431096824,490,7517120,1292575,130,1292445
1338,Johan Bakayoko,59,709400,3220470201919061,260,2298447,1543055,0,1543055
1339,Mama Baldé,31,936200,3697828427604750,126,1365336,1106048,110605,995443
1340,Patrick Bamford,48,832400,8127955857769995,210,2159219,530605,5307,525298
1341,Vina,23,580800,8860018084644855,76,744887,389825,38983,350842
1342,Alexander Barboza,31,1954600,3918919084033561,207,2800469,2523245,25233,2498012
1343,Taison,36,3164600,3826676682342687,355,5097651,2038747,0,2038747
1344,Keidi Bare,69,1196000,6330716375171900,346,3441645,3185734,3185734,0
1345,Kike Barja,64,2478800,5305638111179345,493,5430888,2193926,2193926,0
1346,Federico Baschirotto,58,3801700,5327054401148233,546,7189940,6310835,6311,6304524
1347,Gelson Martins,45,1575000,9445373697022025,245,2968543,2728133,273,2727860
1348,Younès Belhanda,70,3812400,7226443699612670,570,6909350,4605232,46053,4559179
1349,Stefan Bell,43,3712500,6431349164924076,366,5579324,1640011,1640011,0
1350,Jean-Ricner Bellegarde,43,305100,5713675864252551,136,1056134,851095,851095,0
1351,Nabil Bentaleb,59,395300,5790015102614241,219,1674603,1184185,0,1184185
1352,Patrick Berg,65,4759900,5740728490073382,599,8602959,3339451,0,3339451
1353,Sander Berge,52,2106200,6813050825472636,363,4300577,372025,372025,0
1354,Jordan Beyer,55,1689000,3396051616598413,337,3731935,3347764,3348,3344416
1355,Jaka Bijol,22,4517700,5263099672008632,361,6572857,5732797,0,5732797
1356,Jérémie Boga,70,4516500,5805858926355979,695,8866494,8826875,0,8826875
1357,Artem Bondarenko,57,3618300,7891520352283646,499,6571616,2519627,0,2519627
1358,Miguel Borja,60,1647000,7154321241578313,370,4000503,1753616,0,1753616
1359,Gustavo Bou,31,1973100,8930813968509629,227,3069260,2356959,2357,2354602
1360,Armando Broja,63,1091700,4665411965908723,346,3442814,2829026,282903,2546123
1361,Josh Brownhill,24,1498800,9678499670115799,146,2006241,1375862,1376,1374486
1362,Marius Bülter,54,3892600,3665716077770862,451,6398664,4853676,0,4853676
1363,Georgiy Bushchan,55,573900,5503177024766404,263,2311910,767670,767670,0
1364,Bernard,32,2839800,4106183596444410,282,4246418,3660840,0,3660840
1365,José Callejón,34,4960600,8647747957118345,435,7235135,5113215,51133,5062082
1366,Sergio Camello,34,2562100,7114473011117653,235,3746804,1229016,122902,1106114
1367,Aitor,68,1710300,3933823677945882,426,4325478,1519754,15198,1504556
1368,Todd Cantwell,38,2499700,3328953907902584,267,3831412,2148967,21490,2127477
1369,Caro,58,2698600,5547791051903856,396,4739761,2844798,285,2844513
1370,Léo Baptistão,68,979700,4217838357668922,346,3155607,180482,1805,178677
1371,Samu Castillejo,69,3705000,5199006766110747,531,6445818,3246504,3246504,0
1372,Leonardo Castro,24,2785100,9594954406053502,229,3856379,593022,0,593022
1373,Ricardo Batista,61,1330800,4962397224271811,354,3489536,2781547,0,2781547
1374,Julian Chabot,44,4806200,4384648861762809,505,8311298,1260077,127,1259950
1375,Fidel,22,4140200,4296476190040265,344,5801306,4640833,0,4640833
1376,Rayan Cherki,37,2761300,7684461182258710,327,4343618,878201,8783,869418
1377,Pedro Chirivella,42,4600000,9470999343272033,545,8445728,1771879,178,1771701
1378,Víctor Chust,52,1627700,7371074954508286,302,3203087,83856,83856,0
1379,Alexis Claude-Maurice,31,1691700,5011512109482373,211,2556598,2094183,0,2094183
1380,Saúl Coco,63,1420900,3137004946053404,337,3570208,2362319,2362319,0
1381,Séamus Coleman,43,341400,8019256350238486,135,951812,168889,168889,0
1382,Alessio Cragno,62,919400,5813396630819562,344,3340488,1946514,194652,1751862
1383,Miguel Crespo,28,653300,8263225155537350,90,918170,498185,498185,0
1384,Tomáš Čvančara,66,4162200,3004631152844924,530,7043501,7013043,7014,7006029
1385,Evander,68,3139700,9511857185160004,493,6537821,3327389,3328,3324061
1386,Andrew,28,3192300,3419362735309481,252,4567470,503733,0,503733
1387,Maurício,61,2000000,3733129082584300,410,4639075,854891,8549,846342
1388,Patson Daka,66,3008700,8183838138346895,538,6677663,6056565,60566,5995999
1389,Thijs Dallinga,35,3160700,9505525297187427,368,5075361,2216100,22161,2193939
1390,Pedro De la Vega,32,3414200,9949530546945758,283,4873857,2933922,293393,2640529
1391,Dani de Wit,58,1143200,3102034484817760,289,2888618,1416361,142,1416219
1392,Brecht Dejaegere,52,3904000,5952293489378475,490,6696280,2678599,2678599,0
1393,Ermedin Demirović,28,915900,5812827429480811,111,1391877,1075262,0,1075262
1394,Diego Demme,63,1062500,9182024771563214,334,3276970,2441124,244113,2197011
1395,Jason Denayer,42,2760800,7843459999218290,366,5113508,4700660,4700660,0
1396,Leander Dendoncker,42,3822400,5659384373264222,459,6436327,6374251,63743,6310508
1397,Emmanuel Dennis,53,597100,5574707142419666,250,2282257,1830921,1830921,0
1398,Cyriel Dessers,63,2545900,4262950758522565,422,5259704,2476073,248,2475825
1399,Federico Di Francesco,43,1393300,8293811070517579,240,2658066,650324,651,649673
1400,Bafodé Diakité,25,1497300,4500522428930564,136,2128622,1289670,0,1289670
1401,Krépin Diatta,35,3616100,9635113891411552,382,5726283,5007704,5007704,0
1402,Damián Díaz,32,1243600,3637109712891830,136,1784686,1622155,1622155,0
1403,Enzo Díaz,43,4329000,6269764170605970,456,6571167,1010500,1010500,0
1404,Víctor Díaz,23,2790200,8531848588017625,246,4353989,1087351,1087351,0
1405,Junior Dina Ebimbe,24,3886600,8972949148061964,336,5166517,1663078,16631,1646447
1406,Ousmane Diomande,49,4501300,7339881481383247,553,8345591,1784338,179,1784159
1407,Matías Dituro,38,2283700,7206498515026451,281,3767900,1426406,14265,1412141
1408,Matt Doherty,70,4525600,6909303572196297,618,8149252,2926523,293,2926230
1409,Josh Doig,50,3694100,5871542625881108,467,6387737,1212975,12130,1200845
1410,Kasper Dolberg,45,4407400,9605563416139834,474,6726871,4775454,477546,4297908
1411,Léo Duarte,59,4935300,3901753242922298,629,8547333,5628877,0,5628877
1412,Rubén Duarte,22,4666200,5943049720049806,402,7183934,5585970,5586,5580384
1413,Odsonne Edouard,35,2108000,4639301432292330,235,3531297,367418,3675,363743
1414,Maximilian Eggestein,70,1617800,8816402302824742,367,3984668,494537,495,494042
1415,Chidera Ejuke,45,3100000,5371548572719009,393,5643590,1103887,110389,993498
1416,Hugo Ekitike,69,2854200,3727445276838117,458,5232347,3266930,3266930,0
1417,Aschraf El Mahdioui,51,3693700,9606697149135366,471,6068514,4194087,419409,3774678
1418,Jawad El Yamiq,31,1724400,3981122044116511,217,2683159,2348236,2348236,0
1419,Mohamed Elneny,61,2311500,5449362773865648,458,4831295,2522983,0,2522983
1420,Edu Expósito,34,928900,3283274383102435,166,1800798,909375,90938,818437
1421,Paulo Vítor,49,4255600,6894728700180158,524,7813396,7796876,7796876,0
1422,Rasmus Falk,40,1267600,4296892962423118,211,2410771,117652,11766,105886
1423,Facundo Farías,32,393000,9925627769393537,75,606836,468056,0,468056
1424,Jean,43,558500,9745392533637160,155,1376865,362945,362945,0
1425,Nicolás Fernández,44,3349000,9137604399868548,379,5527903,3571580,3571580,0
1426,Guillermo Fernández,52,1584500,7514874991903045,319,3498140,2084647,20847,2063800
1427,Álex Fernández,67,4136100,6435340327819759,601,8186015,3132960,313296,2819664
1428,Joaquín,68,1874700,7405951539658617,393,4577352,4179787,4179787,0
1429,Alexis Flips,68,4336600,5140599562500678,662,8903176,5261134,52612,5208522
1430,Alessandro Florenzi,67,2703400,9792378980184748,439,5465236,4968273,497,4967776
1431,Wes Foderingham,45,3114900,6042719957939637,352,4847433,509502,510,508992
1432,Gabriel Veron,33,2642600,7665058209983636,252,3952086,432310,43231,389079
1433,Taxiarchis Fountas,22,480100,6049397624074549,20,238496,181190,1812,179378
1434,Marvin Friedrich,70,2935200,9159326606994424,508,5830389,1458620,145862,1312758
1435,Unai García,41,2376400,8255334016896820,316,4082417,1555473,1556,1553917
1436,Eric García,42,2555800,9800421061724907,331,4470114,1546522,155,1546367
1437,Falcao,32,4329000,9065551815246820,422,6751941,2122172,2123,2120049
1438,Alejandro Garnacho,41,3271300,4947125893397659,376,5548239,1227483,123,1227360
1439,Dennis Geiger,47,1030700,4587318693662834,238,2563828,1436210,0,1436210
1440,Lautaro Giannetti,41,4316200,4120297407891824,472,6988547,4563784,0,4563784
1441,Andrei Girotto,42,2216600,9608808580022052,321,4323281,988303,989,987314
1442,Ben Godfrey,58,4749000,3614851814410534,600,8930149,2311062,23111,2287951
1443,Connor Goldson,28,2100000,9568936513451150,170,2751423,733881,0,733881
1444,Derlis González,54,2667400,6653753228540819,431,5224787,3785806,378581,3407225
1445,Anthony Gordon,53,451200,3631218138036813,214,1677030,1424907,0,1424907
1446,Jeffrey Gouweleeuw,34,898600,9151554204717832,118,1358551,812014,0,812014
1447,Kamil Grabara,45,894500,9812877774177102,207,2065834,256473,256473,0
1448,Ivo Grbić,61,4733100,5311022426530681,612,9241825,2186432,218644,1967788
1449,Clément Grenier,69,3745800,3661499302674104,568,7208570,890248,891,889357
1450,Hugo Guillamón,27,693500,6132953170444713,104,997638,893266,0,893266
1451,Mert Günok,32,1809500,7010251390507002,225,2998950,626836,627,626209
1452,Emmanuel Gyasi,67,4823200,4039572249313432,672,8672663,6193161,0,6193161
1453,Viktor Gyökeres,27,758000,6049383685182327,75,935834,755638,0,755638
1454,Janik Haberer,66,3559400,6515080757771642,507,6995530,3397463,339747,3057716
1455,Amir Hadžiahmetović,48,1551300,4835718930174993,276,3309863,163336,0,163336
1456,Tarek Hamed,27,1058000,8211815496701391,134,1589150,68928,6893,62035
1457,Gustavo Hamer,46,1989100,8738162171921122,312,3885114,1628844,1628844,0
1458,Andreas Hanche-Olsen,51,2870500,9326201720031698,405,4911786,5368,0,5368
1459,Guilherme Sityá,56,3359900,8789445135291859,482,5946180,2128888,213,2128675
1460,Matheus Henrique,37,1508600,6901060178321106,213,2550852,2518666,25187,2493479
1461,Gastón Hernández,70,641900,9569718089231409,312,2680261,2080833,0,2080833
1462,Luís Hernández,29,2637700,4162158705529343,211,3855650,734813,73482,661331
1463,Daniel Heuer Fernandes,38,2302400,7783387481379183,275,4153468,466851,4669,462182
1464,Isak Hien,49,4682700,4753979515997180,515,7767494,5742373,0,5742373
1465,Philipp Hofmann,43,617500,5718359128845847,180,1700526,232763,0,232763
1466,Patrik Hrošovský,26,1110400,9286568490936359,136,1778856,1544844,154485,1390359
1467,Callum Hudson-Odoi,57,3428800,5620018021982849,481,6874591,6482300,64823,6417477
1468,Marcus Ingvartsen,45,4410900,6588473122627322,469,6594156,3793561,380,3793181
1469,Hiroki Ito,52,3561700,9474699861665875,423,6168575,4958418,4958418,0
1470,Mauro Júnior,22,534700,3563438075045867,25,333597,269316,0,269316
1471,Iván Jaime,38,2956900,4474660429854867,311,4566207,690574,691,689883
1472,Kristijan Jakić,22,3728900,4677782717490714,338,5574215,3530964,354,3530610
1473,Daniel James,36,3762000,5765664906049526,425,5900567,4048938,0,4048938
1474,Fali,40,306700,9482168885544963,118,900747,95707,9571,86136
1475,Alistair Johnston,35,3107400,7035498716937201,356,5294274,579877,5799,574078
1476,Christopher Jullien,44,1035900,4659023487678856,223,2386634,1032626,1032626,0
1477,Jutglà,47,2443100,8519494480744776,358,4928551,3497958,350,3497608
1478,Ozan Kabak,45,743200,7457475669455231,227,2032017,374063,374063,0
1479,Pavel Kadeřábek,36,3270700,3863325436719291,357,5459387,4202270,421,4201849
1480,İrfan Can Kahveci,43,2815100,8759219228836928,339,4656762,771892,772,771120
1481,Lukáš Kalvach,69,475600,6571907013123443,301,2590618,1040169,104017,936152
1482,Jakub Kamiński,60,1512200,3836941091588332,370,3614535,1960608,196061,1764547
1483,Marc-Oliver Kempf,69,2098700,5715008560288297,454,5129672,2891910,0,2891910
1484,Milos Kerkez,30,4898900,9798875438981645,475,7472408,6577515,657752,5919763
1485,Joshua King,31,4183200,7503625718110082,391,6277784,730643,7307,723336
1486,Tim Kleindienst,33,4162300,8552496271575911,396,6191386,2822704,2822704,0
1487,Ansgar Knauff,68,3325000,7335354953110920,585,7095948,4854239,4854239,0
1488,Sekou Koita,60,448000,3701487618942480,288,2445159,838756,0,838756
1489,Ondřej Kolář,25,1958200,7591938088587559,138,2372718,774118,77412,696706
1490,Cheikhou Kouyaté,23,1939400,5164544681215103,184,2856991,305153,305153,0
1491,Rasmus Kristensen,54,3594100,7928447590162691,507,6765168,2266917,22670,2244247
1492,Grzegorz Krychowiak,68,3955100,6150708081423533,553,7733046,810518,810518,0
1493,Lukas Kübler,65,335300,8787130365867366,255,1946557,1202763,12028,1190735
1494,Marash Kumbulla,42,3739200,5137324467317666,439,6249217,654049,654049,0
1495,Daler Kuzyaev,24,4962200,4701751024157139,362,6093007,5827527,583,5826944
1496,Daniel-Kofi Kyereh,55,2019400,4312699936982459,318,3925102,1054341,10544,1043797
1497,Stefan Lainer,39,488000,8569169071429524,170,1321073,1239776,1240,1238536
1498,Tariq Lamptey,31,4818400,3733959374272724,435,7100391,318050,0,318050
1499,Gianluca Lapadula,28,3333600,7003782614957978,352,5407394,3930332,393034,3537298
1500,Cyle Larin,42,3283800,4948728951559229,390,5148517,2758872,27589,2731283
1501,Sam Larsson,67,4752800,4676871480513425,670,9168866,7489950,7490,7482460
1502,Jamaal Lascelles,66,3820800,6051257234250610,576,7673957,4422489,44225,4378264
1503,Cristian Lema,58,1670700,4496470823771286,338,3765061,1939035,1939035,0
1504,Ondřej Lingr,46,2798000,3207290135812469,364,5368296,1266830,1266830,0
1505,Enzo Loiodice,51,1492600,6596072234411229,293,3179038,2097531,0,2097531
1506,Ivi López,62,3507200,4309780040141842,548,6574179,2705191,0,2705191
1507,Anthony Losilla,33,1886100,6855580690338399,232,2962099,548149,548149,0
1508,Jordan Lotomba,63,1223100,6917023358188621,309,3002644,2830397,2830397,0
1509,Sandi Lovrič,67,2398900,5200870090935445,492,5683293,4633473,4634,4628839
1510,Eduard Löwen,54,4766900,6851923635473278,599,8475431,4224652,0,4224652
1511,Giulio Maggiore,28,4306400,8663484272006816,409,6507724,6439215,644,6438571
1512,Arne Maier,22,2754400,5066338404286828,219,3866631,2761533,27616,2733917
1513,Víctor Ignacio Malcorra,26,4107800,5817230260122758,378,6035049,2618139,2618139,0
1514,Emanuel Mammana,37,3029100,5354493657112661,295,4800038,1206277,1207,1205070
1515,Marcão,65,3432600,7777977411535826,593,6931095,3349626,3349626,0
1516,Omar Marmoush,63,4103800,5185094843123039,589,7805570,363752,3638,360114
1517,Aarón,60,1419200,6095023359817547,323,3427219,1134576,11346,1123230
1518,Josef Martínez,27,1940400,5118732052844691,182,2694737,431624,4317,427307
1519,Omar Mascarell,32,683600,4415231977516593,97,1023126,308901,30891,278010
1520,Jean-Philippe Mateta,33,867400,4318818194904950,121,1275314,114533,1146,113387
1521,Cristian Medina,53,1542900,5421723990168639,316,3730657,2475095,247510,2227585
1522,Miguel Ángel Merentiel,53,3480900,6305567855509164,448,5995587,5585835,5585835,0
1523,Illan Meslier,70,2688600,5284022324849557,557,6220988,4806549,4806549,0
1524,Rony Lopes,50,4072800,3618770578908672,471,7322896,4764217,0,4764217
1525,Djordje Mihailovic,68,4951000,3688420963930584,664,9088916,2716934,27170,2689764
1526,Fabio Miretti,57,2982300,9346723903593608,453,5747171,5415181,5415181,0
1527,Moleiro,61,4088600,9698507247740244,517,6814896,5577763,55778,5521985
1528,Joni Montiel,62,2804000,7308374695877891,511,5916320,302939,3030,299909
1529,Maxi Moralez,53,1706000,6979997407404831,318,3741137,3290444,32905,3257539
1530,Harold Moukoudi,28,3416600,5024852671000594,286,4891088,3715224,37153,3678071
1531,Mykhailo Mudryk,59,915900,6782085792721455,328,3184803,1818938,0,1818938
1532,Arijanet Murić,46,2754900,3538377418906280,322,4731551,4112968,4112968,0
1533,Vitaliy Mykolenko,24,1816400,6816992835967441,175,2471916,430335,4304,426031
1534,Keito Nakamura,22,1242100,6000477743946623,84,1326076,515697,5157,510540
1535,Nahitan Nández,35,1839900,3828884226465662,225,2978520,728769,728769,0
1536,Youssouf Ndayishimiye,54,1697400,8500567780976488,339,3877905,574144,0,574144
1537,Badou Ndiaye,23,4242900,8018893690845677,331,5696755,3373501,3374,3370127
1538,Negredo,54,2103500,5197084855393453,331,4148509,2059614,206,2059408
1539,Michael Ngadeu,54,896600,5006711763701710,308,2721205,1321160,0,1321160
1540,Eddie Nketiah,60,2110600,3119676759366901,409,4839063,925007,0,925007
1541,Kenedy,31,382200,6418690775566681,93,690718,753,753,0
1542,Juan Jesus,42,2118000,7112140114705277,302,4113277,2570784,258,2570526
1543,Matt O'Riley,50,3326300,8427663638500121,431,5847767,1096179,1097,1095082
1544,Igoh Ogbu,28,3053800,8008051795154945,263,4317827,2594794,2595,2592199
1545,Nick Olij,60,2173900,7281549067894094,374,4439634,3275096,3275096,0
1546,Lincoln,43,1386100,9538616842359131,209,2488409,1757425,176,1757249
1547,Robin Olsen,27,4360900,5300394856632162,351,5883225,5474927,0,5474927
1548,Gift Emmanuel Orban,28,4927900,3279132367510819,423,6958765,3239435,0,3239435
1549,Divock Origi,56,3032400,3573820197356266,444,5501049,2207575,221,2207354
1550,Mislav Oršić,27,859100,8235249325004641,101,1206088,91313,0,91313
1551,Pacheco,55,1385100,6676603076372348,281,3187990,265996,0,265996
1552,Joseph Paintsil,35,659400,8913945833790546,126,1220890,78295,0,78295
1553,Sebastián Palacios,27,3185800,6131040069261729,289,4821931,1626035,16261,1609774
1554,Nicolas Pallois,42,2348200,9494078458840218,314,4242663,1606083,1607,1604476
1555,José Luis Palomino,59,2380000,7086564358742773,417,5329693,3995151,399516,3595635
1556,Remko Pasveer,26,1394900,8337675750029178,172,2264235,629222,6293,622929
1557,Strahinja Pavlović,55,2932300,7825788348094060,474,5780131,3075803,0,3075803
1558,Amahl Pellegrino,53,977600,9072466227368876,301,3007045,2336252,0,2336252
1559,Rubén Peña,32,2263100,7903917555377439,229,3455544,1060183,106019,954164
1560,Romain Perraud,33,1032200,8848498000552088,162,1748860,1338872,1339,1337533
1561,Bruno Petković,62,2388300,3489510480185192,376,4961228,1504823,151,1504672
1562,Gonzalo Piovi,22,1606600,4651424844029141,135,1984069,88216,0,88216
1563,Portu,22,3231000,6234460659552650,294,5096519,1884693,18847,1865846
1564,Dennis Praet,41,1951700,6108891771392285,297,3611689,1466008,147,1465861
1565,Sanjin Prcić,28,1472800,3800964015108765,160,2207368,316534,31654,284880
1566,Robin Pröpper,67,2571500,6699184681769893,413,4875802,970317,0,970317
1567,Riqui Puig,33,4095000,3214390924151568,368,6105470,4659335,0,4659335
1568,Teemu Pukki,38,3256400,3738611251346771,355,5498441,557017,5571,551446
1569,Vako,54,3125900,7493624352882286,408,5672583,1256416,12565,1243851
1570,Uroš Račić,56,1035700,5097181508369559,319,2918104,982788,983,981805
1571,Nemanja Radonjić,45,1540600,6624700111846704,257,3190448,1967617,1967617,0
1572,Raíllo,23,3894900,7955029993190201,328,5794950,1636374,1636374,0
1573,André Ramalho,61,472600,5123469440150047,267,2330620,1471801,14719,1457082
1574,Cristian Ramírez,46,3944400,7705820696973800,477,6728941,6546901,655,6546246
1575,Moisés Ramírez,44,1860800,5546482798005701,278,3558728,2335721,234,2335487
1576,Sandro,50,351000,8511868707143326,220,1823567,176388,176388,0
1577,Nicolas Raskin,34,2603500,8378702982825307,240,3881129,164707,1648,163059
1578,Filipe Relvas,35,4947900,8352854592556093,427,7649123,1959027,0,1959027
1579,Devyne Rensch,66,3732200,8914891474435013,546,7069854,288014,0,288014
1580,Rodrigo Rey,23,4293800,6185497683900179,333,6410068,1953320,196,1953124
1581,Marco Richter,25,4314300,5663205983781321,330,5476708,3426010,3426010,0
1582,Luis Rioja,41,3749400,5412239268026790,450,6633449,6026799,603,6026196
1583,Connor Roberts,45,1826600,5297398348037771,289,3737749,2204326,2204326,0
1584,Marc Roca,30,3115600,7392166238798920,283,4656886,353184,0,353184
1585,Marek Rodák,53,1029500,5290276721827059,236,2287258,1001751,1002,1000749
1586,Kévin Rodrigues,29,1440600,6756041676041056,172,2189336,680623,68063,612560
1587,Morato,29,1873600,4798617314843848,189,2779137,606350,0,606350
1588,Paulo Oliveira,62,2463200,3289112116635602,395,5032632,3243327,0,3243327
1589,Ricardo Rodríguez,43,917900,7079808573560292,221,2124076,1452507,1453,1451054
1590,Sebastián Rodríguez,47,1553400,8922604442814559,270,3020829,2857986,285799,2572187
1591,Óscar,23,3626800,9729231742965802,297,5053034,1049775,105,1049670
1592,Cristian Roldan,47,3550800,3936497565495781,439,6220298,5499911,5499911,0
1593,Benjamín Rollheiser,41,3697900,3907300791714870,448,6717029,4535279,0,4535279
1594,Pablo Rosario,47,1478000,6622481241775755,276,3007069,1239952,0,1239952
1595,Daniele Rugani,69,494500,6865363515841392,288,2387370,1727266,173,1727093
1596,Mikkel Rygaard,63,2032800,8860722074727820,433,4718670,4637934,464,4637470
1597,Falaye Sacko,69,1912800,7365609488202530,445,4904402,64913,0,64913
1598,Diadié Samassékou,51,2195600,5802303640570106,368,4387655,2992964,300,2992664
1599,Javi Sánchez,41,1568100,5097214406680226,227,2620544,1147943,11480,1136463
1600,Giorgio Scalvini,54,3825600,5459109480037205,471,6703910,6017737,6017737,0
1601,Bart Schenkeveld,38,4886900,9312874595230226,538,8229193,942327,94233,848094
1602,Jerdy Schouten,47,3918600,4390949491051967,411,5896211,4607297,0,4607297
1603,Marcel Schuhen,35,2341600,9279156343725278,294,3946975,380298,0,380298
1604,Benjamin Šeško,66,1839200,3062471900057761,447,4924155,1250190,1250190,0
1605,Ryan Sessegnon,47,1025700,5353158319287023,211,2026020,437564,0,437564
1606,Xherdan Shaqiri,39,994500,9579509598199351,178,1871306,48551,48551,0
1607,Ahmed Sharahili,34,4805200,6865795949820849,499,7704791,313091,314,312777
1608,Jonjo Shelvey,60,3643600,9049248563899297,523,6970525,2962381,0,2962381
1609,Djibril Sidibé,24,788700,5463899817105832,53,741035,341309,34131,307178
1610,Leonardo Sigali,25,3693300,8708717472116728,308,5149202,1117452,112,1117340
1611,Alejandro Silva,50,1772400,7734919939526792,340,3915090,1045491,1046,1044445
1612,Martín Silva,24,4347500,8947123702210821,358,6086182,3669251,0,3669251
1613,David Silva,62,4987200,6291393110172457,610,8585363,55937,55937,0
1614,Cesinha,44,3616600,9596095424384550,417,6354484,58231,583,57648
1615,Gijs Smal,49,2555500,7784506452179223,377,4909507,893567,893567,0
1616,Dominic Solanke,38,4761700,3694579659937285,477,7377144,2933435,293344,2640091
1617,Pablo Solari,56,1611200,5492628667728047,320,3372302,1245313,124532,1120781
1618,Asger Sørensen,47,337300,9637733489925661,167,1194977,1029266,0,1029266
1619,Boubakary Soumaré,22,3026000,9120234544063978,247,4412679,2356913,236,2356677
1620,Ricardo Esgaio,26,4604200,4999068315885942,417,6449285,4450097,4451,4445646
1621,Walace,60,3590400,7598403621932949,472,6121969,1357672,13577,1344095
1622,Anton Stach,39,2946800,7038354647435743,359,5026462,481648,48165,433483
1623,Josip Stanišić,37,1174500,7300545185614406,193,2276019,202255,20226,182029
1624,Zack Steffen,53,1798900,9755576227382523,311,3945379,1645098,165,1644933
1625,Kevin Stöger,56,4636400,7787426059164834,580,8557106,5765331,5765331,0
1626,Luis Javier Suárez,41,3909000,5708346920306433,390,6221865,3920584,0,3920584
1627,Denis Suárez,67,3063700,6104481750252916,566,6496609,6335682,6335682,0
1628,Heorhii Sudakov,22,3313400,3672895797584921,293,4920119,3431205,344,3430861
1629,Serhiy Sydorchuk,25,3441400,6792757580306625,246,4210954,1950260,1950260,0
1630,Damian Szymański,49,2287700,8894830113428549,402,4649064,3100318,311,3100007
1631,Marcus Tavernier,48,2639000,3596657152581155,379,4690336,2469137,247,2468890
1632,Greg Taylor,34,415800,3822293559876746,116,865303,257885,0,257885
1633,Kenneth Taylor,32,3110500,8301861010907014,269,4483318,1872392,1873,1870519
1634,Nahuel Tenaglia,30,1502500,5382445176266115,183,2421063,1126196,0,1126196
1635,Tarik Tissoudali,38,3587300,6154960010115263,368,5370782,3962101,397,3961704
1636,Cenk Tosun,51,1940100,3108051329905899,371,4558597,2018824,0,2018824
1637,Bertrand Traoré,69,2782500,7775852887527779,486,6063108,2487333,0,2487333
1638,Adama Traoré,51,2888800,5776655105842071,357,5064550,4364353,43644,4320709
1639,Felix Uduokhai,39,1635300,9738554209095999,205,2615380,1011393,1011393,0
1640,Aurélio Buta,45,1008000,9131854383315800,265,2742520,117198,0,117198
1641,Deniz Undav,58,4822300,9615521250329356,588,9008371,3980307,3980307,0
1642,Mark Uth,31,3564100,4740293716408047,343,5516380,17596,176,17420
1643,Milan van Ewijk,62,1643600,3389921120649623,325,3469960,1407430,14075,1393355
1644,Maarten Vandevoordt,68,4544500,8541172856057580,632,8236271,5442691,0,5442691
1645,Kevin,65,4661300,5044423135190440,564,8091028,4029184,4030,4025154
1646,Alan Velasco,27,2436700,7858461247528837,244,3436754,1168438,11685,1156753
1647,Alejo Veliz,55,1750800,6731444955879778,333,3826610,109269,1093,108176
1648,Bart Verbruggen,56,4966700,9946426207547639,557,7955947,3455974,346,3455628
1649,Domagoj Vida,49,2920300,8293547140066231,369,5220179,3660693,366070,3294623
1650,Tonny Vilhena,64,1112300,4933164799594179,338,3460600,1953077,195308,1757769
1651,Rodrigo Villagra,48,4612300,7875470593455083,544,8631157,4274535,0,4274535
1652,Lázaro,48,2860400,3640833368591919,404,5367981,3896613,0,3896613
1653,Jed Wallace,40,1550500,6190380255617985,253,2912799,1610123,1610123,0
1654,Shon Weissman,43,4892300,9070270175605979,547,7942249,3894891,390,3894501
1655,Harry Wilson,27,3433400,6776596674423881,298,4819744,1820779,0,1820779
1656,Chris Wood,45,4048000,4777258780855191,421,6529353,3259432,3260,3256172
1657,Andriy Yarmolenko,36,3307500,5765416012937357,377,5438835,4889116,4889116,0
1658,Ryan Yates,34,1259500,9378032593255620,166,2060690,65443,0,65443
1659,Miha Zajc,46,4185600,6412981971297075,545,7146304,5127268,512727,4614541
1660,Edon Zhegrova,24,1702700,9814644444791216,119,2041598,1235937,123594,1112343
1661,Adem Zorgane,70,1907600,4547894152043166,403,4269119,4010577,4011,4006566
1662,Brenden Aaronson,28,3019200,5629193021580538,304,4516262,437418,4375,433043
1663,Liel Abada,59,1434000,5722783266199852,310,3640771,1501209,1502,1499707
1664,Saud Abdulhamid,68,784500,5761124909657171,343,3059411,2641997,265,2641732
1665,Michel Aebischer,57,3011700,4213968820335355,414,5730348,1965556,196556,1769000
1666,Akapo,33,1104000,5720653441980305,171,1958237,1702642,0,1702642
1667,Akieme,51,1035600,8319193332449858,263,2734222,2269473,2269473,0
1668,Kevin Akpoguma,30,726500,8111014607322618,107,1177836,1004587,1005,1003582
1669,Iván Alejo,24,849200,9349398342553995,89,1147644,385089,0,385089
1670,Aleñá,26,3917100,9329648160180584,298,5094226,3511786,35118,3476668
1671,Samú Costa,37,3930000,5338627427080935,454,6988663,4591277,0,4591277
1672,Cristian Álvarez,31,879500,5535381770493440,122,1328170,806807,0,806807
1673,Sergio Álvarez,51,2795900,9728065278766478,365,4841891,2455009,2456,2452553
1674,Daniel Amartey,57,3111700,6805417340702250,449,5610111,2974728,2974728,0
1675,Zeki Amdouni,26,2598300,5042783268304402,240,3711255,3521502,352151,3169351
1676,Samu,36,3984700,3729232531630247,378,5974347,3473953,0,3473953
1677,Ethan Ampadu,23,3334400,3059420085453349,308,4980752,1784504,17846,1766658
1678,Tiago Gouveia,46,3945700,8717125199505302,450,6340800,2250717,0,2250717
1679,Sergio Araujo,25,4507500,3265346236102673,350,6911575,4507644,4508,4503136
1680,Tolgay Arslan,53,2790000,3249643128157697,435,5532974,462180,463,461717
1681,Takuma Asano,33,3435200,8262988542208226,299,5154624,2811846,2812,2809034
1682,Kristjan Asllani,59,3498000,5163839622712759,514,6399732,2248909,224891,2024018
1683,Giorgos Athanasiadis,23,3225100,7667559074630612,237,4099461,1776483,17765,1758718
1684,Jordan Ayew,34,2155200,4718402850789010,215,3466921,130955,131,130824
1685,Tiago Tomás,27,1064000,6790080876313004,129,1691253,1333096,1334,1331762
1686,Carlos Bacca,57,2627800,5319826270307920,370,5015582,800867,801,800066
1687,Matthias Bader,55,4433000,4351329606586218,562,7806170,6312579,6313,6306266
1688,Nedim Bajrami,24,1074800,6867961233368352,124,1477887,1119436,1119436,0
1689,Mitchel Bakker,34,2616300,6802989414012371,269,4123208,3795778,0,3795778
1690,Pedrinho,36,4292500,6366085546983041,441,6479366,4387273,43873,4343400
1691,Melvin Bard,67,2296500,4022380853209495,436,4985383,4322648,0,4322648
1692,Enis Bardhi,29,2938400,6334781075512860,275,4614859,863135,0,863135
1693,Adam Bareiro,33,739400,8703428008931380,114,1109670,401051,0,401051
1694,Ross Barkley,31,3431800,8425081907435440,329,5479281,4927791,0,4927791
1695,Barrenetxea,50,1598800,9590087486636680,295,3273042,3124502,3124502,0
1696,Nahuel Barrios,23,2203600,8080365934573626,164,2815114,227636,22764,204872
1697,Toma Bašić,64,4196000,5374344383583956,628,7439584,6056622,6057,6050565
1698,Calvin Bassey,55,4448100,7818686984377839,502,7675578,6817823,6817823,0
1699,Mourad Batna,44,465800,5141006532417311,160,1385787,446539,0,446539
1700,Martin Baturina,46,1237900,3506549134648624,274,2775601,2766681,277,2766404
1701,Mohamed Bayo,22,2516000,3901875303389332,199,3241546,217591,0,217591
1702,Riechedly Bazoer,70,1237200,7906379970363717,395,3801808,3553374,0,3553374
1703,Jan Bednarek,48,2193600,4315581183042720,301,4035837,682229,682229,0
1704,Asmir Begović,66,2889200,3358864908540788,482,5789428,2572386,258,2572128
1705,Kevin Behrens,52,4116300,3434054366719169,538,6976751,4869262,487,4868775
1706,Armel Bella Kotchap,55,4661600,7092813240114890,549,7887048,1506933,15070,1491863
1707,Darío Benedetto,51,3083900,5223968289621770,429,5285104,2222418,0,2222418
1708,Yassine Benrahou,49,2795200,7243307936471748,402,5281405,2183088,21831,2161257
1709,Christian Benteke,23,906300,7974770926868720,70,1000100,66562,0,66562
1710,Pietro Beruatto,24,434600,5437409722429375,50,414194,208521,0,208521
1711,Jan-Niklas Beste,69,2076100,3507053976770499,436,5201675,109535,109535,0
1712,Sam Beukema,61,3272700,8584823022679595,470,6493937,2153807,2154,2151653
1713,Saad Bguir,23,1139000,3144279977785744,96,1395405,843059,0,843059
1714,Samuele Birindelli,51,1833000,9868681353245229,314,3843980,2623946,262395,2361551
1715,Yann Aurel Bisseck,30,4127200,7407752342409307,405,6214657,4833076,0,4833076
1716,Rubén Blanco,42,4869500,7608736713553202,522,8273790,5708563,570857,5137706
1717,Victor Boniface,28,4335000,4978900994654981,347,6340793,5923543,0,5923543
1718,Jovane Cabral,67,767400,7710377935219946,358,3170964,1540922,154093,1386829
1719,Edoardo Bove,42,1436200,8828581993597269,258,2781174,602401,0,602401
1720,André André,62,2275800,3020461738290134,428,4990642,4095127,0,4095127
1721,Darko Brašanac,39,666900,8598659432851990,141,1329674,836560,837,835723
1722,Joshua Brenet,30,809900,9121715403848789,97,1179516,73375,7338,66037
1723,Ben Brereton Díaz,54,4953300,5278014028458110,661,9229413,1609026,0,1609026
1724,David Brooks,35,1187800,4042696408629873,203,2191056,608960,608960,0
1725,Pavel Bucha,24,4243900,6501965526086385,355,6200971,2358144,0,2358144
1726,Christian Burgess,37,4763600,6464435290863796,486,7805567,3977044,0,3977044
1727,Jonathan Burkardt,33,3199800,3154520529576617,320,4897662,4702066,0,4702066
1728,Leandro Cabrera,65,3310700,8088893105628486,511,5980263,5838101,584,5837517
1729,Carlos Cáceda,51,1624200,5063801330538541,273,3229692,323723,3238,320485
1730,Tom Cairney,56,4215800,6935853151597226,540,8157171,2672416,2672416,0
1731,Luca Caldirola,33,1875800,8505285984144864,211,2921452,199731,1998,197733
1732,Calero,55,398700,4925202401270692,243,1986761,1012531,102,1012429
1733,Nicolò Cambiaghi,67,4242500,9352777107525821,592,7855443,6527837,6528,6521309
1734,Andrea Cambiaso,41,2885600,8371939414317961,350,5047511,4130369,0,4130369
1735,Jaminton Campaz,50,2105400,7764210502818740,345,4272958,799913,0,799913
1736,Nicolás Capaldo,62,3464900,6682588279059230,511,6524965,803655,804,802851
1737,Iza Carcelén,35,1724200,8456508169748663,200,2724006,369920,36992,332928
1738,Dani Cárdenas,58,2728000,7356044915006267,397,5493920,1950833,195084,1755749
1739,Tomás Cardona,61,3844900,9594008663545148,556,7008147,4977741,49778,4927963
1740,Sergi Cardona,52,4842400,9927619912880362,505,7858547,338814,33882,304932
1741,Ramiro Carrera,43,2897900,9823670074473391,350,5138103,4941766,0,4941766
1742,Fábio Carvalho,38,3681300,3981102495312200,389,5805570,4318503,4318503,0
1743,Alexis Castro,67,860900,7127575873902461,339,3163721,2520229,252023,2268206
1744,Matías Catalán,44,1518700,7907301576844171,281,3103875,1258813,12589,1246224
1745,Federico Ceccherini,36,4698900,9063745468620918,468,7610779,3847755,3847755,0
1746,Calum Chambers,22,3105200,4444363324009608,253,4693354,2246955,2246955,0
1747,Tomás Chancalay,27,2410200,3343937717167780,201,3053837,1863820,18639,1845181
1748,Diego Chará,36,4489500,6481625424338084,482,7351922,6033050,603305,5429745
1749,Joris Chotard,43,1985300,7708351193871274,270,3616881,842654,0,842654
1750,Anders Christiansen,65,2814400,8014099188665008,502,6505365,631417,6315,625102
1751,Ryan Christie,30,3236400,5407165472494972,286,4498173,4457823,445783,4012040
1752,Pathé Ciss,60,4281900,5732683072738927,562,7471363,4326825,4326825,0
1753,Nathaniel Clyne,40,2707500,3554782963781291,345,4812367,1636101,16362,1619739
1754,Massimo Coda,40,2276800,8801651029883529,321,3900815,1175989,1175989,0
1755,Antonio Čolak,48,760100,9899036600962353,230,2087178,649000,0,649000
1756,Omar Colley,68,2500400,6735152914418981,458,5467625,5096013,5097,5090916
1757,Andrea Colpani,68,1460700,3920491946938979,382,3618542,1023752,102376,921376
1758,Levi Colwill,29,591500,8940941685572323,96,920144,349977,3500,346477
1759,Lewis Cook,48,318100,9873598436158244,170,1360416,1095154,1095154,0
1760,Jake Cooper,25,1712800,7138746847889355,165,2425103,530235,0,530235
1761,Liam Cooper,70,2927100,9229497189868115,523,6737062,5031617,0,5031617
1762,Lassana Coulibaly,27,4417000,9429919338206204,343,5851498,716314,7164,709150
1763,Nicolas Cozza,52,804700,6170472504725257,257,2541796,1536937,1537,1535400
1764,Andrés Cubas,38,1527600,3095327418414289,205,2684405,578029,578029,0
1765,Carlos Cuesta,59,4731600,8051921369445013,614,7943885,188431,0,188431
1766,Bernardo Cuesta,29,1116800,6991705758137714,154,1881890,932265,0,932265
1767,Christian Cueva,52,577900,6497343571266346,187,1610514,1143017,1144,1141873
1768,Rafael Czichos,70,4976100,3703584117563857,668,9568504,1102266,111,1102155
1769,Danny da Costa,41,1852700,7390253473119925,268,3355895,1952311,1952311,0
1770,Karl Darlow,57,4762100,4261024466485423,597,8692614,1713772,171378,1542394
1771,Pablo De Blasis,60,2053700,9966453949526202,414,4633730,2533902,254,2533648
1772,Julien De Sart,52,3949700,9696284637592572,501,7210923,2760896,2760896,0
1773,Murilo,56,3529100,7878604326104296,499,6723867,5650742,56508,5594234
1774,Ersin Destanoğlu,57,4678900,7106760135276814,631,8883920,4380019,43801,4336218
1775,Amad Diallo,42,2993100,3140585565723937,352,4780614,475272,475272,0
1776,Bebé,52,3083500,5668155897433836,416,5873406,1850991,185100,1665891
1777,Mory Diaw,48,966500,3751269187631349,271,2648094,1454381,146,1454235
1778,Leandro Díaz,44,4888500,4450612673640508,507,7143361,2944626,0,2944626
1779,Sinaly Diomandé,69,1328200,9274632199791119,373,3945679,291774,0,291774
1780,Andy Diouf,51,1618700,5007204961053890,364,3818288,501921,5020,496901
1781,Tasos Douvikas,69,3462400,3259424417017703,606,7444575,3142921,3143,3139778
1782,Anders Dreyer,52,2229400,5855938719673134,403,4889679,719180,71918,647262
1783,Óscar Duarte,25,2535100,6075605212923434,227,3859203,3806029,38061,3767968
1784,Léo Dubois,59,560500,9601739207548212,269,2231131,1550282,155029,1395253
1785,Ondrej Duda,50,2376800,9363284633516861,371,4707237,3144085,31441,3112644
1786,Alfred Duncan,22,1568900,5012555392438546,108,1987887,335918,335918,0
1787,Hugo Duro,65,2163000,9947210939269854,439,5101031,1017219,102,1017117
1788,Tyronne Ebuehi,30,4882800,7367789092358000,473,7664191,4317228,43173,4274055
1789,Rodrigo Echeverría,30,3123500,7378821552026706,313,4822784,1528244,1529,1526715
1790,John Egan,26,2795500,7235938379211332,242,3623563,984536,0,984536
1791,Magnus Wolff Eikrem,27,3521300,6016563808575472,342,5486159,5289284,52893,5236391
1792,Jalil Elías,62,1725300,8039127082986427,337,3709777,313124,0,313124
1793,Martin Erlić,43,2742700,6466811787300428,333,4802771,4742081,47421,4694660
1794,Aarón,27,829100,5434145669766069,72,939218,172023,0,172023
1795,Escudero,39,4434400,6152509541590964,479,7162004,6407135,0,6407135
1796,Cristian Espinoza,37,1712900,8762208880743466,245,2886280,461156,46116,415040
1797,Maxime Estève,28,359200,5613048751307777,82,627408,119361,11937,107424
1798,Francisco Conceição,68,1594900,6788017219253906,360,3965565,1190930,119093,1071837
1799,Federico Fattori,50,2046300,7554480234108142,359,4073861,1304387,1305,1303082
1800,Kiko Femenía,35,2980600,8367452228723412,302,4643087,3894445,3894445,0
1801,Leroy Fer,61,3737900,5769535355545033,591,7999664,452899,452899,0
1802,Lewis Ferguson,24,3203700,8721751522169150,302,4966677,3557554,0,3557554
1803,Junior Firpo,67,4114100,9184263198733508,609,8242315,4041568,4041568,0
1804,Zian Flemming,23,3589400,3403321915416169,347,5085956,2045885,0,2045885
1805,Thomas Foket,69,1168100,6404244190390455,379,3713573,2980416,299,2980117
1806,João Talocha,67,3010700,8961821578863743,564,6304722,4029257,4029257,0
1807,Dimitri Foulquier,62,2358300,6769719652686744,444,5464901,515188,51519,463669
1808,Marco Friedl,60,697800,4425094602647712,293,2593106,265572,2656,262916
1809,Kanya Fujimoto,61,4039000,9109015685434008,553,7490233,5828024,5828024,0
1810,Roberto Gagliardini,63,1481700,3066756798350257,360,3831413,2167064,2168,2164896
1811,Hernán Galíndez,36,1998600,5012654679217049,213,3120758,1617196,16172,1601024
1812,Raúl García,34,3804900,9407896107069748,335,5986081,3879002,388,3878614
1813,Borja García,48,4477800,9960181639618597,505,7468901,4552592,4553,4548039
1814,Kike García,24,4559800,5084475497005821,428,6612062,1032737,104,1032633
1815,Federico Gattoni,57,343000,5845651439268905,217,1804907,1282405,128241,1154164
1816,Georgios Giakoumakis,66,1370400,3480046583413530,404,3927876,1835044,18351,1816693
1817,Andreas Gianniotis,32,2921700,7201302937458072,338,4826568,425477,0,425477
1818,Leonardo Gil,54,1911400,6766925461340844,385,4467346,3046120,3047,3043073
1819,Óscar Gil,51,3156600,7175523667767750,414,5722862,585655,58566,527089
1820,Ryan Giles,59,2791600,5988224918286437,449,5628617,352950,0,352950
1821,Robert Glatzel,28,2143400,6550602440108430,227,3342701,954457,95446,859011
1822,Wilfried Gnonto,37,4520000,7215980786913086,512,7675654,2153917,2153917,0
1823,Leonardo Godoy,22,840400,9984457154656646,64,855659,497277,0,497277
1824,Toti Gomes,58,2378000,6360866487075693,413,4744991,3829125,0,3829125
1825,Gabriel Sara,35,1080500,4726656156696876,142,1715995,463636,0,463636
1826,Yeimar Gómez Andrade,24,699600,9675083857989012,72,885020,273964,27397,246567
1827,Sergio Gómez,28,2664200,6340022936409370,237,3828750,892583,89259,803324
1828,Víctor Gómez,22,450400,9240437846700143,26,233420,104924,1050,103874
1829,Sergi Gómez,22,1891200,4107086822298143,143,2331094,882501,882501,0
1830,Maxime Gonalons,51,4298800,7594688449175317,496,6928715,6485259,64853,6420406
1831,Mario González,48,4252300,9736429157427540,513,7408268,1318839,1318839,0
1832,Craig Gordon,50,4774600,8847590060629075,543,7905535,7115620,711562,6404058
1833,Jon Gorenc Stanković,26,1065700,4611752939102606,122,1675901,1591365,1592,1589773
1834,Lukas Görtler,45,3196000,3839564289950162,377,5626370,5301054,5301054,0
1835,Max-Alain Gradel,22,746900,8292648545692621,41,640567,523278,5233,518045
1836,Andreaw Gravillon,70,3216600,4507770346542753,577,7040653,3213633,3214,3210419
1837,Albert Guðmundsson,26,621900,6674971792330010,58,688079,64979,64979,0
1838,Ander Guevara,59,1711100,4553241233343692,340,3958690,3873556,387356,3486200
1839,Angus Gunn,57,3136200,6691748300957650,480,5879423,1673117,1674,1671443
1840,Guridi,37,4120400,5640090130172707,368,6562539,2542592,2542592,0
1841,Miguel Gutiérrez,57,1054000,6282204983629184,258,2504357,823457,0,823457
1842,Günay Güvenç,50,3461400,6575026668973982,506,6339418,5974214,0,5974214
1843,Joe Hart,46,3145900,5448844476771913,420,5556515,4175535,417554,3757981
1844,Taylor Harwood-Bellis,54,4037800,4450766546221629,562,7803836,2857698,28577,2829121
1845,Pantelis Hatzidiakos,36,4507500,5273194562260090,436,6809659,2515664,252,2515412
1846,Lukáš Hejda,27,2765100,7784092763123052,230,3633724,425181,0,425181
1847,Thomas Henry,38,1069500,8463093579259106,154,1721886,1660092,166010,1494082
1848,Wesley Hoedt,32,940400,9417264697945006,120,1523244,815366,8154,807212
1849,Lucas Höler,23,2567400,6359192259252510,188,3520035,3093817,0,3093817
1850,Mason Holgate,58,3670000,9157408150727732,543,7383629,2077097,20771,2056326
1851,Will Hughes,50,2251600,5463090463052768,363,4619071,703710,70371,633339
1852,Hwang Ui Jo,22,982900,8545004871192078,82,1092761,1007900,101,1007799
1853,Jackson Irvine,43,3795400,9641420232606038,434,6081053,2500874,251,2500623
1854,Gustav Isaksen,44,498200,3091861305159340,175,1482297,1288723,128873,1159850
1855,Daniel Iversen,44,1208800,5162008854409570,255,2947424,330388,0,330388
1856,Carlos Izquierdoz,47,4272400,6715526810754510,464,6494546,5237454,5237454,0
1857,Armando Izzo,69,1270800,3535557750607693,385,3664307,3058503,305851,2752652
1858,Ryan Jack,60,2445300,5018607921744731,431,5302438,718918,719,718199
1859,Paul Jaeckel,52,460100,7280568935384822,179,1411891,134218,13422,120796
1860,Lucas Janson,23,4554400,9730674506733063,387,5998662,3909685,3910,3905775
1861,Pontus Jansson,45,4955300,8055893269310730,503,8023666,7035587,7035587,0
1862,Moritz Jenz,48,4401400,9274923531978727,480,6602220,3197795,0,3197795
1863,Jo Hyeon Woo,24,4281000,5379100551193883,318,5990779,1108792,111,1108681
1864,Ben Johnson,34,1093000,7796713064087103,197,2261085,91898,919,90979
1865,Jens Jønsson,23,3285400,9191633145547324,277,4456553,51931,0,51931
1866,Joo Min Kyu,40,4879300,5657436321441620,529,7906679,1319999,1319999,0
1867,Zanka,69,1244800,6333624577083471,400,3931836,3687821,368783,3319038
1868,Václav Jurečka,29,2534200,8895368170535748,235,3964046,2206558,220656,1985902
1869,Kaan Kairinen,45,4586100,8204524567553187,467,7204226,1337407,13375,1324032
1870,Gaël Kakuta,47,1736000,3924308694997891,300,3310204,1885740,1885740,0
1871,Hassane Kamara,70,2298900,4743449260991460,498,5782021,4240163,42402,4197761
1872,Efecan Karaca,58,2066400,3649496825371683,391,4665974,4295447,429545,3865902
1873,Silas,35,2438900,9280160347151759,299,3967099,252614,0,252614
1874,Jonjoe Kenny,56,2096600,3725096732452112,400,4682291,2962465,29625,2932840
1875,Wahbi Khazri,46,3924100,3570581069610173,427,5993947,4728490,0,4728490
1876,Jakub Kiwior,54,4502200,7013117571426524,572,8274723,5991458,0,5991458
1877,Klauss,49,431500,7245827077770908,172,1366690,382648,0,382648
1878,Mateusz Klich,64,4050200,7332416811403345,605,7902010,7244045,7244045,0
1879,Jan Kopic,44,1951000,8433983955726705,317,4107092,484963,4850,480113
1880,Rominigue Kouamé,45,2797600,9714185245255604,341,4556842,1590659,1591,1589068
1881,Dimitrios Kourbelis,41,3654200,4499609897560503,348,5407918,3459405,3460,3455945
1882,Matěj Kovář,60,3897300,7725337912911472,540,7059051,5208935,52090,5156845
1883,Tom Krauß,69,906400,8110845243098764,373,3274999,1675480,167548,1507932
1884,Stanislav Kritsyuk,60,4768200,4755988357309251,636,8280442,3438133,343814,3094319
1885,Carlos Lampe,24,2819200,7246608291164316,276,4483989,1559634,15597,1544037
1886,Jens Stryger Larsen,41,3399900,9516706618139832,352,5227930,4589678,4590,4585088
1887,Jordan Larsson,63,4633400,9199192597059572,570,8183166,2725611,27257,2698354
1888,Vincent Le Goff,49,1199900,8998262938468927,255,2747757,1103614,110362,993252
1889,Mathew Leckie,22,2414000,9556081837950493,191,3023151,2812097,2812097,0
1890,Daniel Figueira,70,386800,4464220079243338,332,2605091,21247,21247,0
1891,Lekue,62,3536500,7596351728093754,549,7573144,6377599,638,6376961
1892,Moisés,58,2568600,6049124570629182,454,5869417,2775864,2775864,0
1893,Karol Linetty,42,2932600,8752916590339777,404,5392862,2745859,275,2745584
1894,Tino Livramento,53,664800,8231921699544487,235,2153755,1929685,193,1929492
1895,Tom Lockyer,52,2767300,6362745949076462,379,5336955,5311632,531164,4780468
1896,Yury Lodygin,29,1183300,7627598786303645,157,2011155,1748944,17490,1731454
1897,Lisandro López,48,4762700,3296596206577056,533,8125316,6475685,6476,6469209
1898,Unai López,36,2009900,4357685113850637,262,3347256,1827687,182769,1644918
1899,Jhon Lucumí,46,1552400,7585479896001090,300,3381240,1156398,116,1156282
1900,Andriy Lunin,52,1585200,6306826665696310,316,3263865,30678,3068,27610
1901,Sebastiano Luperto,37,2041500,5991160086198396,241,3228591,1616115,0,1616115
1902,Ian Maatsen,38,1865900,8477057186790108,260,3311054,521244,52125,469119
1903,Kevin Mac Allister,57,3663600,6618947909974199,515,7028112,4352193,43522,4308671
1904,Daizen Maeda,62,760100,3564024111022868,258,2472728,2202646,0,2202646
1905,Hörður Magnússon,37,968600,4400373400275362,204,2058577,282502,28251,254251
1906,Adam Maher,66,3517100,5928116957952800,553,6993249,1471535,14716,1456819
1907,Tiago Silva,27,2813900,9659110456404721,255,4063328,1965126,196513,1768613
1908,Linton Maina,41,3634400,5355147262091155,417,5813427,637762,63777,573985
1909,Patrick Mainka,55,1244300,3692959725206605,313,3117026,1122642,11227,1111415
1910,Daniel Mancini,39,3601200,9849587128610766,395,5697498,4556511,4556511,0
1911,Aleš Mandous,63,4327300,8901830451343405,653,8170934,3804232,3804232,0
1912,Ryan Manning,57,898700,5489698428061973,294,2783660,666825,6669,660156
1913,Benson Manuel,33,4780200,5205080494943863,465,7526270,5989170,59892,5929278
1914,Iván Marcone,34,4868400,6846403738142254,463,7261082,6635785,664,6635121
1915,Adrián Marín,59,3460700,3233165091999257,486,6748921,813540,8136,805404
1916,Eric Martel,40,2927700,4886140712251561,376,5351668,1488954,1488954,0
1917,Alexis Martín Arias,55,1872500,5160985931219128,324,3952188,900695,900695,0
1918,Iván Martín,58,711100,5931972584317206,286,2677986,2026036,203,2025833
1919,José Andrés Martínez,38,4424100,3120110977269454,432,7193337,784587,7846,776741
1920,David Martínez,36,2316700,3142203520269641,278,3513643,1478532,1479,1477053
1921,Bruno Martins Indi,59,1053900,6678544515429575,334,3361746,1427089,0,1427089
1922,Lukáš Masopust,30,899000,5612582478634862,123,1395698,1157078,1157078,0
1923,Neal Maupay,66,835500,7357652702895949,305,2699033,2534057,253406,2280651
1924,Borja Mayoral,26,3138200,7643045591129934,260,4424271,2207217,22073,2185144
1925,Mark McKenzie,22,4202000,4088483651469486,323,5553267,355257,356,354901
1926,Nico Melamed,66,1870900,4434269982492862,380,4032590,3473321,3474,3469847
1927,Melero,45,3112900,5201966705724873,369,5504011,2964371,297,2964074
1928,Lorenzo Melgarejo,49,2667200,9676329383287664,391,5011060,4219305,4219305,0
1929,Eugenio Mena,48,4973800,9734769478596004,606,8270766,5970468,0,5970468
1930,Fran Mérida,44,4462200,7442022208286788,524,7023685,1367463,0,1367463
1931,Bautista Merlini,41,3413900,4295046290633636,360,5639728,5310902,5311,5305591
1932,Max Meyer,43,4764900,4418799211757624,545,8532636,4125018,41251,4083767
1933,Alexander Meyer,39,1514100,7960669648985161,245,2890708,1131092,114,1130978
1934,Sebastián Meza,64,1510500,9330489849133214,394,4109240,1599465,159947,1439518
1935,Fredrik Midtsjø,49,3659500,6201965133857726,460,6236434,248974,0,248974
1936,Kevin Mier,57,3133900,3743890517246976,471,6521342,2062635,2063,2060572
1937,Georges Mikautadze,41,4002800,4569708990182180,468,7228121,5741280,575,5740705
1938,Takumi Minamino,22,2046500,9298140380502713,136,2359495,807020,0,807020
1939,Mingueza,44,3831100,5187501329719442,457,6326856,3160631,0,3160631
1940,Leonel Miranda,48,573800,9797729526219838,198,1750496,1356640,135664,1220976
1941,Josip Mišić,56,991600,3766927670928051,280,2551747,1828169,1829,1826340
1942,Virgil Misidjan,30,3592300,8596668980143738,345,5217855,2055790,0,2055790
1943,Stefan Mitrović,26,2223400,7734795309704911,212,3352129,2101842,2102,2099740
1944,Maximilian Mittelstädt,41,4698500,5615203137176046,473,7119236,4924411,4924411,0
1945,Jakub Moder,52,4992700,9579903451965062,580,8450959,3585593,0,3585593
1946,Mostafa Mohamed,37,3859800,6232102109519744,438,6926124,1705314,0,1705314
1947,Munir,29,2601900,8508309374212880,258,3956185,695581,0,695581
1948,Stoichkov,30,4163600,8012526773849616,390,6206079,2112649,211265,1901384
1949,Emre Mor,40,1530700,5542042320046034,200,2373052,1496589,14966,1481623
1950,Leonardo Morales,45,4999900,8189416561824002,512,8193106,5879893,588,5879305
1951,Lewis Morgan,64,3907100,8734398669677433,483,6348995,598969,0,598969
1952,Nikola Moro,52,2620400,3130358081119509,421,4886918,2957829,296,2957533
1953,Dany Mota,67,1616500,8480227681052956,441,4250516,266103,0,266103
1954,Aihen Muñoz,44,471300,3414305220034041,181,1451657,1378174,138,1378036
1955,Alex Muñoz,43,1275100,6243956239889048,216,2520216,318038,0,318038
1956,Petar Musa,37,1977100,9208095831113678,285,3797899,2767722,277,2767445
1957,Yunus Musah,56,4000400,8991705281322376,529,6977901,3409582,34096,3375486
1958,Knowledge Musona,32,4428700,3048855605025591,367,6042246,2070729,2071,2068658
1959,Phillipp Mwene,27,4824900,9090290426117181,379,7326784,3141703,0,3141703
1960,Na Sang Ho,49,1439200,3257651029654690,301,3137118,2170472,217048,1953424
1961,Darlington Nagbe,58,2735100,8757408790536926,455,5453875,3010326,301033,2709293
1962,Marvelous Nakamba,63,2538400,8620169266306067,439,5396901,4031827,4031827,0
1963,Khaled Narey,41,4399800,8638060179367028,459,6607136,4582212,458222,4123990
1964,Iliman Ndiaye,48,3525800,4608952983348651,397,5787894,2486635,24867,2461768
1965,Reiss Nelson,40,4013400,3172521712783234,448,6635813,5418715,541872,4876843
1966,Neto Borges,54,1792000,4246683766635446,324,3852664,1817237,0,1817237
1967,Carlos Neva,41,1914000,5648312170167290,269,3567711,3420017,3420017,0
1968,Lee Nicholls,69,2414100,4456033357687036,493,5654532,3752618,3752618,0
1969,Arnaud Nordin,38,2323800,8853111268993415,271,3944276,993637,0,993637
1970,Oliver Norwood,69,1187100,6335722432598105,400,3772219,2112829,2112829,0
1971,Luís Neto,56,2154100,8726911651966061,366,4416808,4096997,409700,3687297
1972,Gerzino Nyamsi,46,434800,4152923621341414,144,1129297,443089,0,443089
1973,Armando Obispo,59,1995700,4457441013786048,403,4491090,1307571,0,1307571
1974,Vadis Odjidja-Ofoe,26,4247600,9726600359537037,411,6602828,5508833,5509,5503324
1975,Masaya Okugawa,56,3829300,5850832367461805,508,6610512,562789,563,562226
1976,Kristoffer Olsson,55,3592500,6732023451359102,451,6451964,4810069,482,4809587
1977,Jean Onana,58,2814600,9978836490052006,429,5578837,2986827,2987,2983840
1978,Henry Onyekuru,47,746400,3424230054210480,228,2066551,1810123,181013,1629110
1979,Ivan Ordets,57,4825400,7259022738921887,624,8407478,3223611,3223611,0
1980,Bright Osayi-Samuel,63,1018400,8944096576337013,307,3018086,2315519,0,2315519
1981,Adam Ounas,58,4279400,4936792154376295,509,7103762,6531432,65315,6466117
1982,Reece Oxford,53,2634600,5663276028941338,388,4775768,1163673,0,1163673
1983,Willian Pacho,51,1082300,6224179848738436,247,2455937,1007687,1007687,0
1984,Agustín Palavecino,60,1430400,6924362634229887,295,3218480,1081946,1081946,0
1985,Filip Panák,39,4659600,7563498325897943,443,7100836,7045485,0,7045485
1986,Marcus Holmgren Pedersen,64,3050700,3877496865889645,475,5777025,3196413,31965,3164448
1987,Luca Pellegrini,65,3211100,7364863223428310,527,6211347,4971526,498,4971028
1988,David Costa,61,1767700,3943660041192982,366,3937815,3895694,3896,3891798
1989,Danilo,53,4904800,8054286773656623,543,7639694,6255074,6256,6248818
1990,Jeffinho,63,917600,7553250219866456,322,3177299,63462,6347,57115
1991,Guga Rodrigues,28,1467800,3353036454094612,184,2348274,771536,0,771536
1992,Joaquín Pereyra,31,493200,6610336530266196,78,714988,670311,0,670311
1993,Đorđe Petrović,51,3228600,8470773388789406,426,5865694,5591190,5592,5585598
1994,Patric Pfeiffer,61,2960600,8709044919403158,457,5462040,2174163,0,2174163
1995,Maximilian Philipp,70,752100,4703597723120692,343,3146024,1889582,0,1889582
1996,Amos Pieper,37,2797600,7734717185485765,306,4614280,2385658,0,2385658
1997,Andrea Pinamonti,35,3158000,4640391797600498,298,4706515,2707533,0,2707533
1998,Tozé,26,4871300,6802599148896927,448,7108856,6881918,0,6881918
1999,Joël Piroe,51,3385100,7171848247710956,444,6045037,5430491,544,5429947
2000,Joel Pohjanpalo,41,3842400,6626406744967149,410,6222735,3403788,34038,3369750
2001,Marin Pongračić,24,3039100,6676598903767409,244,4359132,1687,169,1518
2002,Denys Popov,33,1096500,6799521730204837,157,1780420,290210,0,290210
2003,Alexander Prass,31,4664400,4215310996165806,492,7315620,2044051,205,2043846
2004,Carlos Quintana,52,4359300,4499998177631803,563,7196488,4388066,0,4388066
2005,Romell Quioto,32,702500,4818430495269269,132,1352462,260841,2609,258232
2006,Aaron Ramsey,48,3472900,8791432257687008,446,6455270,2482624,0,2482624
2007,Fabian Reese,32,310200,4917254498290161,95,626100,263593,263593,0
2008,Ludovit Reis,68,3415300,9397309488033369,556,6760419,4044591,0,4044591
2009,Elvis Rexhbeçaj,54,3645600,6639925511431340,506,7070376,6143540,615,6142925
2010,Chris Richards,58,3680000,9818911931656618,547,6944711,6896772,689678,6207094
2011,Sergio Rico,63,3533100,9058439190023623,480,7038441,1348060,13481,1334579
2012,Fabian Rieder,43,1620200,9827289776755923,257,3325520,1774447,177445,1597002
2013,Jaïro Riedewald,68,431500,3283869424144073,351,2614635,1251566,1251566,0
2014,Jacob Rinne,44,4132800,7705806846435953,472,7179195,6870921,6871,6864050
2015,Stefan Ristovski,57,4513700,4934666104993404,569,8144517,3380430,0,3380430
2016,Joe Rodon,61,829900,5497854939353568,308,2959461,1485432,1486,1483946
2017,Luis Miguel Rodríguez,24,3587600,7880999849713825,324,5452919,803601,0,803601
2018,Jorge Rodríguez,54,3475000,7779878352774397,451,6245692,1528069,152807,1375262
2019,Diego Rodríguez,61,1528700,3563543094486852,345,3705221,1475455,147546,1327909
2020,Puertas,42,2616800,3871771976240225,339,4453950,3220753,3220753,0
2021,Monchu,51,3275100,6127806871601788,429,6088167,166433,166433,0
2022,Robert Rojas,30,4813500,8890428173957828,451,7316577,576166,577,575589
2023,Anthony Rouault,35,1306800,3524577681972115,163,2120295,1115758,111576,1004182
2024,Albert Rusnák,29,1970900,7804210326803720,180,2651037,2262569,0,2262569
2025,Michal Sadílek,45,2496600,6457590777170684,348,4660351,4345782,4346,4341436
2026,Lukáš Sadílek,37,1617500,3573384207630713,218,2868824,155419,1555,153864
2027,Wesley Saïd,64,4333200,7840870655050554,613,7732448,2893297,2894,2890403
2028,Samu Sáiz,44,4932700,9547531187538176,480,7301263,5837970,5837970,0
2029,Albert Sambi Lokonga,39,1426700,7135181417549679,207,2565495,2560461,0,2560461
2030,Jorge Sánchez,32,1185300,7440780099911097,161,1955223,205265,206,205059
2031,Germán,33,2957100,7811056654449032,301,4704412,2218542,2219,2216323
2032,Manu Sánchez,41,1231300,9554518124369284,215,2302522,1800726,181,1800545
2033,Ilie Sánchez,59,683500,8561011051694421,303,2746332,956020,9561,946459
2034,Curro Sánchez,26,2787300,9815105279823731,230,3908846,2398817,2399,2396418
2035,Agustín Sant'Anna,63,4440100,7139689429826397,658,8529926,3950441,0,3950441
2036,Daniel Bragança,68,1085800,3460013555444289,369,3653229,1801106,1802,1799304
2037,Malang Sarr,64,1871700,8358488861933283,443,4642675,4444907,444491,4000416
2038,Jefferson Savarino,36,2663900,9557721023888004,316,4656718,2529303,25294,2504009
2039,Amir Sâyoud,23,1354800,4114610569596577,100,1618928,427176,42718,384458
2040,Joe Scally,69,2673700,5838263343671412,545,6382011,1539112,1540,1537572
2041,Benno Schmitz,23,1612700,5379574515643071,134,2281644,1297999,12980,1285019
2042,Rob Schoofs,53,1898700,4693330163923856,320,3519318,1069877,106988,962889
2043,Ivan Schranz,62,2674800,8172526271214632,444,5338182,5077732,508,5077224
2044,Richard Schunke,68,468000,3806546743866817,279,2235887,134692,135,134557
2045,Stefan Schwab,61,4816200,9843608747661125,573,8820185,1074971,1075,1073896
2046,Faïz Selemani,63,1492900,4111971437614506,376,3830545,850097,850097,0
2047,Lawrence Shankland,61,1094000,7788393485058931,289,2795669,1279751,127976,1151775
2048,Moses Simon,58,3541800,6831480033644648,513,6195821,2162063,2163,2159900
2049,Manolis Siopis,56,4704400,6322960140498657,607,8233444,4908774,4908774,0
2050,Ibrahima Sissoko,62,771800,6210927684497116,319,2711637,40408,4041,36367
2051,Robert Skov,53,2897800,6008916782995992,398,5159809,1612593,1613,1610980
2052,Adam Smith,59,621500,4453181487944107,251,2226431,192183,19219,172964
2053,Josué,31,639100,8824488386399340,103,1100496,1064668,1065,1063603
2054,Rubén Sobrino,63,3851500,5928785326428056,633,7766257,2287366,22874,2264492
2055,Ramón Sosa,56,4640700,8663730326434768,570,8285264,3664026,3665,3660361
2056,Brenner,53,2618800,3998228077186936,434,5358589,5175584,51756,5123828
2057,Djed Spence,45,2658300,3308637212132496,320,4866265,3277420,0,3277420
2058,Jens Stage,34,880100,5230192553595237,149,1596558,508310,508310,0
2059,Benjamin Stambouli,43,2068100,6803760979022374,278,3568194,1239122,1239122,0
2060,Cican Stanković,66,3022500,6457565950745463,531,6700947,535070,535070,0
2061,Carl Starfelt,59,2580000,8533960617294859,480,5816397,72121,0,72121
2062,Niklas Stark,29,812300,3716247437054208,95,1082482,343700,344,343356
2063,Jack Stephens,61,2641100,7015841281637024,445,5566634,1574568,0,1574568
2064,Petar Stojanović,56,2516800,6061459053559154,455,5475779,2769832,276984,2492848
2065,Thomas Strakosha,55,2443700,9673252444192796,352,4496344,160130,160130,0
2066,Luka Sučić,33,3875500,7994008234942927,389,6063567,55907,0,55907
2067,Kamaldeen Sulemana,32,3523000,3098808116906307,353,5538314,1057432,106,1057326
2068,Karol Świderski,37,3639900,7129896865799737,345,5789703,2201193,2202,2198991
2069,John Swift,44,4053100,7494110182485482,490,7618443,4322466,4322466,0
2070,Montassar Talbi,48,756800,7365835544866796,207,1886365,1635297,164,1635133
2071,Adrien Tameze,53,4893600,9967915846987493,617,8100879,3755726,3755726,0
2072,Japhet Tanganga,68,2141600,5108395993569059,430,4775162,1725737,1726,1724011
2073,Nathan Tella,41,330500,8028977042407275,131,904974,79510,79510,0
2074,Simon Terodde,43,702600,5358579705325552,218,1999984,1177895,118,1177777
2075,Morten Thorsby,43,2340500,5640600982677106,349,4219971,2953072,0,2953072
2076,Guus Til,36,1764500,3947912918443360,215,3061646,2687522,268753,2418769
2077,Malik Tillman,53,2218500,7887538169842156,400,5077369,4779050,47791,4731259
2078,Quinten Timber,69,4529100,4108896979258740,615,8015574,1401564,0,1401564
2079,Marcel Tisserand,42,2215900,4046376805633878,346,4522619,2227067,0,2227067
2080,Dorukhan Toköz,45,1732700,4620064324671967,257,3244109,2456096,0,2456096
2081,Hassan Tombakti,59,1452000,6513877091108437,319,3476809,2546203,2547,2543656
2082,Ömer Toprak,22,1908200,8249213039498747,159,2623667,2383351,23834,2359517
2083,Miguel Ángel Torrén,39,382100,6835346502235092,119,969927,464783,0,464783
2084,Jordan Torunarigha,30,3146400,7070764511897222,309,4779874,1990932,0,1990932
2085,Lassina Traoré,22,4906100,8944459575044173,442,6966916,5462857,54629,5408228
2086,Salih Uçan,48,4079400,5568883409662455,462,6844170,2183596,218360,1965236
2087,Mikael Uhre,30,2853900,6137479128950428,281,4293549,1096144,1097,1095047
2088,Sven Ulreich,66,4558500,3971658592224897,654,9392717,1380069,0,1380069
2089,Bruno Valdez,34,1078500,8571405650409941,169,1879578,1330364,13304,1317060
2090,Vallejo,45,1801100,9850555100095281,286,3434175,2324041,2324041,0
2091,Hendrik Van Crombrugge,42,2329700,4303201412664311,335,4653416,3087353,0,3087353
2092,Dante Vanzeir,62,4608400,3724752531341977,587,8153436,3193245,3193245,0
2093,Ruben Vargas,50,1801100,6109586133660186,322,4030141,3223621,3224,3220397
2094,Emiliano Vecchio,57,670900,5445489762965365,254,2212150,1819874,18199,1801675
2095,Lars Veldwijk,24,3444900,8813313839861854,316,5098603,3321207,3321207,0
2096,Unai Vencedor,57,3593800,9864245510406466,474,6387161,2586968,0,2586968
2097,Simone Verdi,52,1637800,8787955629031181,310,3767528,1962853,196286,1766567
2098,Jannik Vestergaard,43,2160900,3542780083322135,322,4166031,3006580,300658,2705922
2099,Toni Villa,46,4355800,5844165020201228,439,6960312,117755,11776,105979
2100,David von Ballmoos,35,4161600,7765946582889343,374,5816491,3982848,3983,3978865
2101,Luca Waldschmidt,65,992800,9856731152070874,299,2782218,2461745,24618,2437127
2102,Marvin Wanitzek,44,2958900,5874598819686611,379,5211701,581491,582,580909
2103,Victor Wanyama,59,1830700,6700000789284828,381,4295708,1276738,127674,1149064
2104,Joel Ward,56,2085200,7180116460453951,383,4385934,1914907,1914907,0
2105,Timothy Weah,32,1442800,4568456241902221,176,2370150,2277158,2277158,0
2106,Ben Whiteman,24,3660700,4998352782630735,306,5091226,3375737,337574,3038163
2107,Harry Winks,59,2058900,9182724557314381,364,4198261,4160674,4160674,0
2108,Freddie Woodman,54,3757000,7628049984702232,486,6348520,3810231,3810231,0
2109,Joe Worrall,44,4671000,7450883791645887,541,8154381,2992569,0,2992569
2110,Haji Wright,63,2445900,3350989016108346,440,4988935,3017059,0,3017059
2111,Rıdvan Yılmaz,60,3010400,4129230918885876,482,6082092,4590067,0,4590067
2112,Yoon Bit Garam,49,2894900,9394617713460697,386,4768756,3948315,394832,3553483
2113,Zaydou Youssouf,42,3918100,6247091379672392,445,6307760,4426745,0,4426745
2114,Kristoffer Zachariassen,60,4667100,3240369816515436,633,8920568,6502536,0,6502536
2115,Dan-Axel Zagadou,22,3405600,4117769926342937,300,5216901,365926,0,365926
2116,Warren Zaïre-Emery,35,608900,3713464075854661,111,1087310,378694,379,378315
2117,Rodrigo Zalazar,65,4264500,3770848662347426,524,7465575,4436025,443603,3992422
2118,Zaldúa,46,4712800,8888590368437572,485,7059192,1511112,151112,1360000
2119,Carlos Zambrano,40,1140700,7066161503871102,182,1947631,823643,8237,815406
2120,Anass Zaroury,30,4665600,7152243706241800,399,7086079,7029420,70295,6959125
2121,Akim Zedadka,49,4118000,6494457399233881,502,6969237,5313708,5314,5308394
2122,Jaroslav Zelený,42,4391600,8401995542488143,428,6624904,3194690,320,3194370
2123,Cédric Zesiger,63,509800,7630837492751240,299,2409077,1802950,1802950,0
2124,Ron-Robert Zieler,32,4610800,5235704886182287,403,7153103,439926,440,439486
2125,Lawrence Ati Zigi,54,2181900,8796153769265016,412,4901798,1580199,158020,1422179
2126,Philip Zinckernagel,29,716000,3580343109503499,83,874765,138945,138945,0
2127,Robert Žulj,60,530200,8739067343689855,294,2340600,1379778,137978,1241800
2128,Fernando Zuqui,47,1398200,3460819999682805,214,2389209,2282492,22825,2259667
2129,Szymon Żurkowski,25,2066000,8411714494967574,160,2888170,2048706,204871,1843835
2130,Max Aarons,32,3130400,5005784565051642,343,5019829,4407680,441,4407239
2131,Mehdi Abeid,67,3926900,5803591725539439,604,7795063,2246585,22466,2224119
2132,Frank Acheampong,26,2677500,5159607496618512,235,3598897,1472566,148,1472418
2133,Arijan Ademi,47,3214500,7866194935042611,429,5601851,2512988,252,2512736
2134,Simon Adingra,32,4364100,3504080601709883,432,6835626,5095746,510,5095236
2135,Yacine Adli,33,4220300,8959178864572401,410,6704207,881521,88153,793368
2136,Agirrezabala,70,2556100,7526149241924513,520,6106240,4331902,4332,4327570
2137,Jean-Eudes Aholou,66,2461600,9769337960028526,482,5616016,4974947,498,4974449
2138,Ola Aina,61,2289900,9910071177278198,448,5142382,1198562,119857,1078705
2139,Aketxe,38,2553800,5486845987828599,277,3933264,856931,0,856931
2140,Carlos Alcaraz,49,1905400,6036388202852016,297,3648953,1507797,0,1507797
2141,Ezgjan Alioski,34,925900,7586145247754805,134,1446190,1003697,10037,993660
2142,Nani,66,1422400,9245226538047878,338,3671536,1802625,18027,1784598
2143,Cédric,64,3160200,9205844452521627,490,6757068,4297498,0,4297498
2144,Jair Amador,27,4026000,6868466729398860,355,5916164,714345,714345,0
2145,Kelvin Amian,41,2632100,5174030537923377,344,4755308,1886765,1886765,0
2146,Mariano Andújar,39,2187800,6837434628937152,250,3297988,1937725,194,1937531
2147,Jaidon Anthony,49,1664400,9150993217714496,320,3701113,3539673,353968,3185705
2148,Domagoj Antolić,58,4041600,4891281307621390,535,7674651,6621951,0,6621951
2149,Christopher Antwi-Adjei,47,3819900,3906552469760106,473,6797808,379465,0,379465
2150,Dennis Appiah,41,2245800,7136979436580894,293,3894308,645715,645715,0
2151,Arbilla,66,3968000,8375510833628550,561,7945375,5972079,59721,5912358
2152,Cameron Archer,38,2512800,8470989683761214,292,4234371,3468382,34684,3433698
2153,Joe Aribo,22,2393800,5500280812021372,218,3198552,2089267,208927,1880340
2154,Stuart Armstrong,52,2452500,7636800813219080,386,4882685,3858971,3858971,0
2155,Gerardo Arteaga,40,3252600,5856371430804043,398,6025671,5358402,535841,4822561
2156,Youcef Atal,70,4455800,6645448498450508,688,8957675,6185269,61853,6123416
2157,Omer Atzili,34,3475800,8510207512180458,355,5782496,3918303,0,3918303
2158,Tommaso Augello,29,1839100,3228821662959915,190,2693532,411785,412,411373
2159,Luke Ayling,48,3045700,3066148741522003,377,5538550,2324869,0,2324869
2160,Serdar Aziz,55,3815500,5779726537087228,489,6816037,2640089,26401,2613688
2161,Talles Magno,27,3307100,4834630462773678,317,5411355,4747217,4748,4742469
2162,Michel Ange Balikwisha,55,1126300,5249111426052832,285,3064567,1013682,1014,1012668
2163,Filippo Bandinelli,65,3872500,7817822121734029,544,6899553,6421719,643,6421076
2164,David Barbona,37,386100,5125225387747639,120,882774,699114,700,698414
2165,Borna Barišić,52,1863500,5139963644421341,296,3501165,3416694,342,3416352
2166,Pablo Barrios,25,4619700,9856384290830064,368,6255121,4976693,497670,4479023
2167,Chris Basham,40,4446900,7883939072462596,502,7601669,2875701,2876,2872825
2168,Maximilian Bauer,49,4428000,8423081213409118,516,7810369,6613549,662,6612887
2169,Timo Baumgartl,64,4449000,4065044964712980,599,8233768,965241,0,965241
2170,Vid Belec,68,314700,7092651189302310,302,2244767,1286656,128666,1157990
2171,Raoul Bellanova,63,1918800,3192886796003218,365,4368925,2931246,2932,2928314
2172,Gastón Benavídez,50,4340000,9059053951717424,537,7707101,3901037,3902,3897135
2173,Daniel Bentley,62,2282500,8808829730787151,386,4404801,969390,969390,0
2174,Paul Bernardoni,41,3672100,9838990507722008,372,6152216,4098468,4098468,0
2175,Dimitry Bertaud,41,2079700,5426904508434078,263,3703424,2072678,207268,1865410
2176,Andrea Bertolacci,34,4212600,9749898112355942,375,6037899,804826,804826,0
2177,Bruno Bianchi,23,2740000,8255318560850394,249,3797011,1491924,14920,1477004
2178,Mads Bidstrup,41,4132100,5373477071693179,432,7183412,46352,46352,0
2179,Bigas,62,1822600,6222685270574419,434,4865689,2157022,216,2156806
2180,Leonardo Bittencourt,30,430600,3875866016493304,73,629876,435040,4351,430689
2181,Sebastián Blanco,62,2090400,4545515362628885,404,4699326,4231032,4231032,0
2182,Antonio Blanco,56,869000,5929543474683363,304,2768682,1275108,127511,1147597
2183,Myron Boadu,42,3149700,8739467876692266,375,5347010,4584908,45850,4539058
2184,Jayden Bogle,48,4121200,3964110814090516,527,7637226,2432783,2433,2430350
2185,Mauro Boselli,58,2233600,6658544985563236,394,5048302,3451672,0,3451672
2186,Eric Botteghin,52,2350300,8895364468514476,369,4836729,508343,509,507834
2187,Mohamed Bouldini,46,4746700,6368375907677771,483,6899307,3465407,0,3465407
2188,Umut Bozok,36,2512800,6956890433050169,245,3886787,1661796,16618,1645178
2189,Yanick Brecher,37,908200,8710685265174001,184,1767544,1252074,0,1252074
2190,Gaston Brugman,68,2403800,3802244315028199,460,5725942,4301217,431,4300786
2191,Cédric Brunner,30,1994500,4155716629336298,218,3032932,2157391,0,2157391
2192,Matteo Brunori,48,3350300,5278730672747749,421,5818631,444051,0,444051
2193,Marcin Bułka,25,3038900,7091265447381362,231,3749626,2968072,0,2968072
2194,Guido Burgstaller,44,4907000,8372746603223434,520,7528837,6097693,0,6097693
2195,Nahuel Bustos,44,1787100,5927603132987422,314,3566726,3484255,0,3484255
2196,Jimmy Cabot,45,2955300,3966738247413760,370,5395586,1139773,0,1139773
2197,Javier Cabrera,67,1607800,5636534629692611,357,3966328,1428736,142874,1285862
2198,Juan José Cáceres,26,709200,4116125028753624,76,859860,560447,561,559886
2199,Mathieu Cafaro,60,2967100,8842630659802642,413,5608913,4685654,0,4685654
2200,Jens-Lys Cajuste,39,708200,5066434349378785,149,1533955,974716,97472,877244
2201,Néstor Camacho,34,3123700,4295691801128486,347,4931758,2568367,0,2568367
2202,Mohamed Ali Camara,29,2239000,7072835933013241,205,3327959,1021263,1022,1020241
2203,Jorman Campuzano,33,3381700,4054994924517589,317,4936770,4099347,0,4099347
2204,Matteo Cancellieri,66,4659900,5804315982192749,610,8425020,6472412,6472412,0
2205,Mateo Carabajal,44,2703200,8728002353038472,312,4561013,1447681,14477,1433204
2206,Johan Carbonero,50,2544400,9531467960957537,428,5074105,2032618,204,2032414
2207,Carlos Mané,24,4914000,5811401581470930,422,7696076,1448977,14490,1434487
2208,Jorge Carranza,69,1744500,6843749929548279,429,4745319,2415791,2416,2413375
2209,Jean-Charles Castelletto,54,4558800,3845087533534174,529,8137758,129821,130,129691
2210,Castro,30,3558300,9681537861186502,330,5371212,3993854,3993854,0
2211,Alessio Castro-Montes,54,1515500,9940710532391338,322,3558108,2155874,2156,2153718
2212,Daniel Cataño,58,546100,3062962907897934,255,2267096,42424,4243,38181
2213,Martín Cauteruccio,51,1938000,4788262321549528,335,3901975,737734,73774,663960
2214,Álex Centelles,46,1612700,4415502532436378,293,3312815,50851,5086,45765
2215,Fabien Centonze,60,1337200,8272934996086888,306,3210517,1229033,1230,1227803
2216,Nacer Chadli,37,3553100,6505077179189382,404,5867242,3765568,377,3765191
2217,Farouk Chafaï,42,4228200,3212265995353074,508,7145605,4717576,4718,4712858
2218,Farès Chaïbi,62,4852100,9500809550468809,606,7998990,1226067,0,1226067
2219,Ilias Chair,48,3594500,8234196690894326,456,6017472,5620759,563,5620196
2220,Brendan Chardonnet,69,1775400,6761470162399857,432,4626833,3220648,3221,3217427
2221,Denis Cheryshev,33,4833700,3369254520391403,442,7789851,1345228,13453,1331775
2222,Tomáš Chorý,50,548400,3286553246684080,214,1980609,1337652,0,1337652
2223,Oliver Christensen,41,900500,8478806474330459,168,1735911,954682,0,954682
2224,Tolga Ciğerci,47,1195700,8636669767776071,259,2657708,199572,19958,179614
2225,Jack Clarke,40,592200,3898813294719024,155,1511073,239496,0,239496
2226,Clerc,48,330100,7617657869607967,187,1519745,868917,0,868917
2227,Nazareno Colombo,55,4309200,3138347748703007,549,7554745,219167,0,219167
2228,Enzo Copetti,62,3152300,6467187723307341,514,6393872,4415761,0,4415761
2229,Jack Cork,41,2085500,4610422651015670,282,3557740,544670,0,544670
2230,Andreas Cornelius,70,3923700,9572984057190692,553,7665466,253559,0,253559
2231,Corpas,34,2269000,5873559029180121,246,3572508,2919410,291941,2627469
2232,Benoît Costil,34,305400,9503160249787947,97,661009,161294,16130,145164
2233,Maxime Crépeau,34,1566300,5819872156822542,183,2468185,1053107,105311,947796
2234,Pejiño,47,809200,6641391459665835,199,1933650,743952,7440,736512
2235,Diogo Gonçalves,59,1950100,6705355755341193,449,5182221,1880584,0,1880584
2236,João Victor,54,4030000,3186262452670102,470,6888744,4977630,0,4977630
2237,Oday Dabbagh,59,1710300,6819205539236007,357,4106490,556288,557,555731
2238,Colin Dagba,25,567300,6695342172176700,49,542269,197575,19758,177817
2239,Finn Dahmen,52,4354400,7374789132408001,490,7394001,1754513,1755,1752758
2240,Stuart Dallas,65,2813100,5943743170570633,452,5660485,1978806,19789,1959017
2241,Flavius Daniliuc,66,509700,5882181060520661,311,2451788,1660664,166067,1494597
2242,Josh Dasilva,68,3576100,8358188681142377,520,6853087,3262877,32629,3230248
2243,Ben Davies,23,1963600,6117955293741444,167,2696207,167638,0,167638
2244,Paweł Dawidowicz,35,3356700,3395830556681233,336,4889358,4311136,43112,4268024
2245,Maxim De Cuyper,56,1204500,4909095561570967,328,3571308,3276655,328,3276327
2246,Aderllan Santos,48,4489400,3250275047464258,533,8056311,6513630,0,6513630
2247,Luca de la Torre,57,1742300,6654767840230611,370,3836339,2957193,2957193,0
2248,Gregore,64,1710300,5354725331547618,395,4223717,1528172,15282,1512890
2249,Cláudio Ramos,22,4611400,8418322249095179,367,6198489,384753,38476,346277
2250,Lorenzo De Silvestri,57,4312600,4391882859181851,620,8266082,6832335,0,6832335
2251,Felipe Silva,34,3569600,6941123282296401,416,5913231,745627,0,745627
2252,Alexsandro Ribeiro,47,409700,3594655337099858,176,1320111,910869,0,910869
2253,Amar Dedić,42,3128300,9155904154612417,349,5382032,1835434,183544,1651890
2254,Grégoire Defrel,56,451900,7952961367922712,203,1646256,1002855,101,1002754
2255,Romain Del Castillo,24,975700,8915589733772739,96,1349228,991261,99127,892134
2256,Rafael Delgado,68,1917100,5412815697523385,461,5346992,3513488,3513488,0
2257,Stefano Denswil,30,1246000,3457375637909952,142,1971306,11848,0,11848
2258,Andrés Desábato,53,1040300,3628985028513025,287,2767334,832219,833,831386
2259,Mikkel Desler,43,1318800,8828878311535344,216,2301949,588921,588921,0
2260,Marcelo Díaz,25,3297500,4356862288342671,284,4872273,3422319,0,3422319
2261,Lautaro Díaz,64,4237200,9999680131894412,611,7769743,2040774,205,2040569
2262,Bamba Dieng,52,4689300,7154832245244368,536,7977522,1976227,0,1976227
2263,Javairô Dilrosun,50,1374800,4358488952386947,290,3043674,1092682,110,1092572
2264,Moussa Djenepo,27,4769900,3948260313879145,380,6528448,204827,204827,0
2265,Koffi Djidji,69,2304200,4053013202082922,491,5515491,1464403,1464403,0
2266,Lucas Piazón,41,360100,3165683851814319,124,900977,456891,457,456434
2267,Alexander Domínguez,68,388400,8734395469150707,306,2351866,1148831,0,1148831
2268,Jean-Luc Dompé,62,2201100,5289518157434081,422,4878924,1414820,141482,1273338
2269,Fernando,43,2877900,3970266332529377,365,4638435,499264,49927,449337
2270,David Douděra,29,1322500,4984347750037966,160,2139719,413688,0,413688
2271,Patrick Drewes,66,2394200,9906447592178112,462,5258715,2031742,0,2031742
2272,Joël Drommel,64,3576200,5123877554745933,512,6874419,2987166,299,2986867
2273,Shane Duffy,24,538600,5992862734756179,34,392492,334560,334560,0
2274,Paul Dummett,31,4770700,6854578379845396,420,7353308,4742639,0,4742639
2275,Filip Đuričić,58,567400,8521819089266961,300,2480401,1212933,12130,1200803
2276,Serdar Dursun,62,3112600,8080367292916396,486,6203497,283178,0,283178
2277,Carel Eiting,31,303300,9118815284741714,65,460870,62376,0,62376
2278,Albin Ekdal,42,3390400,4051334755928382,360,4999631,1252981,1252981,0
2279,Hjalmar Ekdal,70,430600,4071875321278618,276,2204721,1778686,1779,1776907
2280,Jurgen Ekkelenkamp,69,3708100,5851967119158371,651,7870802,1232735,1232735,0
2281,Omar Elabdellaoui,58,2583400,4852067415112772,400,4968382,1951102,195111,1755991
2282,Anthony Elanga,44,749400,8998119647290534,180,1823680,1728501,0,1728501
2283,Meschack Elia,27,2787300,3581906175768673,241,3940421,1282194,129,1282065
2284,Niclas Eliasson,31,1087300,3862652700776150,126,1625107,59011,0,59011
2285,Jack Elliott,64,3991500,7378118647776302,562,7288984,4214626,422,4214204
2286,Mohamed Elyounoussi,62,3876000,6915928732395711,570,7914470,4640346,4641,4635705
2287,Björn Engels,65,4119300,5962597328518222,541,7254739,2425813,2426,2423387
2288,Bernardo Espinosa,39,2008100,8630624195889102,302,3803732,2682241,269,2681972
2289,Håkon Evjen,40,2607800,3831693742780625,292,4167146,3279438,0,3279438
2290,Abdessamad Ezzalzouli,69,1472200,6610316696270411,361,3521635,145764,146,145618
2291,Marouane Fellaini,36,4732700,7578962230695602,452,7753281,7086753,0,7086753
2292,Evan Ferguson,68,2178700,3372838882057819,441,4973787,2027197,20272,2006925
2293,Edimilson Fernandes,45,1523800,8121689000481641,253,3005950,1201397,0,1201397
2294,Ezequiel Fernández,37,1655900,4969130665965651,230,3063129,1728891,17289,1711602
2295,Valery,46,3809900,5356502839002412,389,6052668,764642,76465,688177
2296,Carlos Fernández,44,2062000,8906904758558744,349,4416943,1210445,1210445,0
2297,Frederico Venâncio,38,4350300,9272669721383154,397,6810304,5514199,552,5513647
2298,Miguel Maga,66,506500,6484561725897685,286,2207696,2155619,2155619,0
2299,Philipp Förster,70,3410800,3011121744144305,571,6925164,6366665,0,6366665
2300,Francés,70,3002700,3660788386491582,538,6112075,1411349,0,1411349
2301,Ryan Fraser,36,2875600,8193644824612439,348,4552521,3794299,380,3793919
2302,Ryan Fredericks,68,3644500,5563916949715415,559,7453590,1633734,164,1633570
2303,Dael Fry,42,2692100,9553872400967898,315,4387299,1515669,1515669,0
2304,Chris Führich,35,1676800,4578570735679279,227,2846182,99370,994,98376
2305,Francisco Fydriszewski,39,3118700,4014745116175577,395,5755010,3001055,0,3001055
2306,Matteo Gabbia,67,2214500,5796202864046769,433,4867328,4545694,454570,4091124
2307,Fernando Gaibor,34,1047300,3209574227778703,145,1737581,137357,13736,123621
2308,Enric Gallego,22,1511600,5845555727661622,121,1850543,1617767,162,1617605
2309,Pedro Gallese,42,2472900,8173194828994076,324,4478253,2279687,0,2279687
2310,Gauthier Gallon,50,1536800,9952465636699823,306,3456776,2457985,0,2457985
2311,Ignatius Ganago,59,4365900,5406292544732322,604,7916629,3201116,0,3201116
2312,Facundo Garcés,24,1327000,3166862204702655,128,1772393,1146118,114612,1031506
2313,Javier García,37,4723500,3834314204409918,456,7498601,1947070,1948,1945122
2314,Ali Gholizadeh,22,3657200,7457131466263634,322,5314941,4444173,444418,3999755
2315,Jakob Glesnes,69,2481500,7894937906222903,514,5996164,3932679,0,3932679
2316,Saviour Godwin,55,366800,5315624571065880,230,1719362,895051,895051,0
2317,Elías Gómez,33,1346700,3727213232803528,172,2040082,779568,77957,701611
2318,Jonatan Gómez,58,4687800,9012391640814567,584,8688686,4520413,0,4520413
2319,Fábio Abreu,37,2356600,9289556894737683,275,3481471,3459369,3460,3455909
2320,Zeca,24,1180700,4147717604039493,83,1349850,17621,1763,15858
2321,Francisco González Metilli,67,2152000,3953277826658603,419,4819294,259191,259191,0
2322,Lucas Gourna,30,574500,4388154731941971,111,1036324,804200,8042,796158
2323,Alex Grant,49,4427500,8718174595477687,533,7168610,1280951,1281,1279670
2324,Julian Gressel,60,2669000,7155972151521637,468,5479369,1772531,0,1772531
2325,Matt Grimes,67,4988300,5800240058883802,695,8821657,1326635,133,1326502
2326,Kamil Grosicki,56,2971400,9736231035892760,432,5810656,4575149,0,4575149
2327,Carlos Gruezo,39,1991400,4387855684230084,229,3037263,777221,778,776443
2328,Gabriel Gudmundsson,45,568900,9327110934205119,171,1550884,335747,0,335747
2329,Jóhann Berg Guðmundsson,28,2032500,8841691367374892,229,3269527,627793,6278,621515
2330,Paolo Guerrero,36,1674200,4673371852543081,238,2876280,2647513,264752,2382761
2331,Manuel Gulde,64,2566900,7034302523331981,519,6236422,1683007,0,1683007
2332,Gumbau,56,3515400,5442470944721688,490,6912928,3939202,3939202,0
2333,Samuel Gustafson,24,4061700,6637056328225565,361,5849401,2520777,2520777,0
2334,Ianis Hagi,47,1880900,3150401027148196,306,3451995,3056321,3056321,0
2335,Haris Hajradinović,29,1181000,7690590394738157,126,1757385,1026331,10264,1016067
2336,Sead Hakšabanović,47,3657500,3860205221526916,464,6447840,4729992,473,4729519
2337,Grant Hanley,27,2381900,9014952795206499,235,3397622,55051,55051,0
2338,Ridgeciano Haps,48,1601400,8726985546597833,277,3488899,1849557,185,1849372
2339,Makoto Hasebe,34,4838600,8197749977526608,432,6968831,935025,935025,0
2340,Gabriel Hauche,57,1594000,7487278307084992,328,3642985,2155588,0,2155588
2341,Rhys Healey,25,2334600,5071487351735421,208,3405589,1108839,111,1108728
2342,Silvan Hefti,56,3001500,9389830469092558,415,5331410,95115,9512,85603
2343,Jack Hendry,45,3337300,6043506130688000,370,5440050,2334077,23341,2310736
2344,Wayne Hennessey,34,3858500,5455346513035827,319,5366277,1704916,1705,1703211
2345,Christophe Hérelle,39,2053300,9872991882796343,245,3247373,1805683,0,1805683
2346,Junior Hernández,23,1925700,6276352689798374,197,2734911,2404282,240429,2163853
2347,Mees Hilgers,30,475800,5085946069754060,89,755396,362241,363,361878
2348,Casper Højer,63,3660400,3410570836237230,469,6453794,2784204,27843,2756361
2349,Fabian Holland,39,4364000,6350717858119536,456,6756912,1034628,1035,1033593
2350,Hong Hyeon Seok,33,595700,8996217543148727,101,1004049,634672,0,634672
2351,Osmar,39,903800,6735152643600323,160,1795640,1054224,1055,1053169
2352,Andrés Ibargüen,42,2448000,9176844189833688,263,4012075,3015908,3016,3012892
2353,Roberto Insigne,52,2489200,3038926820221412,373,4865142,174780,0,174780
2354,Mikael Ishak,53,2687800,3379545017273199,405,5132495,1684596,1684596,0
2355,Cedric Itten,35,4806100,6643882734022987,460,7363592,4988827,498883,4489944
2356,Alireza Jahanbakhsh,49,1438400,6749689258811508,314,3292285,3123769,312377,2811392
2357,Ismail Jakobs,55,3468300,7511900061572222,479,6183406,496507,4966,491541
2358,Jakub Jankto,39,3455000,7262159800016751,355,5761799,423803,42381,381422
2359,Tin Jedvaj,62,4927500,8062657228186227,594,9099465,6066048,6066048,0
2360,Václav Jemelka,51,3809300,4856246037416926,453,6608249,1043454,1044,1042410
2361,Isaiah Jones,32,3987100,8796762820566536,358,6009091,270534,27054,243480
2362,João Pedro,64,4799900,6097480259222174,707,9607891,2192441,0,2192441
2363,David Jurásek,57,3983700,4083720597627421,472,6963058,6164250,6164250,0
2364,Issa Kaboré,66,4748300,5154502420553150,644,8955024,4602742,460275,4142467
2365,Tino Kadewere,53,2714500,8435738927153724,411,5272060,820876,0,820876
2366,Gédéon Kalulu,63,1420400,7848779271855131,327,3631759,3578697,0,3578697
2367,Glen Kamara,43,1972900,3957035641307854,305,3825604,1663637,1663637,0
2368,Thomas Kaminski,31,2724300,3446863089672144,249,4114813,2863280,28633,2834647
2369,Ercan Kara,58,4673900,7646185628773677,616,8277690,6204261,62043,6142218
2370,Yann Karamoh,60,3647500,5245251372817140,559,7025309,4998031,4998031,0
2371,Oleksandr Karavaev,54,4648800,4286056392897041,558,7985755,2993337,2993337,0
2372,Atakan Karazor,29,4925800,7221455015291923,389,7197908,2581288,259,2581029
2373,Michał Karbownik,60,2709500,3806693353691171,411,4880812,2416716,0,2416716
2374,Jesper Karlström,55,4576500,7410275847974307,587,8394280,4266222,427,4265795
2375,Tomasz Kędziora,33,2670000,9191468914941987,266,3785473,2987062,0,2987062
2376,Caoimhin Kelleher,37,1049700,9799337674321743,177,1966137,1419767,1419767,0
2377,Lloyd Kelly,30,4771200,5036365100859317,418,7218692,4862003,48621,4813382
2378,Gyrano Kerk,58,4006100,6301658829978029,589,7474306,5985371,598538,5386833
2379,Ki Sung Yueng,26,777600,4897004047664013,92,1124622,105557,10556,95001
2380,Kim Young Gwon,38,479500,6796510768241999,107,984125,775248,0,775248
2381,Maurits Kjaergaard,25,2732000,7619300306866886,251,4110193,1934064,1935,1932129
2382,Hervé Koffi,53,4909700,6100063064427981,530,8209659,3324816,0,3324816
2383,Dominik Kotarski,68,2635100,6125238921025753,498,6116499,3868305,0,3868305
2384,Jean Evrard Kouassi,52,3341900,4419153411097372,472,6797524,835445,836,834609
2385,Boubakar Kouyaté,37,710500,9774492239981842,123,1160428,479325,0,479325
2386,Dawid Kownacki,52,343800,3773835205738851,231,1795435,577134,57714,519420
2387,Emil Krafth,69,3079000,3867337490402429,467,5793511,5038173,5038173,0
2388,Damir Kreilach,60,1261500,6379945485269638,303,3414400,1497454,0,1497454
2389,Filip Krovinović,36,2372900,7731211617629079,299,4133440,3196184,319619,2876565
2390,Tim Krul,45,334300,6734593033486247,173,1356253,347862,347862,0
2391,Sven Kums,40,1264200,3783357343283888,198,2475890,400810,40081,360729
2392,Layvin Kurzawa,48,1452100,8199648945073659,269,3057778,2009829,2009829,0
2393,Giorgi Kvilitaia,61,1437200,3990048026011250,370,4110130,3595322,359533,3235789
2394,Giorgos Kyriakopoulos,52,3594700,3360328262259477,446,6230504,803990,0,803990
2395,Qazim Laçi,65,2079900,6456114636571070,480,5169450,1236649,124,1236525
2396,Loïc Lapoussin,33,3852300,4512231409526211,361,5834088,3511338,0,3511338
2397,Jacob Bruun Larsen,61,2099700,7820922712299976,437,5135371,2884077,289,2883788
2398,Jørgen Strand Larsen,24,989400,5733620987591322,112,1487975,952666,9527,943139
2399,Gautier Larsonneur,38,3161400,7727871390183749,337,5221361,1437186,143719,1293467
2400,Toni Lato,60,4703600,7439728680408948,622,9038519,95095,95095,0
2401,Romeo Lavia,43,4306400,8083279815815284,543,7474834,1493773,0,1493773
2402,Tom Lawrence,64,2912000,6398791723469439,482,5711231,966237,0,966237
2403,Lazo,40,3585400,3673989275899033,400,5668596,4734937,4735,4730202
2404,Jérémy Le Douaron,46,4195100,7987593373863749,456,6521608,4303033,0,4303033
2405,Darragh Lenihan,67,4759600,5075535962147673,668,9096054,2313932,2313932,0
2406,Christopher Lenz,29,3847800,8083205320793137,397,5756929,3619600,0,3619600
2407,Sergio León,47,2914600,8469422990988100,386,5270560,2903737,0,2903737
2408,Johann Lepenant,58,3535600,7111620016446494,518,6817184,16532,16532,0
2409,Lukas Lerager,64,3182400,4210221967059312,488,6203280,4929538,0,4929538
2410,Rico Lewis,60,492900,9722833485728941,253,2126972,203142,20315,182827
2411,Andrés Llinás,43,1084100,8577547607005840,187,1974474,797086,0,797086
2412,Raúl Loaiza,40,3779200,9251980830145811,428,6105142,4970552,4971,4965581
2413,Robin Lod,37,3495200,7006829084190821,387,5570876,1190705,11908,1178797
2414,Luciano Lollo,47,1321700,8921379684800948,230,2549978,2460102,0,2460102
2415,Duk,48,3735900,8341879835717075,477,6812159,226571,226571,0
2416,Leonardo,49,1308500,7395720610822715,251,2718298,1946979,194698,1752281
2417,Pedro Pereira,38,843000,4767923989456754,145,1551993,552671,0,552671
2418,Hernán López Muñoz,59,2256000,9211762965916410,392,4848441,851265,0,851265
2419,Dion Lopy,37,1509300,7617238146239937,218,2776118,216653,0,216653
2420,Nahuel Losada,59,2861500,9225892509910936,475,5640116,4233681,42337,4191344
2421,Imrân Louza,56,2192500,3622476254241203,363,4399405,1896471,18965,1877506
2422,Anthony Lozano,48,3287000,6642648286047580,438,6102593,5759424,5759424,0
2423,Pol Lozano,25,3091100,3964101907044400,286,4735121,4715733,47158,4668575
2424,Fabio Lucioni,37,2334300,3160806862865158,277,4175183,3845890,0,3845890
2425,John Lundstram,63,855600,7378326141586082,304,2803692,326963,3270,323693
2426,Senne Lynen,30,1661100,6221536354499869,170,2403393,1543813,0,1543813
2427,Jamie Maclaren,40,2474100,7930243012552166,291,3982977,1995052,200,1994852
2428,Giangiacomo Magnani,67,4862000,3823644779586724,627,9007014,1011417,101142,910275
2429,Hugo Magnetti,50,4097800,7252864862949529,488,7393867,220101,22011,198090
2430,Yohann Magnin,58,1627600,4778062970007397,342,3779686,3590134,0,3590134
2431,Josh Maja,51,4509600,3368921857515859,591,7681323,2744288,27443,2716845
2432,Jean-Victor Makengo,60,4341000,8650984051631404,618,8319049,6920991,6921,6914070
2433,Wilson Manafá,54,1482600,8562044659366236,321,3721747,751556,752,750804
2434,Marco Mancosu,53,2541200,8010444910266995,400,5008929,3373939,0,3373939
2435,Vasco Fernandes,36,1192100,6474144032922842,151,2044947,1777938,1777938,0
2436,Faitout Maouassa,41,3956000,7311977631629001,412,5974395,2987556,29876,2957680
2437,Lazar Marković,67,2219900,4451054196677840,469,5395470,1917565,0,1917565
2438,Roger Martí,24,3728100,9201158498734463,324,5474238,5134378,514,5133864
2439,Juan Carlos,65,4967400,7731465792774636,611,8768217,414995,415,414580
2440,Gonzalo Martínez,27,1778000,7476099900908874,173,2490076,931202,93121,838081
2441,Emiliano Martínez,56,4010900,9078329795844950,522,7158909,3944080,394408,3549672
2442,Roger Martínez,48,557800,4106313597144274,181,1647189,305706,305706,0
2443,Adrián Martínez,56,1859400,4181057048472622,365,3935528,247542,0,247542
2444,Erhan Mašović,35,3630300,9329937247974242,351,5982581,3707033,3707033,0
2445,Mata,34,715400,4533129423338852,143,1324231,1301389,1301389,0
2446,Eliot Matazo,40,3400900,4333673340772568,384,5625111,669546,66955,602591
2447,Luca Mazzitelli,56,3440100,5190780091459411,528,6824292,653924,654,653270
2448,Pasquale Mazzocchi,46,2913400,7836684142023475,373,5369562,5009404,0,5009404
2449,Scott McKenna,42,4790700,7803973146310399,509,7991890,5581796,558180,5023616
2450,Marvin Mehlem,56,2888500,9281699813047646,473,5655382,4908249,4909,4903340
2451,Björn Meijer,65,2121800,7679896038251283,398,4758455,676054,677,675377
2452,Soualiho Meïté,52,3408200,4975048689443324,486,6454529,4475706,447571,4028135
2453,Gonçalo Paciência,63,675600,3770903635716973,274,2548018,986133,986133,0
2454,Benjamin Mendy,68,793900,9425735913590917,325,2781583,2578791,2578791,0
2455,Lucas Menossi,38,3353000,3607603633427374,387,5583292,52183,0,52183
2456,Quentin Merlin,60,1802700,4828261795673537,366,3929092,1731089,0,1731089
2457,Matt Miazga,27,615900,8709926109675475,77,776138,48519,486,48033
2458,Milad Mohammadi,58,308500,4968837432388501,261,1911923,674859,675,674184
2459,Aaron Molinas,58,4463600,6073565483821159,593,8130513,2269882,0,2269882
2460,Florent Mollet,25,4529700,6605693333248921,331,6435985,975088,9751,965337
2461,Jamiro Monteiro,66,3720300,9092256125951296,542,7265946,6414713,6414713,0
2462,Kieffer Moore,36,2118400,8106876528530163,234,3470450,174081,175,173906
2463,Anthony Moris,63,1455400,6631463480777578,337,3523056,1894096,18941,1875155
2464,Manu Morlanes,45,528700,4607478348348561,178,1597763,144232,0,144232
2465,Andrés Mosquera,41,763700,3508003821432443,182,1765568,1705893,1706,1704187
2466,Jhon Mosquera,69,4090300,3919928044727469,673,8516276,3339216,0,3339216
2467,Fahd Moufi,63,4359400,7105321707861796,584,7641828,891221,892,890329
2468,Samuel Moutoussamy,60,2027400,3930172953635699,352,4334210,2247397,22474,2224923
2469,Franco Moyano,37,2995000,3691949080899275,373,5596805,2705240,0,2705240
2470,Marius Müller,34,2053000,6544190319640259,234,3231465,2522145,2522145,0
2471,Kevin Müller,63,2497200,3193055836010727,408,5033138,2170143,0,2170143
2472,Paul Nardi,68,4594100,7363855481928851,581,8250993,7665023,76651,7588372
2473,Amath Ndiaye,43,1926900,5796532467442021,298,3858713,19514,1952,17562
2474,Luca Netz,36,1964700,4900788261122108,233,3107819,1630111,16302,1613809
2475,Cyril Ngonge,26,1515800,6208364416019537,151,2179755,437696,43770,393926
2476,Tanguy Nianzou,25,1510900,6101834240548488,147,2156653,744833,744833,0
2477,Bart Nieuwkoop,59,2177500,3313080575781376,389,4879926,857160,857160,0
2478,Fabián Noguera,34,3341800,7189309208548696,338,5098784,2806091,2807,2803284
2479,Rúben Vezo,34,1294900,9884400177006636,178,2351576,2281858,2282,2279576
2480,Allan-Roméo Nyom,36,4098000,9194481286405443,399,6576079,5664083,0,5664083
2481,Jens Odgaard,67,2461500,9859705310794505,447,5274488,3467267,347,3466920
2482,David Okereke,69,1249600,9171935713945381,441,4267071,2013943,2013943,0
2483,Joseph Okumu,50,1258100,6862686626512452,241,2442831,1282246,12823,1269423
2484,Rogério,66,1994200,9910430885268402,474,5283060,3062878,307,3062571
2485,André Silva,57,3677400,8130758746149191,515,7370367,2160105,2160105,0
2486,Gastón Olveira,39,423100,8449156067935863,165,1275467,702538,0,702538
2487,Ohi Omoijuanfo,39,3219200,4308687041195520,359,5395191,134071,135,133936
2488,Abdülkadir Ömür,24,3477300,6995522913855999,327,5121311,2181815,0,2181815
2489,Paul Ebere Onuachu,26,1046500,8734195295978249,123,1482658,768976,0,768976
2490,Raphael Onyedika,61,1046800,5046087995842644,329,3202133,2898886,0,2898886
2491,Frank Onyeka,52,3354300,3925802448536346,447,6080316,5800610,5800610,0
2492,Aimar Oroz,64,2124800,7518933498121383,465,4910922,625635,625635,0
2493,Richard Ortiz,22,1282500,3989800633470406,86,1422947,21459,2146,19313
2494,Pedro Ortíz,51,3195600,3841842677071361,445,5660778,4248353,4248353,0
2495,Jonathan Osorio,26,4318200,6325865321260510,412,6745532,600365,0,600365
2496,Leo Østigård,63,3326900,4536000104621676,556,6850465,2582944,25830,2557114
2497,Juan Ferney Otero,37,3161000,9634445233040077,386,5648810,1672544,16726,1655818
2498,Alexandre Oukidja,62,4212600,7727296257175674,516,7433833,830714,831,829883
2499,Paik Seung Ho,29,3611600,6748372682591489,354,5261667,4906986,49070,4857916
2500,Leart Paqarada,30,1381700,8640362458467270,138,1860035,370208,0,370208
2501,José Paradela,47,1681900,7004505840795721,251,3288607,1313495,1314,1312181
2502,Martín Payero,70,3643900,4799872646112740,634,8113406,5602902,560291,5042611
2503,Sergio Peña,36,3546900,9246448977869492,379,6072361,65238,653,64585
2504,Iñaki Peña,62,4868900,4118870963218830,676,9189592,6855657,685566,6170091
2505,Mauricio Pereyra,48,417100,4089240769333746,181,1334120,524306,52431,471875
2506,Marco Pérez,70,1917000,3875469606429612,397,4461679,1562655,15627,1547028
2507,Rafael Pérez,59,2376400,4963990767196937,414,4794817,2989283,299,2988984
2508,Juankar,48,3426400,6605345152584720,427,6372219,1320094,13201,1306893
2509,Luis Pérez,48,4702200,5936742946771289,559,7898082,1042715,1043,1041672
2510,Kike Pérez,39,4899800,3715921219697278,548,7462201,2714579,0,2714579
2511,Lucas Perrin,31,1770400,7686984598103127,191,2649057,823999,8240,815759
2512,Pavao Pervan,65,2037200,9332557555279493,411,4539531,2056429,2057,2054372
2513,Jakub Pešek,54,2837800,6131637412291808,397,5122107,1148452,114846,1033606
2514,Aleksandar Pešić,37,3781300,6801466125699343,379,5868083,2754434,27545,2726889
2515,Giuseppe Pezzella,53,4769200,3412984696642873,557,7914311,198158,1982,196176
2516,Nathaniel Phillips,63,2901100,4012884373826927,470,5669216,2896187,289619,2606568
2517,Krzysztof Piątek,67,3248600,5085536733742570,502,6160162,162269,163,162106
2518,Kamil Piątkowski,46,1026800,4537405076439600,221,2329119,1001241,1001241,0
2519,Ronaël Pierre-Gabriel,23,1685100,4005163219687772,142,2277962,282963,0,282963
2520,Mirko Pigliacelli,42,4636200,8205547274244295,458,7130016,4608078,461,4607617
2521,Iván Piris,61,3471300,9887955912357004,534,7073022,5365180,53652,5311528
2522,Francisco Pizzini,47,4596000,6355092689988442,492,8194974,4386484,438649,3947835
2523,Óscar Plano,51,2002500,3995625500543202,309,3573286,1180380,1181,1179199
2524,Ezequiel Ponce,56,374000,8600121741543716,229,1928570,1352268,0,1352268
2525,Lukáš Provod,57,4563700,5140626522566356,577,8222155,265966,266,265700
2526,Pulido,33,2385200,5565591278042638,251,3601000,1140389,0,1140389
2527,Cryzan,59,2384800,7418873935096091,352,4493077,3236902,0,3236902
2528,Largie Ramazani,54,1328100,3139972377293675,245,2923115,396399,0,396399
2529,Gastón Ramírez,25,827200,8274972895993127,83,1056683,668072,0,668072
2530,Chris Ramos,65,2390900,7079855148905629,415,5117709,3012075,302,3011773
2531,Bart Ramselaar,69,1304600,3677729090533432,403,4149809,3907395,3907395,0
2532,Jacob Rasmussen,46,4762800,6744819077181869,476,7857118,5234233,5234233,0
2533,Federico Rasmussen,33,4326000,8915791959163492,438,6736768,3664492,3664492,0
2534,Tim Ream,47,2368900,4687889869542828,294,3699624,1141591,11416,1130175
2535,Jeff Reine-Adélaïde,49,3089600,8056886986748207,424,5841136,4025632,4026,4021606
2536,Luiz Júnior,49,3020200,8735136628087249,376,5193496,1122473,1123,1121350
2537,Mihailo Ristić,37,2463000,9357257232909923,266,3915030,2141550,21416,2120134
2538,Hugo Rodallega,22,1050400,8192520524874245,79,1131854,180166,1802,178364
2539,Jay Rodriguez,68,4152900,9821680247428461,616,7901668,1659478,165948,1493530
2540,Patricio Rodríguez,28,1103200,9900949350510384,97,1254691,1145534,114554,1030980
2541,Gabriel Rojas,27,4605800,4598176379322343,360,6610904,3308149,33082,3275067
2542,Felipe Román,51,912600,3394786582955991,251,2619966,270328,27033,243295
2543,Braian Romero,46,2989400,5389941957759662,384,5675469,2505227,2506,2502721
2544,Salomón Rondón,60,2018000,9275897581137067,378,4710509,3491955,0,3491955
2545,Kemar Roofe,54,4978500,8512563536848263,514,8215687,108712,10872,97840
2546,Diego Rubio,30,535500,6552862202046518,103,905201,755109,756,754353
2547,Rúnar Alex Rúnarsson,69,1753200,9554454742051968,432,4397403,2556592,2557,2554035
2548,André Franco,69,3331000,5917426570932058,553,7170884,1201250,121,1201129
2549,Georginio Rutter,59,3319800,6531283447327353,478,6027795,2580346,258035,2322311
2550,Emir Sahiti,51,4878700,4637767910367763,569,8780521,2935483,293549,2641934
2551,Mamadou Sakho,27,547600,8562676681699173,78,699951,641126,0,641126
2552,Manolis Saliakas,55,3077900,5672930025104422,420,6012913,1671214,168,1671046
2553,Ulrik Saltnes,28,1861900,8612395129417241,192,2965524,163681,164,163517
2554,Lazar Samardžić,54,2078400,3968047976633898,379,4518126,3618431,3619,3614812
2555,Carlos Sánchez,32,4800200,4995179150877435,465,7475555,3094114,0,3094114
2556,Iván Sánchez,52,4081000,6534095356487258,546,7593793,4143889,4143889,0
2557,Salvi Sánchez,68,339100,3062626540076906,307,2377486,2291286,22913,2268373
2558,Ron Schallenberg,52,473700,7186369629101152,228,1780860,798570,0,798570
2559,Alexander Schlager,39,2228100,6005787664232789,326,4189224,2133341,0,2133341
2560,Romano Schmid,56,1501400,4142442796560412,342,3645341,1334622,134,1334488
2561,Lasse Schøne,58,3530000,8292571635674118,483,6416985,3176307,318,3175989
2562,Aleksandar Sedlar,38,3784400,7465698818993274,396,6018539,2233492,0,2233492
2563,Ibrahim Šehić,52,2895500,3710236684655920,416,5425888,4421711,0,4421711
2564,Davie Selke,27,3978300,3764303730154212,384,5958126,5558998,0,5558998
2565,Luigi Sepe,45,3359700,6810406137099494,425,6444968,3005822,300583,2705239
2566,Ben Sheaf,29,2310200,7932860094599262,205,3389504,2090368,209037,1881331
2567,Jordan Siebatcheu,61,3621200,3458392443206440,473,6512104,4016752,4017,4012735
2568,Arnór Sigurðsson,61,489700,4266195612001071,277,2300228,109956,0,109956
2569,Jadson,22,2830500,5725509154383054,221,3888740,1740665,1741,1738924
2570,Henrique,44,4316500,6461719026522448,518,7815821,1156862,0,1156862
2571,Marcos Antonio,66,4389500,8487644721070295,612,8290546,5554333,5555,5548778
2572,Santiago Simón,37,3734200,8810530781654796,424,6424226,6034133,6034133,0
2573,Moussa Sissoko,44,2269200,8648820874646530,343,4575230,272378,273,272105
2574,Sivera,53,4332200,5475406396873487,493,6919801,6274633,627464,5647169
2575,Douglas Augusto,69,3746900,7426277323584760,604,7586813,1789826,1790,1788036
2576,Fábio Silva,56,3173000,6745932593049593,419,5692081,1933620,1933620,0
2577,Eduard Sobol,47,1229800,6489222182358657,277,3117566,117443,11745,105698
2578,Yira Sor,61,857800,7445140676484151,269,2507761,1840892,1841,1839051
2579,Adama Soumaoro,69,2325100,9750879729187840,436,5317924,3742772,3743,3739029
2580,Arnaud Souquet,58,4449700,7701670444245197,572,8672022,7652602,0,7652602
2581,Harry Souttar,31,1455900,6765677348862401,163,2106085,753725,7538,746187
2582,John Souttar,53,3941800,3995249710027140,505,6905498,1543551,1543551,0
2583,Andraž Šporar,40,3997100,8967642189873306,416,6534632,4107593,4107593,0
2584,Jack Stacey,61,2223100,8459895403943570,426,5197273,2084876,2084876,0
2585,Calvin Stengs,48,4504800,4355949748216026,566,8233820,140920,141,140779
2586,Angelo Stiller,43,1195000,6121479851590097,230,2702946,568428,56843,511585
2587,Nikola Storm,53,4966800,6801744706112713,659,9343592,1460217,0,1460217
2588,Kevin Strootman,66,4187000,7318286622577518,578,7375615,2469783,2470,2467313
2589,Pascal Struijk,28,303700,6905017324073414,49,315359,228250,2283,225967
2590,Matías Suárez,63,423200,7677756154435718,272,2211047,504990,50499,454491
2591,Isaac Success,70,4475900,8449293291451817,603,8241997,3501948,35020,3466928
2592,Crysencio Summerville,62,2051500,7865013300785309,422,4697351,3947374,3947374,0
2593,Toni Šunjić,30,359200,7146475059314372,73,562329,453386,0,453386
2594,Erik Sviatchenko,39,1037600,4774419052857835,196,1933117,119274,119274,0
2595,Jan Sýkora,25,3474900,4488367998109171,291,4533121,710687,711,709976
2596,Issiaga Sylla,35,1171500,7151581711307995,179,2156253,1451415,1451415,0
2597,Yohei Takaoka,57,4837000,3179222260982728,628,9051754,1002138,0,1002138
2598,Charlie Taylor,46,1185900,5406699863466327,254,2898928,95488,95488,0
2599,Terrats,39,4533500,4701615980552334,471,7269805,2690608,0,2690608
2600,Florian Thauvin,43,1627200,3329172757242816,281,3306480,104465,0,104465
2601,Luke Thomas,63,2855900,9343240827034284,423,5531226,920727,92073,828654
2602,Kristian Thorstvedt,60,4463900,3031202185313874,590,7812502,712322,71233,641089
2603,Gastón Togni,41,4196400,6200588232015511,452,6332880,4321594,43216,4278378
2604,Jens Toornstra,30,1822900,4089285526069803,200,2910819,2339601,23397,2316204
2605,Facundo Torres,66,3357100,6730446941950148,508,6665252,205864,2059,203805
2606,Aiyegun Tosin,49,1990100,8771704576412984,366,4553532,4082185,4083,4078102
2607,Birama Touré,62,1672400,3922443682081709,405,4172979,1374766,13748,1361018
2608,Ismaël Traoré,45,2113300,9571880614925305,315,3925397,539675,5397,534278
2609,Mark Travers,28,1077700,9369790804088930,136,1628039,615508,0,615508
2610,Auston Trusty,54,3182800,6808705760696187,468,6120458,2891456,290,2891166
2611,David Turnbull,63,1039700,5822321471692715,366,3451126,518878,0,518878
2612,Deniz Türüç,42,3810400,6556028988631821,412,6549226,5294476,529448,4765028
2613,Matthieu Udol,41,967600,7496350439413284,168,1840844,1253574,0,1253574
2614,Ayase Ueda,42,4267200,5187917935504376,460,6981355,4638118,4639,4633479
2615,Lesley Ugochukwu,61,4977700,6891310499478377,613,8219166,2634916,0,2634916
2616,Filip Ugrinic,32,1446000,4197633659424905,160,2285659,561233,0,561233
2617,Um Won Sang,25,420100,7147182866273299,33,288299,184751,1848,182903
2618,Tomáš Vaclík,50,3648600,3183191295183932,474,6687639,5953059,595306,5357753
2619,Josha Vagnoman,22,2618100,5129567064694369,227,3965862,247455,24746,222709
2620,Cote,52,1758100,4405392828071052,340,3771490,707496,707496,0
2621,Bruno Wilson,28,3821900,7412141036222330,303,5876220,2608721,260873,2347848
2622,Manu Vallejo,62,3760200,5526409812258873,559,7395845,7382086,0,7382086
2623,Nicolai Vallys,47,1421800,4963421771393618,272,3245144,1023588,102359,921229
2624,Sven van Beek,63,4780600,5972054385380268,626,8705851,7830830,0,7830830
2625,Mick van Buren,59,2778700,3801907861376054,464,5793379,717631,718,716913
2626,Vito van Crooij,28,991600,7420053575124795,107,1354651,665908,66591,599317
2627,Denis Vavro,35,1410100,3881175990438573,237,2787355,458644,458644,0
2628,Brandon Vazquez,24,4333100,4532036766843171,339,6443454,2207738,220774,1986964
2629,Gustavo Velázquez,66,1633600,9472506740163712,417,4259312,1473864,1473864,0
2630,Miloš Veljković,53,4019200,3838641614560726,518,7001832,4015925,4015925,0
2631,Valerio Verre,23,1478300,9540407056083119,135,1960098,75049,0,75049
2632,Yari Verschaeren,57,809800,4381130279414383,272,2406848,554987,554987,0
2633,Iñigo Vicente,58,1933200,7697465794085566,397,4717149,643550,643550,0
2634,Diego Viera,37,3378100,5240437304789960,370,5731861,4746047,4747,4741300
2635,Nick Viergever,58,744100,3091985778907165,227,2022931,1979861,1979861,0
2636,Villalibre,61,1804200,4385548962697885,379,4190224,3122958,312296,2810662
2637,Mikel Villanueva,66,2369000,6463416085761017,453,5253232,4885612,489,4885123
2638,Iván Villar,59,797200,9774871980118776,275,2454721,2219921,0,2219921
2639,Matías Viña,67,3361800,9955431310973528,535,6414250,2939866,2940,2936926
2640,Martin Vitík,42,3392800,9576329311450747,410,6215223,1175123,0,1175123
2641,Adam Vlkanova,58,4199000,6066921755687076,486,6652532,3535386,0,3535386
2642,Aster Vranckx,44,4279800,4586861803144857,482,6843615,6331998,0,6331998
2643,Matěj Vydra,63,2443300,8845194532834196,375,5019657,491906,0,491906
2644,Danny Ward,45,4158900,5641638519208409,420,6401172,1661511,166152,1495359
2645,Neco Williams,58,3243000,5699408015804365,527,6634324,4881045,0,4881045
2646,Maximilian Wittek,68,2971100,3022590370785530,500,6714708,1545166,0,1545166
2647,Abdul-Aziz Yakubu,57,3665800,3827780636266093,514,7072273,3997509,0,3997509
2648,Yusuf Yazıcı,53,4225700,5919152915570693,531,7664239,6427908,642791,5785117
2649,Okay Yokuşlu,48,2811100,5125530111356539,406,5030558,742020,743,741277
2650,Maya Yoshida,60,2236300,7023849868970761,384,4370756,1839616,184,1839432
2651,Yoshimar Yotún,50,4237100,3476743075774916,513,7323699,1014842,10149,1004693
2652,Diego Zabala,47,1954600,6237943259403240,300,3621733,2656637,265664,2390973
2653,Illia Zabarnyi,43,3606200,3314551870567868,427,6400518,1173555,0,1173555
2654,Christos Zafeiris,42,836000,7126402136592800,175,1673105,381302,0,381302
2655,Francesco Zampano,69,2937000,9930333889394145,469,5922885,3050,0,3050
2656,Zarraga,41,4064700,9741304200526013,440,6861958,1768476,177,1768299
2657,Exequiel Zeballos,65,1569500,7553690308402389,362,4167732,917114,91712,825402
2658,Moustapha Zeghba,54,3957100,6151453943371187,510,7609736,4542035,45421,4496614
2659,David Zima,69,3100500,9437526164679678,480,5913309,4469030,0,4469030
2660,Christoph Zimmermann,68,4517400,9315388480284055,580,8258956,3051942,0,3051942
2661,Joshua Zirkzee,40,699700,7274502464627974,163,1663703,1015503,102,1015401
2662,Oleksandr Zubkov,48,2858500,9466761493319704,391,5274106,4976020,498,4975522
2663,Bruno Zuculini,26,4090600,7711890633658556,311,5937016,1386552,0,1386552
2664,Rodrigo Abascal,49,2824200,4159870331455866,416,5710324,3487355,0,3487355
2665,Himad Abdelli,65,345200,7413610661216945,269,1996337,247903,248,247655
2666,Oliver Abildgaard,59,2636200,9888592814643542,443,5440730,5043496,0,5043496
2667,Luis Abram,58,1809400,4635648909628044,319,3929965,1264987,12650,1252337
2668,Gonzalo Abrego,36,4673900,7640871967897770,411,6685818,1823269,183,1823086
2669,Lautaro Acosta,25,3474800,3362289622658791,315,4921131,1935479,194,1935285
2670,Kellyn Acosta,37,3643100,3877927475933120,401,6186447,3409673,0,3409673
2671,Martin Ádám,28,2953900,8111946229602598,316,4754295,4668423,4669,4663754
2672,Elijah Adebayo,34,754700,3516030851516261,140,1433248,822746,822746,0
2673,Ahn Hyun Beom,41,3918000,8797985567778922,421,5891714,3007475,30075,2977400
2674,José Aja,68,3354900,9705826480894239,601,7064547,3817812,0,3817812
2675,Emre Akbaba,28,2901500,4366755636558889,238,3791231,740020,0,740020
2676,Halil Akbunar,43,3987800,4167841293094507,451,6711991,1354096,1354096,0
2677,Yunus Akgün,33,4688600,6130223745336759,454,7362061,6705748,6706,6699042
2678,Paul Akouokou,32,3589700,7932434136225140,312,4774443,2385037,238504,2146533
2679,Bandar Al Ahbabi,30,3257000,7949065411165995,339,5509423,3022224,0,3022224
2680,Ameen Al Dakhil,32,3364200,7854218204769201,370,5712681,1903186,191,1902995
2681,Salman Al Faraj,28,4822500,5724057922713514,402,7371091,4690010,46901,4643109
2682,Bruno Langa,28,1199400,5857971349251195,143,1827726,1029309,1030,1028279
2683,Alcalá,27,3745300,9107329504490509,314,5221251,795527,0,795527
2684,Danijel Aleksić,63,367400,9375110808239402,322,2472690,107223,1073,106150
2685,Doğan Alemdar,30,591400,4062349628063810,80,810007,203448,203448,0
2686,Bruno Costa,27,2051300,6215626529180958,174,2854710,1598173,159818,1438355
2687,Facundo Altamirano,22,2349700,3263000750003050,161,2906242,1734793,173480,1561313
2688,Gastón Álvarez,41,2758500,8365318877392511,310,4731351,3526375,0,3526375
2689,Francisco Álvarez,29,4184700,9596058425912763,370,6696371,1693525,16936,1676589
2690,Agustín Álvarez Martínez,26,1576800,9539154712169326,125,1932559,1808281,1809,1806472
2691,Steven Alzate,58,2051800,4259905418650296,360,4226604,2195917,2195917,0
2692,Lazare Amani,58,4137600,8446233909896942,557,8210616,205843,2059,203784
2693,Jordan Amavi,26,4691100,9522336134916926,399,6571802,5215211,0,5215211
2694,Branco Ampuero,31,2772900,7486648011110361,285,4196437,2675840,0,2675840
2695,Francis Amuzu,27,3145800,7391695054744778,306,4981204,2104967,0,2104967
2696,Elliot Anderson,69,1006500,5962217272401945,325,3341608,2590285,0,2590285
2697,Joel Andersson,48,1747600,8171043261346857,260,3014210,1430842,143085,1287757
2698,Shinta Appelkamp,22,2447400,8386282544742809,201,3364092,179540,1796,177744
2699,Claudio Aquino,70,869800,3436397403272378,357,3170398,3166128,3166128,0
2700,Mattia Aramu,39,756400,9958228062367884,137,1451309,199039,200,198839
2701,Alexander Aravena,56,2014700,6455868949743321,385,4231451,1458759,146,1458613
2702,Carlens Arcus,52,3587400,8439817441194246,491,6110421,1230255,123026,1107229
2703,Matías Arezo,63,4212600,9689760297493243,557,8261692,8002686,800269,7202417
2704,Adam Armstrong,23,1283300,4144851241404144,90,1333150,1210504,122,1210382
2705,Paul Arriola,49,3435400,5034582067069566,428,6109338,1377833,13779,1364054
2706,Majeed Ashimeru,47,3505300,8135866302264465,427,6104380,3728173,3729,3724444
2707,Kaan Ayhan,36,1509400,8131724087496246,206,2536673,825625,0,825625
2708,Hernani,65,1744200,5286118347674534,441,5014823,4053332,406,4052926
2709,Daniel Bachmann,61,1624400,7855571678536779,362,3999311,3321913,3321913,0
2710,Milan Badelj,28,4707200,9611054644969044,358,6685160,814969,0,814969
2711,Stefan Bajcetic,26,2643000,3893687148905213,244,3864279,1154399,0,1154399
2712,Éder Balanta,60,4365000,4059777469731899,538,7012312,491746,49175,442571
2713,Fodé Ballo-Touré,40,1870500,6467049125836742,246,3236455,723322,724,722598
2714,Barry Bannan,57,3192300,3492706412051294,481,5716135,3604522,0,3604522
2715,Federico Barba,46,1965900,4971614391753234,297,3633218,3475773,0,3475773
2716,Yoann Barbet,64,4245100,8268584853488147,566,8205279,5300656,531,5300125
2717,Facundo Barceló,69,2998000,3016704164379717,521,6176258,5867248,586725,5280523
2718,Hernán Barcos,56,3002300,5840790571643997,494,6176465,5556754,555676,5001078
2719,Francesco Bardi,55,4715200,7236594983190816,590,7976845,1177559,1178,1176381
2720,Vasilios Barkas,70,2558600,9618640626787622,581,6105977,3323859,0,3323859
2721,João Novais,37,3981600,8602167638785411,380,5719668,697324,69733,627591
2722,Simone Bastoni,23,446500,4714199889077074,44,380919,343037,3431,339606
2723,Damian Batallini,32,1828000,4863317735020931,215,2802692,136711,1368,135343
2724,Jean-David Beauguel,60,924400,7772154672026739,311,3007637,544599,545,544054
2725,Dion Drena Beljo,65,3563300,7640300595335393,570,7427334,6817443,0,6817443
2726,El Fardou Ben,24,1045200,5275942553027630,69,1122657,70116,7012,63104
2727,Eliesse Ben Seghir,69,4086700,3058420709729092,645,7744953,1049720,104972,944748
2728,Marcelo Benítez,53,3562600,9302902302310770,428,6144128,1323965,132397,1191568
2729,Filip Benković,58,3893400,3831167163094291,535,7161794,5615433,562,5614871
2730,Bartosz Bereszyński,66,421100,7217152204709930,311,2691515,2286887,2287,2284600
2731,Muhamed Bešić,40,4953000,9386173178734224,502,8388338,4080064,0,4080064
2732,Krystian Bielik,51,1216600,7319772276969636,289,3230400,1552436,156,1552280
2733,Fredrik Andre Bjørkan,52,4732800,8456025760309706,570,7692172,3168877,0,3168877
2734,Lucas Blondel,48,4492100,9329157230598110,504,7209385,410506,4106,406400
2735,Emmanuel Boateng,60,2293000,9553271251224401,404,5034560,1450315,14504,1435811
2736,Paweł Bochniewicz,51,1608700,8915915443129867,263,3345471,2209821,221,2209600
2737,Arnaud Bodart,25,4893700,9879977270712871,396,7111453,1559107,156,1558951
2738,Miler Bolaños,41,3370500,4773421763208227,370,5644850,5039875,5039875,0
2739,Sinan Bolat,61,4036100,3789312317703551,587,7459597,4813735,482,4813253
2740,Valeriy Bondar,61,2791800,4057473348876772,477,6028837,5036553,5036553,0
2741,Kevin Bonifazi,49,4367200,7653262724784420,535,8041783,7667881,7668,7660213
2742,Rubén Botta,37,4003900,5744488835210956,454,6897652,5218151,0,5218151
2743,Terrence Boyd,62,3157100,7983659699240606,516,6768654,4205513,0,4205513
2744,Martin Boyle,64,3072600,4824652632827228,455,5854746,1307395,13074,1294321
2745,Tom Bradshaw,26,1183900,7055501334398859,101,1510296,969256,969256,0
2746,Billal Brahimi,52,4185400,9244051546717201,542,7800213,2427811,0,2427811
2747,Jarrad Branthwaite,53,1581500,4389837522740048,304,3279570,2264654,2265,2262389
2748,Lilian Brassier,68,1921500,3717484954200341,418,4545620,3702713,3703,3699010
2749,Claudio Bravo,29,4944200,5725388239373480,491,8019836,5257094,0,5257094
2750,Anthony Briançon,33,3309300,6466440066404396,315,4900046,3101939,3102,3098837
2751,Jorge Broun,31,2901000,9267077829015220,275,4186378,3282808,3282808,0
2752,Facundo Bruera,69,1658000,7343098038219458,388,3989926,3402792,0,3402792
2753,Jeffrey Bruma,43,3702400,8835573332150980,421,6141944,5398311,539832,4858479
2754,Tajon Buchanan,39,3515200,3168961827592043,390,5697761,4072258,408,4071850
2755,Yan Couto,46,4481400,3270627241875316,508,7528407,3636680,3636680,0
2756,Hugo Bueno,44,365200,9565741004256536,156,1202397,397272,0,397272
2757,Adam Buksa,57,1545400,7298993671460170,311,3683754,1576394,15764,1560630
2758,Marnon Busch,51,1993400,3536791014111289,296,3855202,2736606,0,2736606
2759,Gianluca Busio,47,3925600,3692091516680608,484,7094804,6526146,6526146,0
2760,Alexander Callens,60,3628200,8174679237814893,447,6513767,3021771,303,3021468
2761,Dani Calvo,68,913100,9778773586872146,308,3086957,3026695,3027,3023668
2762,Mahdi Camara,44,2417800,8677834192581633,310,4131922,3892981,0,3892981
2763,Alejandro Camargo,24,2324200,6964073474243476,211,3368884,455605,45561,410044
2764,Sergi Canós,45,828000,6439063053668093,202,2073995,1901433,1901433,0
2765,Elia Caprile,27,596800,9003641721393543,86,801600,254938,0,254938
2766,Irvin Cardona,61,3780600,7479798614274150,557,7200776,481070,0,481070
2767,Bernardo Vital,49,3450600,5355341927433204,451,6385263,4718188,471819,4246369
2768,Julián Carranza,22,4551800,9610966317186627,353,6139991,4508206,451,4507755
2769,Vitor Carvalho,58,4328300,9470503057807819,578,7560311,1933820,1933820,0
2770,José Carvallo,30,2329000,4253799844796944,245,3764612,1180286,1181,1179105
2771,Cristian Cásseres Jr,56,1535200,4647076512603419,341,3387062,558257,559,557698
2772,Lucas Castro,48,1425100,7376527124266251,278,3352839,3307087,0,3307087
2773,Maximiliano Caufriez,69,2923800,7250017369321962,475,5506167,1104892,110490,994402
2774,Ivan Cavaleiro,47,696200,4739133737512490,190,1849030,50429,0,50429
2775,Maxime Chanot,40,1896800,8652127434047894,228,3177219,2365920,2365920,0
2776,Yimmi Chará,57,4094800,7626026791786562,493,6737188,1445972,0,1445972
2777,Gaëtan Charbonnier,22,4105700,7396297913740864,340,5900665,1058703,1058703,0
2778,Xavier Chavalerin,47,1745200,3780141678937631,289,3486092,1434931,0,1434931
2779,Walid Cheddira,70,3982900,4115066350038198,625,7560875,1598659,1598659,0
2780,Youssef Chermiti,39,3886900,6554444482317138,445,6365246,6033220,60333,5972887
2781,Cho Gue Sung,25,581600,6397775524071530,47,535521,238878,23888,214990
2782,Mohamed-Ali Cho,28,3453300,9719216604018054,347,5428464,1842865,1843,1841022
2783,Hamza Choudhury,35,4737900,8766775837655248,487,7774373,7524340,753,7523587
2784,Alexandru Cicâldău,54,1093300,7745823744425827,296,2976058,1714980,171498,1543482
2785,José Cifuentes,36,1451500,4119809894960348,181,2286289,925865,0,925865
2786,Facundo Colidio,35,4678600,7711022149151042,407,6396981,3890929,0,3890929
2787,Lorenzo Colombo,45,1412200,6068526442952558,237,2654415,64156,642,63514
2788,Florinel Coman,25,548400,7444739489439836,43,476632,48735,0,48735
2789,Steve Cook,53,2882800,7896717225698849,430,5374050,2902408,290241,2612167
2790,Córdoba,64,1034100,5185892621551505,312,2926818,580374,580374,0
2791,Carlos Coronel,38,3154900,5546136024447288,381,5559791,2114237,211424,1902813
2792,Janner Corozo,61,940300,7258561256679237,292,2888682,1680259,169,1680090
2793,Brayan Cortés,48,3318100,7460762051840415,402,5441821,431662,4317,427345
2794,Ayrton Costa,52,1472900,5327832445829972,248,2907421,2678399,26784,2651615
2795,David Costas,23,3383000,4313652872988759,295,5062584,1522399,15224,1507175
2796,Yoann Court,40,637400,7211999122930302,160,1391653,602566,602566,0
2797,Leonardo Lelo,68,814300,3301531146685287,301,2801712,2684530,2684530,0
2798,Jorge Cuenca,40,3307600,8936718536475498,403,5733056,4221891,0,4221891
2799,Braian Cufré,65,630500,4160098809106333,268,2359484,724612,0,724612
2800,André Vidigal,68,632400,5470975018355973,287,2349712,173913,173913,0
2801,Patrick Cutrone,70,3132400,8492233037212051,584,6620963,4874300,0,4874300
2802,Damien Da Silva,48,2254500,6302543984337774,381,4241165,1044779,104478,940301
2803,Edgar,39,2425400,4379738379046398,252,3730249,2156453,216,2156237
2804,Riccieli,35,2396500,7306436808263823,279,3716833,2502782,0,2502782
2805,Ignácio,22,1260800,7064974724904694,103,1582289,433214,433214,0
2806,Abner,53,1190500,4028178177431540,249,2474066,1351409,135141,1216268
2807,Damian Dąbrowski,24,809700,4390455843047296,86,1059833,921319,921319,0
2808,Marcus Danielson,46,3252100,8397250266507406,382,5592872,3447596,345,3447251
2809,Mohamed Daramy,34,1618700,3732871972420833,176,2510778,1805027,18051,1786976
2810,Márton Dárdai,37,1213300,4761665741411518,161,1927514,440997,440997,0
2811,Sean Davis,54,4804400,3448354900368957,589,9199644,1287769,1288,1286481
2812,André Geraldes,63,3795700,4271310577207829,554,6813983,6313062,63131,6249931
2813,Maracás,59,3965300,8093921968833774,539,7129488,4078084,407809,3670275
2814,Anderson Jesus,51,717000,7304619562393299,214,2057265,700100,700100,0
2815,De La Hoz,53,3706400,4389333581794418,533,6765029,5484946,5485,5479461
2816,Ritchie De Laet,45,1527500,5934604691322012,278,3388224,2106948,211,2106737
2817,Thibault De Smet,43,576200,5176143405175364,166,1576041,277446,2775,274671
2818,Rúben Lameiras,31,364900,3548045813032127,76,596868,557472,0,557472
2819,Steven Vitória,70,4696000,5419339769304908,707,9133891,5405993,5405993,0
2820,Thomas Delaine,47,744900,4545643893930579,229,2050315,70562,7057,63505
2821,Hannes Delcroix,54,3685900,9469022214227902,507,6771597,1401390,0,1401390
2822,Fabio Depaoli,31,3176400,7278081629527840,320,4918714,2573461,0,2573461
2823,Arthur Desmas,25,3874100,5319350955349089,322,5544863,2513820,251382,2262438
2824,Stéphane Diarra,31,4674600,7427813052152111,428,6466544,5881368,5881368,0
2825,Álvaro Djaló,50,805500,4341508902045575,228,2093376,1496873,0,1496873
2826,Amadou Diawara,33,1792000,6267231095113105,193,2704975,1310640,13107,1297533
2827,Fabricio Díaz,69,2405600,7135843998702521,515,5959666,1758518,17586,1740932
2828,Rob Dickie,69,348500,7949168000448040,292,2226769,2037007,20371,2016636
2829,Landry Dimata,25,4569800,7321365787999680,416,6810674,3727908,3728,3724180
2830,Sokratis Dioudis,52,2828800,8189236355988277,434,5900614,249758,2498,247260
2831,Jaume,24,2751100,7083459531384216,263,4037340,3600237,361,3599876
2832,Mateus,63,2733100,3970235897898687,507,6107001,2295471,229548,2065923
2833,Alfie Doughty,41,1075100,3451727658659105,172,1821426,837438,83744,753694
2834,Kamory Doumbia,68,1545700,4512842504752965,444,4328542,2948450,295,2948155
2835,Ousmane Doumbia,52,3624000,3044398131336011,476,6461880,3476256,347626,3128630
2836,Kieran Dowell,24,477700,9667846555227984,52,474778,53724,5373,48351
2837,Dominick Drexler,62,3771700,9009274409193888,582,7787707,7606400,0,7606400
2838,Jonathan Dubasin,27,1617100,8635478048150992,152,2087691,862628,862628,0
2839,Mikkel Duelund,30,1610200,8643941761117566,169,2388163,2246784,225,2246559
2840,Rafiu Durosinmi,27,1576700,9810102193725368,179,2412525,2142680,215,2142465
2841,Noë Dussenne,32,1724100,9655468510216999,205,2717002,670513,6706,663807
2842,Jeremy Ebobisse,55,1815400,5541300890834341,330,3708628,1240297,1241,1239056
2843,Karim El Berkaoui,67,2691800,3181638575307351,520,6064542,4433270,443327,3989943
2844,Oualid El Hajjam,51,737400,5309114149577991,213,1991991,746759,746759,0
2845,Alberth Elis,41,4953500,3230497546331782,471,7598147,6361850,6362,6355488
2846,Arne Engels,48,2644200,4708492473332794,414,4985509,1630278,16303,1613975
2847,Alberto Espínola,27,3264500,4667180962181657,299,4681086,4388683,4389,4384294
2848,Michael Esser,68,3204400,8017699339476771,490,6650857,76228,0,76228
2849,Óscar Estupiñán,36,2251700,9427774448154264,265,4045079,3807684,381,3807303
2850,Yan Brice Eteki,28,1958200,9379008697010227,216,2808082,1060939,106094,954845
2851,Etxeita,64,4671700,5354271793925331,656,8804885,941153,94116,847037
2852,Ralf Fährmann,30,4080100,3779687974038233,369,6340927,2266795,0,2266795
2853,Marcello Falzerano,31,4612900,6835250696642052,461,7542231,3472370,3472370,0
2854,Fei Nanduo,43,4506100,6539017579464138,472,6794853,2642390,0,2642390
2855,Álvaro,52,1260600,4396360931178117,296,2926643,2355797,0,2355797
2856,Josan,60,4346800,5182654447708584,541,7752691,2656837,265684,2391153
2857,Gian Marco Ferrari,43,4075900,8202110844236004,431,7010998,3230112,323012,2907100
2858,Juninho,30,327800,4603500998073481,81,621265,369357,0,369357
2859,James Forrest,42,2058000,8898326728883721,280,3722085,2565671,2565671,0
2860,Timothy Fosu-Mensah,47,2292400,9071222955456475,323,4550505,3071859,0,3071859
2861,Mohamed Fouzair,36,3234100,3844229979832137,361,5495086,1791951,1792,1790159
2862,Franco Fragapane,46,1507700,8512646084833712,273,2979371,1381256,13813,1367443
2863,Stefan Frei,27,3728000,5773294610797859,342,5556721,5216286,0,5216286
2864,Morten Frendrup,59,4298900,8395493156046526,592,7513650,337487,337487,0
2865,Fresneda,45,4638600,9397514470047908,528,7934066,2924988,293,2924695
2866,Ramiro Funes Mori,48,1029000,8847142174724424,206,2172448,2066541,207,2066334
2867,Manu Fuster,31,4968200,8522502717323719,475,8102691,7004954,700496,6304458
2868,Cristian Gamboa,53,2330300,9435938087517305,367,4795270,4596450,4596450,0
2869,Ulisses Garcia,36,3532700,6507476692144395,363,5884074,4980359,4980359,0
2870,Agustín García Basso,47,1473400,4391930746422930,248,2771335,2140879,0,2140879
2871,James Garner,34,867200,6041415354990601,130,1365788,1272322,1273,1271049
2872,Luca Garritano,61,2055100,3604744830057565,383,4248342,132751,132751,0
2873,Valentin Gendrey,61,1334900,9265023808306457,314,3308913,959992,9600,950392
2874,Valère Germain,69,988300,4087808821296880,377,3714794,2511377,25114,2486263
2875,Marius Gersbeck,69,4315300,3164067802235107,694,9526116,4958292,49583,4908709
2876,Dimitris Giannoulis,43,3989500,7424333687540034,447,6046289,4334708,433471,3901237
2877,David Gil,43,1932500,7192135715266030,238,3137390,956174,956174,0
2878,Billy Gilmour,35,1325200,9354169914009941,181,2215305,416178,4162,412016
2879,Gastón Giménez,45,4054700,6171988180042348,452,6825565,1118392,1118392,0
2880,Paolo Goltz,22,3046000,5442984465829833,237,4137059,971790,9718,962072
2881,João Nunes,41,894700,5725251258317936,180,1885670,1539654,15397,1524257
2882,Alberto Grassi,70,2029000,4480406683572846,486,5258214,4605386,4605386,0
2883,Stian Gregersen,28,2149400,7231964136854429,164,2945697,1291470,129147,1162323
2884,Marco Grüll,42,2450200,7291666262486117,320,4419163,1167763,1167763,0
2885,Sergi Guardiola,39,1695500,8805419721939090,252,3196484,2220701,0,2220701
2886,Marcelo,36,413700,3096422067298563,124,977336,248197,0,248197
2887,Morgan Guilavogui,62,2692200,5452216193894467,423,5171631,4774495,4774495,0
2888,Koray Günter,30,2885900,3120756702285820,266,4024683,455424,456,454968
2889,Serdar Gürler,22,708500,7683237999589984,65,751926,610448,611,609837
2890,Norbert Gyömbér,67,3652500,8090908297745044,570,6879626,4708166,4709,4703457
2891,Robin Hack,31,4713000,3715614479183324,456,7208458,7116636,711664,6404972
2892,Ehsan Haji Safi,69,328200,5525101239407655,355,2962612,1519928,0,1519928
2893,Genki Haraguchi,30,2120700,6641300750102943,235,3547298,806553,0,806553
2894,Abdou Harroui,50,2934700,4574028356111693,421,5618868,5573297,5574,5567723
2895,Marcel Hartel,55,1998300,7210819244086527,355,4315520,1493324,1493324,0
2896,Quilindschy Hartman,35,3670100,4273988048968481,343,5656450,2335967,2335967,0
2897,Kortney Hause,36,3037500,4512828659455195,328,4616573,4250578,42506,4208072
2898,Milan Havel,57,3308500,5250458909773733,460,6315186,3822422,382243,3440179
2899,Thom Haye,51,2887500,6261247785245877,405,5336837,1550732,15508,1535224
2900,Tom Heaton,52,3032200,7320100337769636,421,5612815,3920673,393,3920280
2901,Liam Henderson,27,652300,5165900716401766,75,763566,437757,43776,393981
2902,Leo Coelho,56,3179800,8520212341985542,497,6310887,1099563,1100,1098463
2903,Mads Hermansen,32,1534800,9812777825702402,210,2519934,1911610,1912,1909698
2904,Abel Hernández,47,558500,6176666282786161,174,1525767,655791,656,655135
2905,Andrés Herrera,57,3163800,5474239930282755,457,6427265,5348950,0,5348950
2906,George Honeyman,49,2798700,9737001596628189,392,4847758,1735240,174,1735066
2907,Ethan Horvath,28,4154700,9288889077331530,344,6391258,1325757,133,1325624
2908,Dino Hotić,27,331000,6707750057328189,41,274152,101994,1020,100974
2909,Even Hovland,49,866200,3166214459478311,208,2075801,1538264,154,1538110
2910,Lucas Hoyos,64,1034600,7070394593911391,301,3109074,2128993,21290,2107703
2911,Branimir Hrgota,38,2260700,8037147155680619,248,3746019,3254422,0,3254422
2912,Jakub Hromada,62,4518300,3964832307577349,585,8539300,1273100,1273100,0
2913,Dominic Hyam,62,2590100,8291537123685511,456,5400988,1032898,0,1032898
2914,Renato Ibarra,57,345000,7079987377905827,208,1594441,1413279,1414,1411865
2915,Edgar Ié,67,559000,3600600832911449,340,2764157,2256422,226,2256196
2916,Juan Iglesias,22,1793900,6535814915389475,160,2545183,1493402,150,1493252
2917,Marco Ilaimaharitra,68,2723900,8880654249118345,522,5761764,3365878,0,3365878
2918,Tom Ince,67,2032700,7213946374282396,427,4755972,3831518,0,3831518
2919,Juan Manuel Insaurralde,67,1889400,9276268897684938,457,4937655,268233,26824,241409
2920,Ardian Ismajli,45,3590500,7631869713938339,477,6757316,2899232,28993,2870239
2921,Tomoki Iwata,44,2360700,9400892143395244,297,4095242,2427934,2428,2425506
2922,Jeong Woo Yeong,50,3320400,8130266386590623,423,6303762,1505052,1506,1503546
2923,Jiang Guangtai,27,2393600,6528332483590320,197,3120568,1423045,142305,1280740
2924,Erik Jirka,43,3768300,9218364310582331,461,7070290,6673301,6673301,0
2925,DeJuan Jones,49,4588000,6866595622896518,560,8197502,4815855,4816,4811039
2926,Jesse Joronen,40,2829900,5114645946178957,340,4706478,2590460,0,2590460
2927,Anthony Jung,70,3599000,9397958622629452,585,7558734,5257108,5257108,0
2928,Julian Justvan,48,3737800,9526609028760690,485,6535818,2324066,23241,2300825
2929,Taras Kacharaba,39,855900,3621461531150681,179,1681136,718357,0,718357
2930,François Kamano,60,4088600,6614206305419222,610,7755230,1118216,112,1118104
2931,Loris Karius,30,2612400,6307887985760489,263,3744258,305164,0,305164
2932,Ilan Kebbal,29,717100,7850305243882515,77,904082,794550,0,794550
2933,Davit Khocholava,56,1192100,7560236817675697,274,2857406,1034445,103445,931000
2934,Luca Kilian,69,1853900,3534354534425598,435,4559052,3872806,387281,3485525
2935,Emre Kılınç,25,809700,3964205768798001,85,1034890,835225,835225,0
2936,Kim Dong Joon,70,1107800,4793895909815020,338,3459364,271232,272,270960
2937,Kim Seung Gyu,57,1990900,7544950379470281,337,4050310,1615579,161558,1454021
2938,Sean Klaiber,52,3218800,7334364772158235,446,5475269,3479445,0,3479445
2939,Christoph Klarer,42,3963400,8463715610411033,398,5651961,1664816,1664816,0
2940,Ko Seung Beom,36,730000,7131187635687923,123,1276725,8907,8907,0
2941,Mats Köhlert,38,1517900,9737041057572568,217,2664132,2051585,2051585,0
2942,Philipp Köhn,58,4234500,3654802455148362,507,7070020,7043010,704301,6338709
2943,Derrick Köhn,25,4948200,6074902093258370,403,7196380,641216,641216,0
2944,Tomáš Koubek,45,2341000,5177504061392541,334,4344567,2819620,2819620,0
2945,Vladan Kovacević,66,4275600,9800190294642542,537,7996917,850133,850133,0
2946,Victor Kristiansen,23,1554800,4322016515623384,149,2072473,1987487,1988,1985499
2947,Sergiy Kryvtsov,37,3945600,3773726646381372,399,6371423,4632175,464,4631711
2948,Fabian Kunze,42,4139600,7680617960258666,484,7026705,2046597,205,2046392
2949,Jasmin Kurtić,64,4168600,3860270155767483,562,7600577,5669438,5670,5663768
2950,Grejohn Kyei,34,1196600,8194044211184060,153,1873849,1132192,114,1132078
2951,Zakaria Labyad,29,3200600,9924116247906436,294,4440615,4265507,4265507,0
2952,Kenny Lala,53,2221000,3298243357133537,388,4764786,3549520,3550,3545970
2953,Didier Lamkel Zé,36,2226400,9064492625363630,258,3650105,2394218,23943,2370275
2954,Luca Langoni,58,4851100,5701438473012955,616,8419666,7508434,751,7507683
2955,Federico Lanzillotta,31,3444300,7082832037577158,330,5599189,2761125,0,2761125
2956,Rasmus Lauritsen,43,3678800,7383711377659437,499,6383099,4547517,4547517,0
2957,Valentino Lazaro,45,461200,8100566049518938,181,1407254,387963,38797,349166
2958,Jean-Louis Leca,49,2776900,4591564454791258,348,4695358,389039,3891,385148
2959,Lee Dong Jun,30,4605100,3317270952071803,474,6955511,6522255,6522255,0
2960,Lee Chang Geun,25,3704900,8836075189932805,334,5216633,172691,0,172691
2961,Maxim Leitsch,23,2852500,3051587194511325,236,4119849,2406912,2407,2404505
2962,Mehdi Léris,30,3785900,3970873118575935,295,5428772,1142143,1142143,0
2963,Benjamin Leroy,35,2999500,3254729679270467,322,4451163,2017556,0,2017556
2964,Jamie Leweling,42,1088100,6229944848444921,185,2093661,1346525,13466,1333059
2965,Keane Lewis-Potter,48,4937100,3981782597668039,515,7336995,6560637,656064,5904573
2966,Darío Lezcano,68,1408400,6825161300466495,383,4058452,1317321,0,1317321
2967,Dimitri Liénard,30,3971800,4776266116743386,351,6055631,4925853,0,4925853
2968,Lim Chai Min,50,3700500,5907070743598942,437,6725671,2743344,2743344,0
2969,Luquinhas,29,2504700,3845469106593399,245,3677522,1696897,16969,1679928
2970,Martin Linnes,28,456200,3803564108546722,78,696310,202176,202176,0
2971,Pol Lirola,65,3617600,7118724758114073,545,6582836,95336,954,94382
2972,Raúl Lizoain,57,3675700,6751742086914857,508,7274594,4697428,46975,4650453
2973,Jürgen Locadia,62,3893000,5167858952773041,568,6962446,6961715,0,6961715
2974,Bradley Locko,35,4534800,4796429428425453,424,6828590,6676723,0,6676723
2975,Roberto López,45,1671500,6492457050701213,264,3273752,396838,0,396838
2976,Jonas Lössl,28,559400,7714103189585045,62,601489,296356,2964,293392
2977,Max Lowe,68,3569600,6990738849324598,553,7197611,6239586,6240,6233346
2978,Lorenzo Lucca,49,2264300,4952259901376125,350,4518755,300139,300139,0
2979,Abel Luciatti,23,4668100,9586864796697252,349,6456216,1283135,0,1283135
2980,Jeison Lucumí,26,309800,5342796286403296,25,126036,2829,0,2829
2981,Jhonatan,36,2208500,9992724798918686,237,3111127,947794,948,946846
2982,Andreas Luthe,34,379100,5590949235644618,107,864534,755458,7555,747903
2983,Charalampos Lykogiannis,24,1922700,3203709260335619,161,2511833,2422386,0,2422386
2984,Mathieu Maertens,65,4353000,9001853536870616,568,7793231,4862554,48626,4813928
2985,Ainsley Maitland-Niles,58,4666400,6579073425368208,631,9289302,4451560,4452,4447108
2986,Gaius Makouta,48,1747900,6439519363886476,314,3787616,3217735,32178,3185557
2987,Youssef Maleh,57,2336100,5955474867380674,438,5059801,1962244,1963,1960281
2988,Mickaël Malsa,31,2872600,5683722019093173,329,4824359,1742266,0,1742266
2989,Dennis Man,42,2108600,4071673318564678,320,3962833,3002243,301,3001942
2990,Eliaquim Mangala,47,3923900,3701468564735194,476,6800006,1768802,177,1768625
2991,Vito Mannone,28,3965700,5272047508842109,325,5131940,550068,5501,544567
2992,Manquillo,36,2489400,5392616295661444,293,4117247,2351987,2351987,0
2993,Tomás Marchiori,38,1029200,3412275507336828,177,1917660,181609,18161,163448
2994,Mika Mármol,29,960000,6066460149219568,143,1590922,229599,0,229599
2995,Jonas Martin,43,3478700,4814813369309097,437,5693692,5029735,502974,4526761
2996,Federico Martínez,68,3689800,9025369102357179,630,7840262,6077110,607711,5469399
2997,Pablo Martínez,27,697100,5158683282344803,71,831969,863,0,863
2998,Nacho,23,4098600,6590270277953804,366,6441029,1691044,1692,1689352
2999,Josep Martínez,43,3914300,9644675942312146,421,6529415,4577401,45775,4531626
3000,Adam Masina,57,1278200,5681050930243596,308,3464021,1920393,19204,1901189
3001,Christian Mathenia,45,4505300,9078027579132131,486,6953153,1343291,1344,1341947
3002,Jordi Mboula,51,713600,5117192676768337,265,2529060,1487540,148754,1338786
3003,Oli McBurnie,36,582900,4709596525550704,141,1323335,1285414,128542,1156872
3004,Alex McCarthy,54,2642800,4433160204502068,425,5383600,770939,770939,0
3005,Riley McGree,66,3240900,9603263848569323,493,6295200,3427185,3427185,0
3006,Barrie McKay,70,4757800,3465182713090627,639,8325695,1286527,128653,1157874
3007,Kenny McLean,32,851300,6351399659762606,143,1465496,436430,0,436430
3008,Paddy McNair,30,2247400,8553084255762604,245,3698473,867894,0,867894
3009,Jakov Medić,40,3480900,4576401713087834,367,5569805,78949,0,78949
3010,Alan Medina,27,4687800,4471446110690853,447,6878966,4182846,41829,4141017
3011,Jonas Meffert,28,990900,4012165769573986,131,1519872,887763,0,887763
3012,Jubal,67,410000,8985587898154561,267,1974622,1519145,151915,1367230
3013,Alexandre Mendy,68,1114300,3694730785821247,353,3458658,1538965,1539,1537426
3014,Batista Mendy,24,2006100,4792577534968154,202,2939274,1659198,16592,1642606
3015,Xavier Mercier,31,2836300,8245468064313008,296,4402184,473364,0,473364
3016,Jorge Meré,32,2900100,4333222866286612,296,4180123,933000,933000,0
3017,Merquelanz,41,4492500,6069914162458816,479,7750092,3875502,388,3875114
3018,Fernando Meza,30,4995800,7842993224939596,407,7298497,538299,538299,0
3019,Omenuke Mfulu,48,873900,3344149847236953,207,2110544,1451400,1451400,0
3020,Sven Michel,27,2063800,7671579696788822,164,2695861,526808,52681,474127
3021,Peter Michorl,33,3856600,7539253029320637,338,5620759,1747221,17473,1729748
3022,Sven Mijnans,50,4358000,5807979406165723,461,7022730,3572409,0,3572409
3023,Salvador Agra,47,1377400,6016813857915693,256,2920993,1946862,1946862,0
3024,Martin Minchev,66,1273700,9968781073553102,418,4117708,1978205,1978205,0
3025,Jorge Miramón,67,4116900,6220510844905392,626,8239580,6323991,632400,5691591
3026,Alexandru Mitriță,58,2714200,4008406201788920,444,5369523,2731222,0,2731222
3027,Niklas Moisander,64,3539000,7359479492574394,571,6883502,1058958,0,1058958
3028,Thomas Monconduit,60,4287700,9780185032778731,627,8455064,4809969,0,4809969
3029,Brian Montenegro,40,2681500,8566697832980776,381,4959085,4747767,474777,4272990
3030,Shaquell Moore,30,774700,8011755381524592,103,1197776,447053,0,447053
3031,Tete Morente,42,4616600,7177360225767607,468,6959573,4365192,436520,3928672
3032,Ilaix Moriba,35,3245000,9288168703059450,303,4994223,3336213,334,3335879
3033,Ryota Morioka,53,4597000,8343396166106459,553,7413736,2608723,0,2608723
3034,Carlton Morris,23,4293800,3534442947564197,351,6036975,4613042,4613042,0
3035,Jordan Morris,65,1263200,7605709171208718,377,3846355,2379706,0,2379706
3036,Patrick Mortensen,47,4367800,9729164436266471,431,6702211,834452,834452,0
3037,Steve Mounié,35,3148200,4284207648584073,344,4983811,2295462,229547,2065915
3038,Toni Moya,57,1481800,3174010283639575,346,3790784,1302826,13029,1289797
3039,Kerim Mrabti,52,985700,4678497673742371,266,2525282,1484271,0,1484271
3040,Stefan Mugoša,45,1037100,3701755969839421,235,2424431,2414540,241454,2173086
3041,Mert Müldür,63,1586600,5452573475663296,364,3739903,750269,75027,675242
3042,Florian Müller,36,1646300,5731194835073525,186,2648385,452817,453,452364
3043,Facundo Mura,33,2105000,9037805340611509,251,3682045,1400070,140007,1260063
3044,Michael Murillo,69,311500,5159646293795905,305,2276853,2254067,0,2254067
3045,Nyasha Mushekwi,64,3080200,3596463740465439,522,6358769,3187544,3188,3184356
3046,Florent Muslija,24,2501700,7417524638496272,254,3915332,3561111,3562,3557549
3047,Bogdan Mykhailichenko,69,1985200,8777516586124724,455,4745963,4069487,40695,4028792
3048,Ádám Nagy,64,3354000,9813019507987923,516,6129671,2049252,0,2049252
3049,Rúben Vinagre,23,466300,7568650533755728,63,557399,151013,0,151013
3050,Wilson Eduardo,51,1592300,4890158944688795,314,3469387,1240003,0,1240003
3051,Franco Negri,63,1816400,3808526058772333,391,4024343,1152633,115264,1037369
3052,Tokmac Chol Nguen,32,3309400,6309155191136611,334,4925945,1792678,1792678,0
3053,Cheikh Niasse,52,320500,3797265306631691,177,1383541,781844,0,781844
3054,Florian Niederlechner,66,3773900,4227361192216060,599,7504833,394787,0,394787
3055,Dimitrios Nikolaou,49,2822200,4242497901836674,384,5130593,3297703,3297703,0
3056,Joakim Nilsson,50,1972500,5356049918227712,387,4622910,2134985,214,2134771
3057,Kevin Nisbet,61,2992400,8110377069439494,533,6262556,486098,48610,437488
3058,Kristoffer Nordfeldt,26,3515500,5696959861324541,345,5244456,4137294,0,4137294
3059,Vital Nsimba,70,1491900,7839347559675332,409,4125132,3439439,34395,3405044
3060,Stanley Nsoki,51,2753900,3397486134828421,399,5415805,3150981,0,3150981
3061,Ernest Nuamah,38,3751400,4747622192085659,365,5769608,1860012,1860012,0
3062,Bram Nuytinck,29,1607100,6077123859403440,171,2322125,1715556,172,1715384
3063,Kelechi Nwakali,42,489800,6309510472489227,149,1353608,182717,18272,164445
3064,Obinna Nwobodo,32,536900,6406852565211169,91,889599,742620,0,742620
3065,Lewis O'Brien,45,715500,9352044389015184,156,1507885,1154490,1155,1153335
3066,Callum O'Hare,66,1397200,7774741270469921,354,3627112,3061990,3061990,0
3067,Dara O'Shea,53,693300,9201886618983309,212,2006099,550984,0,550984
3068,Pedro Obiang,38,4507000,3168879514993624,460,7546013,6606364,0,6606364
3069,Brian Ocampo,49,2083500,8207856845423439,344,3874273,3465096,0,3465096
3070,Denis Odoi,27,4417000,8777932639623696,416,6542720,909861,0,909861
3071,Ahmet Oğuz,35,2071400,8868129259710042,277,3906033,2572388,2572388,0
3072,Caleb Okoli,61,3777900,6281020653463033,583,7399192,2817446,0,2817446
3073,Jean Mota,35,3845900,6941814515227529,394,5714273,711611,7117,704494
3074,Patrick Osterhage,62,2598000,9945322708825644,414,5383980,1843516,184352,1659164
3075,Romulo Otero,67,4426200,5802962700634445,620,8595108,3929230,0,3929230
3076,Dango Ouattara,31,1110300,4428415517250640,141,1709909,915523,0,915523
3077,Rémi Oudin,48,2502700,3138816150196539,399,5126870,363435,3635,359800
3078,Aiham Ousou,47,3374200,9468405352747699,451,6132709,5466813,5467,5461346
3079,Thomas Ouwejan,53,2032700,8780423005295444,382,4512218,391786,3918,387868
3080,Ertaç Özbir,26,3474100,6614114939363661,323,5261529,4713701,4714,4708987
3081,Berkay Özcan,62,442800,7593691744111323,286,2501437,2268701,226871,2041830
3082,Cenk Özkacar,38,4405800,6572450234112575,394,6504074,5126540,0,5126540
3083,Diego Palacios,46,761100,8117565228599925,192,1824396,756735,75674,681061
3084,Antonio Palumbo,56,4201600,6717838781017349,536,7832613,6835439,68355,6767084
3085,Ivor Pandur,23,4048900,6352764861161999,336,5579934,4329338,43294,4286044
3086,Keaton Parks,66,4148400,3741009601294945,629,8688815,4445171,44452,4400719
3087,Pablo Parra,29,2811500,7470578941763931,247,3905023,498702,0,498702
3088,Jamie Paterson,44,2100300,6142662805901755,261,3798331,294807,2949,291858
3089,Nathan Patterson,46,487100,8125207909662846,188,1501405,1268628,127,1268501
3090,Esteban Pavez,44,2365500,9147480519675377,328,4573591,3546587,3546587,0
3091,Ben Pearson,62,2974900,5788025891629640,502,5926040,4998733,500,4998233
3092,Mads Pedersen,30,1487100,5133234914440841,192,2653513,604487,60449,544038
3093,Sebastián Pedroza,38,1655600,7553094096667275,233,2918976,1910605,192,1910413
3094,Dimitrios Pelkas,68,2133200,6259009124813010,465,5092527,3623492,3623492,0
3095,Cristian Pellerano,54,1046100,9977270428684339,236,2365311,286289,28629,257660
3096,Andy Pelmard,68,3404500,7022861032393967,518,7027917,6972776,6973,6965803
3097,Alberto Perea,49,3663300,5011834847977119,477,6064317,191840,191840,0
3098,Federico Pereira,62,994900,4806941102450582,327,3280877,2106079,211,2105868
3099,Mathias Pereira Lage,66,803500,8133151040882120,340,2916165,1903771,1903771,0
3100,Gastón Pereiro,37,1052200,9793542356603216,142,1587162,648488,649,647839
3101,Mario Gaspar,42,624200,8798899243497368,138,1294345,211633,0,211633
3102,Dino Perić,31,2843700,4043834732342519,297,4441209,1901100,0,1901100
3103,Baldomero Perlaza,67,752900,3196884033061390,307,2760712,951711,95172,856539
3104,Luděk Pernica,48,881900,6890522278160729,216,2136995,766337,767,765570
3105,Immanuel Pherai,25,1409600,3851705145926167,114,1792175,209864,20987,188877
3106,Pablo Piatti,45,1794100,5586893607194370,261,3564923,2858709,285871,2572838
3107,Carlo Pinsoglio,36,617000,8214886796039726,125,1201605,881852,882,880970
3108,Miguel Veloso,40,1845100,7943438634732432,225,2815201,1604509,0,1604509
3109,Srđan Plavšić,29,2431100,8289136489629096,228,3392065,564469,5645,558824
3110,Lukas Podolski,46,1215200,9819592590812528,245,2510258,1944213,19443,1924770
3111,Diego Polenta,56,3158500,5702189521448477,430,5422874,4760310,4761,4755549
3112,Sebastian Polter,50,3275900,6517984865926277,453,5693214,699671,69968,629703
3113,Julien Ponceau,63,1925200,5970698300442671,401,4450638,406786,0,406786
3114,Luciano Pons,49,1613000,5028206557396353,304,3365871,759386,760,758626
3115,Juan Portillo,22,1612400,4194138872762706,134,2067897,177874,0,177874
3116,Samuel Portugal,46,2628800,6818839497493610,362,4559390,1085064,108507,976557
3117,José Pozo,22,3979300,4833576736709581,317,5611786,1439172,1440,1437732
3118,Álex Pozo,67,499000,6246403632042207,299,2496217,1798182,180,1798002
3119,Alan Pulido,58,3613500,3846343363693023,486,5990423,2549372,2550,2546822
3120,Mateus Quaresma,42,3672500,5688761254885293,459,6034172,234746,2348,232398
3121,Luquinha,41,1846600,5387760052675378,255,3373404,1302350,1303,1301047
3122,Facundo Quignon,41,3938400,4880041642769504,375,5386827,361451,36146,325305
3123,Jordi Quintillà,45,1922800,5250243275569484,282,3618106,3093558,3093558,0
3124,Nemanja Radoja,26,1718400,9979366385867052,155,2160134,773255,7733,765522
3125,Ionuț Andrei Radu,42,4491100,8465981622319805,533,7769213,7108468,710847,6397621
3126,Carlos Ramírez,25,2858200,5566117727746435,249,4310337,1663796,16638,1647158
3127,Darren Randolph,49,2733600,8588471814420166,415,5211722,1936360,1937,1934423
3128,Luca Ranieri,47,4374600,8359553123901729,497,6894303,6154856,0,6154856
3129,Elbasan Rashani,32,999100,4578947987766062,141,1660112,1480028,0,1480028
3130,Nicolás Ratti,68,4120500,4339063719375475,642,8225077,1105852,0,1105852
3131,Arkadiusz Reca,49,3333200,8616741609891759,487,6233241,453747,0,453747
3132,Jason,37,1822500,5990029380906782,217,2941362,1440243,0,1440243
3133,Emiliano Rigoni,35,738100,8277594896942678,136,1412026,29043,0,29043
3134,Matt Ritchie,46,3458500,8703043297268971,427,5843250,4254017,426,4253591
3135,Jack Robinson,41,1662100,7591663257155687,257,2979514,744904,0,744904
3136,Miles Robinson,57,3227200,9858298171681724,460,6140732,5939843,5939843,0
3137,Enzo Roco,47,2980200,4789077443026726,367,5005050,3272258,0,3272258
3138,Angelo Rodríguez,48,2064300,9446756667699708,367,4273461,2639054,2640,2636414
3139,Santiago Rodríguez,43,584300,5140378943424661,161,1379738,187145,1872,185273
3140,Juan Gabriel Rodríguez,45,2108400,9685123881145162,323,4250343,1874220,188,1874032
3141,Ángel,66,2077200,8644069944382422,385,4893636,1659645,1660,1657985
3142,Yoel,62,2605500,3223494446999640,441,5591271,5344511,5345,5339166
3143,Zaid Romero,58,2317200,8740516105983473,456,5251150,2988708,298871,2689837
3144,Facundo Roncaglia,33,1651900,9190338454599070,205,2607731,2232142,0,2232142
3145,Eloy Room,43,806200,4325045619993343,187,1837246,396922,0,396922
3146,Lazaros Rota,63,4664200,7180730956500556,579,8402785,5968479,597,5967882
3147,Johnny Russell,35,1591500,7140193066211873,227,3083159,1217492,122,1217370
3148,Pablo Sabbag,50,1801900,7342467031826502,344,3920082,719961,71997,647964
3149,Mujaid,32,1327100,9079086993261947,154,2070249,1638381,0,1638381
3150,Osame Sahraoui,48,1960100,3055939143397503,324,3866650,2600300,2600300,0
3151,Fashion Sakala,63,3627000,8059790381256239,467,6873443,5477310,5478,5471832
3152,Tatsuhiro Sakamoto,50,2400000,6265932447999708,375,4423284,2845224,2845224,0
3153,Dániel Sallói,42,1099000,3494672878815127,230,2217631,1437339,0,1437339
3154,Yoann Salmier,27,3666700,3584414639392503,346,5382411,3612127,0,3612127
3155,Mbwana Ally Samatta,44,4879900,6340038629211151,520,8078210,7437739,744,7436995
3156,San Emeterio,28,1319200,4804453195112064,162,2046425,1127893,1127893,0
3157,Adrián,64,746000,5787406855940782,295,2497223,1873566,1874,1871692
3158,Ulises Sanchez,60,434400,7452785987619772,266,2008141,525543,5256,520287
3159,Antonio Sánchez,47,4410200,7192670064086561,505,7459329,1370309,13704,1356605
3160,Kevin Sandoval,43,1322300,5033249111684996,241,2681471,1065935,107,1065828
3161,Carlinhos,26,4925100,6800755188302963,369,6810563,4695578,0,4695578
3162,Ivo Rodrigues,35,1171300,8251133217837234,142,1794353,1222356,122236,1100120
3163,Josh Sargent,63,3082500,4038790933344352,495,6304269,5224986,523,5224463
3164,Manprit Sarkaria,60,3705800,7140229138314407,488,6665967,832797,833,831964
3165,Pape Matar Sarr,61,2709300,3244905357527540,478,5788963,5787829,5788,5782041
3166,Martín Satriano,70,2176100,6581596690147153,479,5650866,5287768,5287768,0
3167,Kevin Schade,37,620100,4128897373335688,150,1334090,278883,0,278883
3168,András Schäfer,24,4606000,6259787435501803,347,6339851,1149819,1149819,0
3169,Louis Schaub,60,4794300,4936874928692354,677,9265366,5320059,5321,5314738
3170,Christopher Schindler,28,3030400,9319544748495011,277,4449815,966406,0,966406
3171,Keven Schlotterbeck,42,3028900,9016590391337435,379,4916564,3465306,34654,3430652
3172,Sebastian Schonlau,64,1980300,7804232559571653,448,4897784,3504028,35041,3468987
3173,Siebe Schrijvers,36,2833500,3840304429432149,333,4962612,1720198,172020,1548178
3174,Alex Scott,32,4683400,3321970628684565,445,6845410,2430888,244,2430644
3175,Paul Seguin,23,3400400,7506278254574279,268,4585746,2012835,2013,2010822
3176,Alidu Seidu,48,1990400,3439154455625740,349,4312648,583750,584,583166
3177,Bruno Varela,67,680000,4562321561542760,326,2880088,1307679,130768,1176911
3178,Jaime Seoane,69,3128400,9078914375143459,495,6453305,2175022,0,2175022
3179,Jean Michaël Seri,31,3037600,4278024667229097,317,5138992,4126633,413,4126220
3180,Leonardo Sernicola,29,3724600,8535818941454704,358,5799283,3098148,0,3098148
3181,Volodymyr Shepelev,68,1594700,8554242622004642,438,4584577,2202043,2202043,0
3182,Eldor Shomurodov,40,2662000,3954301799752346,317,4376501,3007995,0,3007995
3183,Óscar Sielva,33,792900,9257077273034815,162,1564354,562195,563,561632
3184,Carlos Sierra,25,4650900,6912015242840988,333,6789269,5924201,5925,5918276
3185,Francisco Sierralta,26,3792100,9452955663024034,351,5537263,4249282,4249282,0
3186,Kiliann Sildillia,35,2350200,5827889127145830,262,3729386,3043391,30434,3012957
3187,Jonathan Silva,58,3760700,9664216324873009,546,7643287,6751949,676,6751273
3188,Giuliano Simeone,49,4646100,7474793786374328,504,7516118,6489705,6489705,0
3189,Daley Sinkgraven,70,4916300,9276448527438150,669,8648178,8236087,824,8235263
3190,Mile Škorić,43,4302400,3791145508999941,455,7232970,23653,237,23416
3191,Steven Skrzybski,48,1725700,5186266514443131,292,3525718,459071,45908,413163
3192,Marcel Sobottka,30,3471500,3676798063861354,325,5171281,2553684,2554,2551130
3193,Serginho,68,1817500,6581408103486719,423,4456847,4068509,406851,3661658
3194,Yuki Soma,52,4552200,4890646998652524,534,8123414,7086529,7087,7079442
3195,Juan Soriano,45,619400,4915992522234470,177,1576146,1131241,113125,1018116
3196,José Sosa,56,4098100,3363484577774816,542,7714903,3023026,30231,2992795
3197,Dario Špikić,34,3901400,7086399098046181,362,5466314,2568395,2569,2565826
3198,Ross Stewart,34,3682500,4283319021998506,391,6109656,3233144,323315,2909829
3199,Filip Stojković,36,3987600,5446339502797564,376,5840198,508112,0,508112
3200,Jordan Storey,54,4031400,9880000569937160,479,6668264,1552838,156,1552682
3201,Stefan Strandberg,64,2383400,9359098578403825,420,5036654,1504840,0,1504840
3202,Róber,69,680200,8007707077625689,321,2842796,290493,290493,0
3203,Gabriel Suazo,57,1702500,6402038704916555,344,3497682,2557712,2558,2555154
3204,Boško Šutalo,61,1961100,3591716751958343,389,4601671,3028336,30284,2998052
3205,Morlaye Sylla,47,4234800,4025941572831600,468,6964875,2278825,228,2278597
3206,Tan Long,37,1163800,7783150927140523,162,2011577,827401,0,827401
3207,Ao Tanaka,68,3487100,6381203343925027,582,7262047,5003800,50038,4953762
3208,Florian Tardieu,59,2645800,4635609269526824,432,5429352,3435071,0,3435071
3209,Cristian Tarragona,57,1747400,9521561243921367,373,4193640,3722015,3722015,0
3210,Júlio Tavares,22,2823900,9344365090041865,232,3697800,3603933,360394,3243539
3211,Léandre Tawamba,56,4638700,8967769749117422,560,8728810,4012424,0,4012424
3212,Álvaro Tejero,66,1579700,3087416755795320,431,4345004,2040533,0,2040533
3213,Aleksa Terzić,59,2092200,6076725586626779,394,4650447,3276727,3276727,0
3214,Cedric Teuchert,32,2748300,3925904364078644,271,4561083,847428,848,846580
3215,Mame Thiam,56,3324900,4398243047694997,497,6568373,6319390,63194,6256196
3216,Jan Thielmann,26,435600,8632334337637422,77,681470,353403,0,353403
3217,Romain Thomas,32,3656900,8354886982357424,343,5047651,2900614,2900614,0
3218,Phillip Tietz,36,510500,5074385286729981,119,1062779,506163,0,506163
3219,Jeremy Toljan,66,750400,7068870407944554,297,2594872,363785,364,363421
3220,James Tomkins,53,1920400,6659454643373828,335,4212051,610000,0,610000
3221,Daniel Torres,59,886500,8626014673298494,332,3090911,2266828,0,2266828
3222,Ibrahim Traoré,59,2244900,9480309634292744,443,5299679,2501292,251,2501041
3223,Miguel Trauco,31,3413900,5012173254764904,362,5019829,4236504,0,4236504
3224,Lewis Travis,64,3641500,7762720971126281,515,6757642,6153700,615370,5538330
3225,Nicolás Tripichio,23,4359300,7585029939393666,374,6717836,4582743,0,4582743
3226,Fran Tudor,32,2784800,9255334138423043,320,4799847,3855648,386,3855262
3227,Ozan Tufan,66,1717300,5539033826003969,383,3820398,1240951,1241,1239710
3228,Stefano Turati,26,4573500,4031076944077590,443,7341284,5372571,53726,5318845
3229,Oleksandr Tymchyk,32,831400,5618128851413311,138,1498446,491637,4917,486720
3230,Andreas Ulmer,32,4063300,5223765077142104,386,5987168,713458,71346,642112
3231,Filip Uremović,36,1594600,4499625429138873,174,2355537,533297,533297,0
3232,Nuno Santos,56,409200,7030360706035508,212,1812331,1002764,101,1002663
3233,Nicolás Valentini,68,3524700,9875259742453087,547,7430951,107913,108,107805
3234,Alex Valera,65,635200,6002704521306870,313,2638746,1311108,132,1310976
3235,Sepp van den Berg,63,4738300,5488609780165999,629,9064866,7150536,7151,7143385
3236,Siebe Van der Heyden,47,4956200,9571484851544720,561,9098037,6865445,0,6865445
3237,Mike van der Hoorn,45,2000700,8117888348872640,283,3601892,2277532,22776,2254756
3238,Marco van Ginkel,50,4990000,3688031198047685,515,7536164,1270227,12703,1257524
3239,Sydney van Hooijdonk,47,2033200,8659911862430918,333,4122039,1039070,0,1039070
3240,Ricky van Wolfswinkel,64,4084800,6452051404366143,544,7094295,2073276,208,2073068
3241,Matías Vargas,57,390700,6744826618831660,246,1987471,1525648,152565,1373083
3242,Lorenzo Venuti,53,4047100,6334473700586565,485,6819930,61642,6165,55477
3243,Benjamin Verbič,53,3622300,8688759186078448,525,6341560,6184238,619,6183619
3244,Daniele Verde,51,462000,9683910332756900,210,1847217,1442353,144236,1298117
3245,Arthur Vermeeren,32,3909800,8462665383539405,374,5982731,2221860,223,2221637
3246,Yorbe Vertessen,51,2059200,9794951103435881,349,4214006,1058641,106,1058535
3247,Hugo Vetlesen,70,4991400,6417435870864949,653,9191211,2988687,299,2988388
3248,Francesco Vicari,49,4917400,4309921233276253,606,8243908,5833887,0,5833887
3249,Emanuel Vignato,57,697200,3103604992786484,263,2264773,1754297,17543,1736754
3250,Héctor Villalba,35,4500200,5930493507457999,424,6589886,5512506,551251,4961255
3251,Mattia Viti,47,1404200,6925975264245957,297,3258213,1374500,137450,1237050
3252,Mërgim Vojvoda,59,3789600,3869473301150199,480,6809183,6779833,678,6779155
3253,Patrik Wålemark,23,763800,3539711665609304,88,968018,924175,924175,0
3254,Marcelo Weigandt,46,1132600,7704711977332153,233,2657960,1153646,116,1153530
3255,Gaëtan Weissbeck,53,1213700,5585912472511760,293,2920110,530278,0,530278
3256,Timon Wellenreuther,68,320200,4893162796829676,343,2580526,2031674,2032,2029642
3257,Ashley Westwood,41,1227800,6110573335340163,221,2452130,586450,0,586450
3258,Mateusz Wieteska,25,1103700,3267577358521214,91,1438797,478283,478283,0
3259,Brandon Williams,29,4648000,3320987050629830,447,7446937,4717563,471757,4245806
3260,Chris Willock,22,2497900,5480902207922144,237,3428778,84735,0,84735
3261,Cláudio Winck,26,4065800,4228329712954125,367,5874613,1332019,1332019,0
3262,Christopher Wooh,22,4382300,8829250807218550,340,6366504,3763370,0,3763370
3263,Wu Lei,68,2092200,5655108742737529,421,4655801,2530507,254,2530253
3264,Gregory Wüthrich,28,4420700,3515177497528027,436,6987292,3170004,0,3170004
3265,Yan Junling,40,4652200,5835148674542729,477,6969274,421704,4218,417486
3266,Roman Yaremchuk,52,4933200,5562310026157861,614,8972737,2382623,2382623,0
3267,Barış Alper Yılmaz,64,4289100,5340148179270703,611,8819178,4503468,4504,4498964
3268,İsmail Yüksek,60,4137100,3775788303706061,571,7673685,1699853,1699853,0
3269,Alhassan Yusuf,41,3494400,9265042669205350,373,5412966,3264777,326478,2938299
3270,Luca Zanimacchia,28,898700,8377998186008598,125,1411004,1072687,10727,1061960
3271,Cristian Zapata,58,1709100,5287853326013061,375,4141129,1049026,1050,1047976
3272,Giovanni Zaro,22,920800,5512624708758797,55,828873,107487,0,107487
3273,Arbër Zeneli,34,4385000,4327200928549396,446,7396585,5107724,51078,5056646
3274,Matthias Zimmermann,58,2524300,7086005520278484,410,5311817,4918833,0,4918833
3275,Simon Zoller,40,4989300,4600301148818178,481,8166856,5375356,53754,5321602
3276,Peter Žulj,35,2070100,6083952972998968,222,3209922,1053075,10531,1042544
3277,Ali Abdi,61,1463000,6575961777449783,365,3912409,1696650,1696650,0
3278,Ramón Ábila,32,716900,5743637212096240,91,1030293,378607,37861,340746
3279,Mohammed Abu Fani,56,4321000,9285531617931387,546,7776622,5333653,533366,4800287
3280,Bryan Acosta,66,1932000,6981581353706590,430,4768123,3302311,0,3302311
3281,Bismark Adjei-Boateng,63,2063900,9920957209481473,460,5245969,3932690,0,3932690
3282,Felix Afena-Gyan,37,878600,7594003201226732,161,1823839,1659301,1659301,0
3283,Lucien Agoumé,55,4292000,5581110321849089,516,7117613,3801375,38014,3763361
3284,Alan Aguerre,29,1754000,4197551193220538,193,2554984,262002,0,262002
3285,Emanuel Aguilera,56,4566900,7946593874045524,613,9134566,6455777,6455777,0
3286,Juan Felipe Aguirre,54,3538300,5177277933192247,432,5508592,1087997,108800,979197
3287,Firas Al Birekan,69,1491600,7375531169142260,384,4117579,2961043,0,2961043
3288,Ali Al Bulayhi,32,571300,3174263678845648,100,1020489,381056,3811,377245
3289,Abdullah Al Mayoof,69,584600,3308996088426324,328,2612069,2588917,25890,2563027
3290,Yasser Al Shahrani,70,2041900,4222485295825571,435,4760172,1622027,1622027,0
3291,Gabriel Alanís,23,2613000,4714799815118015,209,3721234,2444566,0,2444566
3292,Christos Albanis,64,1243800,6718554919450918,305,3004359,542766,542766,0
3293,Antolín Alcáraz,58,3525900,5564840791578637,502,7001342,6920364,6921,6913443
3294,Romain Alessandrini,34,2375100,5315537859672451,267,3547789,2009329,2009329,0
3295,Oberdan,64,3074400,6330184067183630,528,6585309,2618690,262,2618428
3296,Ignacio Aliseda,44,4344400,8436199243118669,476,7518602,5268319,526832,4741487
3297,Tadeo Allende,37,4646100,9785113991107511,430,6899908,588549,588549,0
3298,Miguel Lopes,33,4617900,9255249521692621,444,7402428,1349394,1349394,0
3299,João Pedro,37,3195700,6775950751444809,331,5107532,2343747,0,2343747
3300,Juan Álvarez,41,2317100,6688280307647014,308,4100790,1920715,1920715,0
3301,Lucas Lima,34,615000,7482224650969506,130,1141548,134151,13416,120735
3302,Emiliano Amor,60,4754000,5606059314424594,548,8409939,184596,0,184596
3303,Mads Juel Andersen,29,3989200,9913785668079511,371,6175841,4513323,4514,4508809
3304,Andrés Andrade,66,1277700,4459796207864419,336,3383974,2783726,279,2783447
3305,Fabrizio Angileri,23,4725100,7325888955873515,390,6840620,5687578,0,5687578
3306,Cristian Ansaldi,53,4879800,3741706772042383,581,7917604,1583199,1583199,0
3307,João Correia,23,3528300,8632632893141127,284,5357614,3022495,0,3022495
3308,Barış Atik,63,2872400,9826578469779522,476,5901794,1255399,125540,1129859
3309,Rob Atkinson,68,3347400,8607435083068073,579,7360569,3147248,3147248,0
3310,Mathias Autret,50,695300,7505077066421871,264,2384626,2197355,219736,1977619
3311,Gastón Ávila,45,4537400,3210856429407005,463,7679981,4730502,473051,4257451
3312,Chidozie Awaziem,30,3791700,5395509741409104,348,5834677,3761677,0,3761677
3313,Jean-Sylvain Babin,66,1233800,3451829651881778,362,3726786,2884122,2884122,0
3314,Baek Sung Dong,44,2866900,8645176278345096,393,4916146,3698483,0,3698483
3315,Javier Báez,51,1408900,6330733891092794,320,3344932,1353088,0,1353088
3316,Lewis Baker,68,4657200,7672936322284321,722,9313092,7568309,75684,7492625
3317,George Baldock,66,1178100,8805059242809793,399,4034488,2212774,0,2212774
3318,Daniel Ballard,33,3999000,5867378794361756,395,6840522,3455920,3455920,0
3319,Josepmir Ballón,37,2041700,8127755966419070,280,3588063,508657,508657,0
3320,Leon Balogun,66,1624700,3844821158333652,390,4115797,1779960,17800,1762160
3321,Tudor Băluță,51,983300,9047583701762562,281,2975004,1389875,138988,1250887
3322,Abdoul Kader Bamba,25,2392800,9708369569213260,221,3174582,2206793,2206793,0
3323,Mattia Bani,40,2014500,5461438357732220,257,3620232,3323023,3324,3319699
3324,Valentín Barco,24,3797000,8819450957791032,353,5689946,4174409,41745,4132664
3325,Juan Barinaga,42,1468600,7830420690100222,204,2478378,1077793,10778,1067015
3326,Aymen Barkok,24,1120200,6296109818716400,97,1351669,288764,288764,0
3327,Daniel Barlaser,27,3683600,9099990271427444,370,6037491,4500778,451,4500327
3328,Ashley Barnes,28,4208200,6069609635289767,320,5317219,4881719,0,4881719
3329,Pier Barrios,22,2890200,6969365003926218,242,3957200,3031554,303156,2728398
3330,Daniele Baselli,36,4953700,7501673445532205,462,7544220,6370798,0,6370798
3331,Christian Bassogog,61,1210700,8612805360242502,319,2996969,2894606,28947,2865659
3332,Gil Dias,55,1253800,3678967687199506,344,3337717,181348,1814,179534
3333,Jelle Bataille,22,4766400,7931910910657380,348,6230037,4567931,45680,4522251
3334,Gavin Bazunu,62,3426000,3858271388928870,479,6502106,1085666,1085666,0
3335,Alejandro Bedoya,41,1814900,7918702913767122,260,3154056,808918,0,808918
3336,Felix Beijmo,42,2744000,6182211631087549,362,4879430,4273029,0,4273029
3337,Amari'i Bell,53,829600,9222988987642633,247,2501087,234034,0,234034
3338,Mohamed Ali Ben Romdhane,54,2870700,3996277876973871,471,5714599,3075832,30759,3045073
3339,Sofiane Bendebka,68,1251200,9929196283620034,402,4012477,253573,0,253573
3340,Gaston Benedetti,50,776400,4345442082691063,200,1847910,860660,0,860660
3341,László Bénes,70,3372600,5606478857637861,548,6759821,5430819,54309,5376510
3342,Jessy Benet,59,2382000,6848280620357106,359,4617188,1122609,1123,1121486
3343,Etrit Berisha,22,1897400,5223062068064801,189,2844188,1477838,148,1477690
3344,Veton Berisha,67,2200300,6559231070329873,482,5426362,1593351,1594,1591757
3345,Matteo Bianchetti,57,3396000,9895978668979352,480,6519803,1954768,195477,1759291
3346,Jake Bidwell,65,1432200,5783084686501660,340,3495552,727889,0,727889
3347,Veljko Birmančević,61,660200,3192691962777043,267,2210269,1269175,127,1269048
3348,Alexis Blin,36,2477900,7152403228647601,247,3592876,452265,452265,0
3349,Daniel Bocanegra,26,1273700,5738810949973644,120,1762137,799449,79945,719504
3350,Yann Bodiger,31,1622800,3606081676161897,189,2790154,559353,55936,503417
3351,Emil Bohinen,34,4481500,8423005193304645,451,7085905,5381411,0,5381411
3352,Nicolai Boilesen,32,3883800,9742241669661899,336,5818198,2138913,213892,1925021
3353,Marcos Bolados,66,1267600,6202951638660599,368,3586968,375,375,0
3354,Franck Boli,53,4060700,6761734032366552,479,6717702,2111638,2112,2109526
3355,Enrique Bologna,66,1561800,9158224069906362,371,3720927,3038051,3039,3035012
3356,Federico Bonazzoli,42,2658100,5444688033341600,319,4452783,2482080,248208,2233872
3357,Toni Borevković,23,1587800,6271048604483271,135,2104752,1672683,1672683,0
3358,Cristian Borja,45,2650600,9159594434406120,371,4923885,4799541,0,4799541
3359,Brandon Borrello,41,4334900,3089335702445211,395,6237823,3992806,39929,3952877
3360,Walter Bou,52,3070500,5383182310828110,438,5677438,5104164,511,5103653
3361,Bilal Boutobba,24,1309000,3442573431743990,129,1753033,578670,5787,572883
3362,Dedryck Boyata,27,727200,4792442982647529,69,846924,551793,5518,546275
3363,Domagoj Bradarić,29,3069800,4539201709661906,282,4243506,4039233,4039233,0
3364,Pedro Rebocho,51,1542000,8677854437441888,309,3498959,2996328,29964,2966364
3365,Chumi,54,4267300,3291742276526516,480,7108509,3448446,0,3448446
3366,Mattijs Branderhorst,35,3759500,8859780443635202,406,6026863,2799035,279904,2519131
3367,Fabian Bredlow,51,3250200,8454080228971751,411,5997839,1601018,16011,1585007
3368,James Bree,63,1448400,7818182245473694,342,3629459,833708,0,833708
3369,Norberto Briasco,35,2848600,4520896824757090,272,4160111,4091455,0,4091455
3370,Dylan Bronn,33,4151000,3820107609702948,419,6646540,3670964,367097,3303867
3371,Brugui,47,681000,3858943011712663,220,2080282,540228,541,539687
3372,John Buckley,60,2612500,4055969940924828,396,4812077,281094,282,280812
3373,Julio Buffarini,57,3431500,3469932462124541,525,6609429,3640098,364010,3276088
3374,Ezequiel Bullaude,38,3941600,4664704306462679,444,6246847,141889,1419,140470
3375,Fabijan Buntić,31,2767200,3070713924016147,315,4852749,1487551,148756,1338795
3376,Cristian Buonaiuto,22,4086200,9503563898495991,338,6024943,4563647,0,4563647
3377,Jack Butland,57,2610200,8262210248429491,432,4917997,2424560,24246,2400314
3378,Brandon Bye,63,2684800,4749710928208752,499,6431612,3200966,3200966,0
3379,Jamie Bynoe-Gittens,27,1137400,5467994819699776,141,1718718,971795,972,970823
3380,Sam Byram,37,2509500,7828846923805634,267,3991996,3073818,30739,3043079
3381,Ben Cabango,38,4564400,5869804884731108,495,7511249,6335387,633539,5701848
3382,Liberato Cacace,38,3302300,6634924520652167,350,4789964,4738404,4738404,0
3383,Martín Cáceres,50,4880900,8373523086006337,536,8698050,2770824,278,2770546
3384,Jhonder Cádiz,63,2905200,4782119427198996,432,6078674,5676271,56763,5619508
3385,Riccardo Calafiori,26,1917000,3882924730203684,190,2791033,474014,47402,426612
3386,Horacio Calcaterra,26,1439200,4185926294492931,140,1976071,844893,0,844893
3387,Francisco Calvo,49,4295600,9839305301719594,502,7198903,4712598,0,4712598
3388,Camarasa,66,3398500,4547231275167375,566,7035702,1984169,19842,1964327
3389,Martín Campaña,48,1763800,3521045318002494,302,3569016,3031713,0,3031713
3390,Fali Candé,30,3768400,6490931891396070,376,6032664,5332513,534,5331979
3391,Cantero,23,3566300,3104615165474194,282,4991570,1009692,100970,908722
3392,Cao Yunding,22,2026300,5821822533986921,146,2424841,771130,771130,0
3393,Pierrick Capelle,28,3873300,4462012153375536,372,6228407,1518488,151849,1366639
3394,Marc Cardona,51,3049200,4432358399936713,462,6069726,2604137,0,2604137
3395,Óscar Cardozo,24,3067600,4548993249288023,273,4607732,403890,404,403486
3396,Patrik Carlgren,33,1510500,6506854158073017,177,2354231,246114,2462,243652
3397,Federico Carrizo,47,2798100,9607116174489466,365,4972645,4371065,438,4370627
3398,Tiago Santos,57,2652000,9616111362579532,411,5404017,4789758,4790,4784968
3399,Giuseppe Caso,41,1402300,4843323885133916,225,2552822,2108392,211,2108181
3400,Fabián Castillo,30,2521500,9114030782636977,259,4183150,1607143,16072,1591071
3401,Harlen Castillo,67,433700,7234810608912609,294,2374840,2335923,0,2335923
3402,Nicolás Eduardo Castro,45,1579400,5775496866373675,240,2892994,276829,2769,274060
3403,Gonzalo Castro,56,4326500,7243239374910291,552,7415843,5011312,501132,4510180
3404,Pietro Ceccaroni,31,3406900,8105747873564100,358,5584782,5274071,52741,5221330
3405,Nathaniel Chalobah,45,4547100,8198109969706358,525,7850000,613599,613599,0
3406,Muhammed Cham,41,3513600,6376102094510409,367,5718417,4023961,4024,4019937
3407,Conor Chaplin,33,4973200,5621921791769243,467,6998834,1622914,162292,1460622
3408,Pep Chavarría,31,4274900,8420614406113622,392,6468077,6293652,6294,6287358
3409,Lucas Cháves,54,4046200,8705527672044850,451,6472575,4886053,48861,4837192
3410,Ignacio Chicco,37,1712100,6378368154085202,204,2887969,2386893,238690,2148203
3411,Vlad Chiricheș,59,863900,5673263540071776,328,2773401,1903640,0,1903640
3412,Tahith Chong,70,3711600,7548610812063359,596,7727046,6535049,6536,6528513
3413,Cyrus Christie,53,3761000,6639607408706131,486,6339273,4941895,4941895,0
3414,Mojmír Chytil,33,4717600,4557878833139768,409,6589466,2462303,0,2462303
3415,Gojko Cimirot,46,2760600,4127722350712815,339,4734938,569391,569391,0
3416,Jordan Clark,66,2719000,9648470528226807,466,5591377,3768522,377,3768145
3417,Zander Clark,53,2113000,6654594618053508,352,4253639,3430448,344,3430104
3418,Matt Clarke,51,446000,3611436582635416,233,1777058,943077,943077,0
3419,Jonson Clarke-Harris,58,1489400,9792378383831568,314,3343897,843150,8432,834718
3420,Matías Cóccaro,24,4055800,5600293053502304,301,5606890,2192061,220,2191841
3421,Alex Cochrane,55,3403200,9975939702088411,447,6104955,2475532,247554,2227978
3422,Marcus Coco,49,3148700,8402111123665158,395,5432707,2924829,29249,2895580
3423,Vitinho,56,4013200,5181410288430530,506,6959768,3389995,33900,3356095
3424,Timothé Cognat,53,4392300,4686057019294986,585,8084401,6393395,0,6393395
3425,Michele Collocolo,24,3937300,7292449427340959,294,5668877,388155,0,388155
3426,Jairo Concha,51,1770100,8447471887564426,337,3604818,2794088,0,2794088
3427,Cheick Conde,61,2614800,3631375946755994,415,5017101,3947074,395,3946679
3428,Michael Cooper,63,1435500,7732789387913183,385,3735904,3613841,0,3613841
3429,Diego Coppola,69,1023700,5824322254264516,378,3339583,2038820,20389,2018431
3430,Córdoba,44,4715100,9226688594481343,498,7823080,1302273,1303,1300970
3431,Claudio Corvalán,52,2449600,8350704654651240,375,4735628,458222,459,457763
3432,Marquinhos,60,1376500,8274559309810959,374,3759820,3755560,376,3755184
3433,Sebastián Cristóforo,26,1360700,4356596176271946,144,1911305,260568,26057,234511
3434,Enzo Crivelli,31,4769700,5520656215830058,429,7474276,6552956,6552956,0
3435,Matt Crooks,68,1772400,3276898596196773,417,4736028,3250809,0,3250809
3436,Michaël Cuisance,55,3913900,7562469356259988,519,6977066,4364266,4364266,0
3437,Antônio Carlos,34,4337000,3686471675105161,409,7048204,3009121,300913,2708208
3438,Nuno da Costa,62,4448300,7879530619423304,601,7883790,7223328,722333,6500995
3439,Lucas Da Cunha,58,820300,9372508355640037,280,2691680,2194773,0,2194773
3440,Rafael Silva,64,4416800,6534272212828969,608,8097215,1439264,1440,1437824
3441,Vitinho,61,4443500,3394318851864433,604,7602494,2825610,2826,2822784
3442,Willyan,55,4177400,3103368923799521,539,7688543,4183040,4183040,0
3443,Henrik Dalsgaard,70,2720800,7929754747311227,507,6128126,5976051,59761,5916290
3444,Toni Datković,28,4579600,4256995812537167,369,7008413,502793,0,502793
3445,Keinan Davis,48,3926800,6930306488774582,436,6689135,4694734,4694734,0
3446,Zeca,32,4697900,4052090703146352,422,7019347,5932251,0,5932251
3447,Konrad de la Fuente,28,737600,8366701165154925,82,994458,289615,0,289615
3448,Miguel,40,3235100,3642645288268694,407,5661602,5386565,53866,5332699
3449,Paulino,62,643500,4449719461997837,247,2032008,750280,751,749529
3450,Artur,59,591700,4471991877275605,277,2176334,1448681,145,1448536
3451,Matías de los Santos,39,3690100,8844191887341669,386,5909428,4775289,477529,4297760
3452,Anselmo,65,1901900,8181107148877801,390,4553869,352674,3527,349147
3453,Casper De Norre,29,3675000,3958856256207437,386,5953673,1704381,171,1704210
3454,Fernando De Paul,23,2382200,9865431881529388,216,3695946,2130522,21306,2109216
3455,Tiago Esgaio,46,3120700,5399164063404325,328,5171278,2542135,2542135,0
3456,Marcos André,26,3056500,4226221058445249,275,4340938,3023354,302336,2721018
3457,Zeno Debast,28,2549600,3816219968805268,253,3787550,1845434,1846,1843588
3458,Harrison Delbridge,41,806400,6478547838377289,219,2181268,585782,0,585782
3459,Jessy Deminguet,34,3021300,5287145420279729,287,4259307,1361817,136182,1225635
3460,Cameron Devlin,38,4469000,9444646034308950,476,7372250,5344990,0,5344990
3461,Francesco Di Mariano,39,3662300,4701387942970583,415,5816804,1623244,163,1623081
3462,Cassiano,43,4224100,9887740731134520,511,6999879,2406300,2407,2403893
3463,Davide Diaw,41,1254800,8090694369812300,188,2403255,1040751,1041,1039710
3464,Thomas Didillon,70,3268100,4438672785957394,507,6526094,2340822,23409,2317413
3465,Seny Dieng,59,3639700,9103002442347723,511,7200764,231545,23155,208390
3466,Daryl Dike,41,524600,6551667294286477,135,1137210,330423,0,330423
3467,Papy Djilobodji,69,4029800,7048615881137257,654,8028878,2160561,2161,2158400
3468,Álex Domínguez,32,1843800,5057446936134881,236,3011990,1123322,11234,1112088
3469,Aron Dønnum,64,4948800,8990201945183273,677,9613950,7029421,7030,7022391
3470,Iago,41,1647700,3534341317085196,265,3072792,1130673,113068,1017605
3471,Alberto Dossena,67,1253700,6921152757439215,409,4202038,1105435,1105435,0
3472,Désiré Doué,31,3807100,4815992229980208,321,5307534,510258,5103,505155
3473,Flynn Downes,48,4937800,9886422945299682,543,8158096,7832112,784,7831328
3474,Callum Doyle,28,3483300,3387493637788449,302,5109532,3736390,0,3736390
3475,Rade Dugalić,59,2689400,5449190909394961,401,5111211,1355701,1355701,0
3476,Milan Đurić,40,1213200,7297370049531072,228,2523314,2080134,20802,2059332
3477,Enzo Ebosse,33,3826000,4871267035901192,372,5768407,2834846,0,2834846
3478,Kingsley Ehizibue,56,1761300,5048769709896954,298,3555030,1499632,1500,1498132
3479,Bilal El Khannouss,34,4739300,6054421211276570,494,7648163,4479326,0,4479326
3480,Josip Elez,61,3692800,5461897304325487,532,6664556,3329270,3329270,0
3481,Elgezabal,31,4365900,7406474671457050,401,5919566,4037243,4038,4033205
3482,Sergi Enrich,66,1379700,3349189064038391,333,3530735,1651406,16515,1634891
3483,Ramiro Enrique,36,4607000,4613248574103279,476,7506515,3790492,379050,3411442
3484,Magnus Eriksson,42,749500,4320081527894082,154,1541655,228619,0,228619
3485,Emeka Friday Eze,35,1346100,3861862657317644,162,2144852,1454614,145462,1309152
3486,César Falletti,25,3687800,9515230796928669,310,4899906,2335230,0,2335230
3487,Federico Fazio,30,1115400,4795584574844296,154,1751306,650011,651,649360
3488,Raúl Fernández,30,1154900,5201785891728500,148,1911761,1355679,135568,1220111
3489,Sofiane Feghouli,30,3312900,7377047693496539,291,4848173,1606417,1606417,0
3490,Gerso,64,2792100,6110373384951037,443,5249230,4597010,0,4597010
3491,Bernardo,46,3039700,6921953211698399,403,5229024,2277497,22775,2254722
3492,Paolo Fernandes,31,4683900,4050459805371848,448,6698593,2309464,231,2309233
3493,Wesley,57,2894600,3212341195914574,414,5426280,3330131,3330131,0
3494,Facundo Ferreyra,36,4121300,9477762744980120,411,6511655,933622,933622,0
3495,Sam Field,29,2426800,9214332272240926,239,3950901,1901752,1902,1899850
3496,Kilian Fischer,64,3490100,5238400062586135,584,7326206,2180396,21804,2158592
3497,John Fleck,56,4891500,4750955592044399,627,9281929,8923004,893,8922111
3498,Jonas Föhrenbach,51,3945400,9431303171082279,559,7559336,1615385,1615385,0
3499,Lamine Fomba,37,3782800,8311823172820823,384,6348539,245217,2453,242764
3500,Martin Fraisl,39,3751000,6073459447596826,360,5599444,2555949,0,2555949
3501,Bartol Franjić,70,2254100,8489726709891651,504,5654271,3742753,0,3742753
3502,Fabian Frei,27,1653400,6293322008786479,149,2297980,1076247,1077,1075170
3503,César Fuentes,56,886100,5571641750179945,273,2570243,1020355,10204,1010151
3504,Jay Fulton,37,3686300,4639822052490102,340,5959542,4954531,4955,4949576
3505,Darnell Furlong,43,3508500,9444001200344847,366,5617564,342744,3428,339316
3506,Gianluca Gaetano,41,3387000,5513241621643220,398,5757714,1027722,1028,1026694
3507,Konstantinos Galanopoulos,28,3858200,9704822399164753,378,5767375,1083103,108311,974792
3508,Antonino Gallo,62,582300,3550981529883238,271,2196280,1003521,10036,993485
3509,Santiago García,33,944600,7474842105962037,132,1468095,1465706,147,1465559
3510,Nicolas Gavory,31,2138500,5367318435374590,222,3062336,585308,58531,526777
3511,Joe Gelhardt,30,2325600,5739597145215462,257,3763816,1508958,151,1508807
3512,Agustín Giay,36,3381200,5444327415679061,375,5616761,4582559,458256,4124303
3513,Daniel Giraldo,46,4666300,9102052564878880,496,7237266,2877427,2878,2874549
3514,Aníbal Godoy,40,2936800,4499140840368879,347,4809231,304887,0,304887
3515,Thomas Goiginger,23,1926600,7164283927096539,174,2781843,1498936,149894,1349042
3516,Edoardo Goldaniga,68,4288200,9166219685562724,620,8350620,7836194,7837,7828357
3517,Alfred Gomis,44,4468700,7822513485185245,467,6702314,3020975,302098,2718877
3518,Pedro Malheiro,69,3345300,8469809098539751,568,6936229,1239074,12391,1226683
3519,Jérôme Gondorf,34,1541300,8095016521606523,181,2361413,397198,0,397198
3520,Luciano Gondou,59,4602900,6313231091371016,606,7985480,3842325,0,3842325
3521,Luis González,58,3827300,5242035730630097,491,6663617,5328845,0,5328845
3522,Giovanni González,47,3503800,5275434002924798,415,6302380,3387576,338758,3048818
3523,Quique,36,4273300,8466459549224931,380,6405646,586577,0,586577
3524,Jay Gorter,70,3535100,3290163493781079,560,7026448,5038362,0,5038362
3525,Gabriel Graciani,65,3099600,4802143474737593,471,5611186,1843852,185,1843667
3526,José Gragera,53,4099500,3591177220569782,544,7284455,2060386,206039,1854347
3527,Karlan Grant,27,1513600,7229947327216142,177,2350660,1129871,113,1129758
3528,Jacob Greaves,61,4620100,3992313676364029,550,7999386,2338633,234,2338399
3529,Dominik Greif,54,704900,4797176649002938,252,2312755,1066361,0,1066361
3530,Albert Grønbæk,48,2779600,7762142196757371,389,4908123,2155130,0,2155130
3531,Ilia Gruev,22,2310600,3716766830830046,191,3262196,408638,0,408638
3532,Robert Gumny,52,3174700,6710035936827700,441,5466061,1225455,123,1225332
3533,Felipe Gutiérrez,58,3368500,8089614284524852,452,6353063,2004424,200443,1803981
3534,Raúl Guti,34,3360300,6794725579179283,310,4862501,1585796,159,1585637
3535,Nicolas Haas,28,2494400,7198203477183693,262,3612696,3401929,0,3401929
3536,Dennis Hadžikadunić,60,4564400,6437129396958886,521,7631636,5325894,532590,4793304
3537,Nikita Haikin,66,2591200,8650415273447276,439,5699908,1072776,10728,1062048
3538,Craig Halkett,35,4292200,6879304754043045,415,7039435,2456904,24570,2432334
3539,Han Kook Young,38,4276300,5398035111306529,433,6630273,6158967,0,6158967
3540,Andreas Hansen,24,849400,4497147464156292,83,1083144,65213,0,65213
3541,Jesper Hansen,49,2729100,4212438909594589,386,5075335,2372902,0,2372902
3542,Jens Petter Hauge,28,1277300,5170984279114182,150,1950834,1584343,0,1584343
3543,Isaac Hayden,64,1932600,3924769103953009,424,4268224,3118919,3118919,0
3544,Dominique Heintz,43,592700,9367845041818156,175,1645664,1371003,1371003,0
3545,Michał Helik,45,3337200,8245799572367873,404,5644508,4737587,4738,4732849
3546,Markus Henriksen,58,4828400,7917067924482664,660,8928840,2569519,256952,2312567
3547,Valentin Henry,38,4817200,6302684575708348,474,7334472,2870258,0,2870258
3548,Onel Hernández,47,2901600,5418637588602568,374,5348118,578664,578664,0
3549,Edwin Herrera,40,726400,8437697521085714,187,1774053,1189475,1190,1188285
3550,Patrick Herrmann,58,4866900,7428244302571581,623,9122419,3111371,3111371,0
3551,Fredy Hinestroza,34,1580800,4860822181971223,214,2682180,474370,0,474370
3552,Andrew Hjulsager,64,3031600,8642571151439481,491,6194675,2044246,2044246,0
3553,André Hoffmann,26,406700,9014645194163638,67,567970,249696,250,249446
3554,Alejandro Hohberg,23,823200,4403673417662173,49,798739,469255,0,469255
3555,Ryan Hollingshead,29,2569100,3373518593588781,243,3653530,1875027,18751,1856276
3556,Sebastian Holmén,53,3209300,4265142882922282,470,6305343,2419038,24191,2394847
3557,Lewis Holtby,63,2665700,6737821285425884,473,5421349,2213332,0,2213332
3558,Hong Jeong Ho,49,934400,9227020688062948,217,2253997,712255,713,711542
3559,Martin Hongla,27,2604600,9142716847593890,261,3744861,3097817,30979,3066838
3560,Tomi Horvat,55,399100,8488176482518749,270,2094733,1085743,109,1085634
3561,Sascha Horvath,69,731000,5696311242951184,314,2768956,1152279,1152279,0
3562,Cédric Hountondji,64,877100,9217948878787112,308,2878030,1168663,116867,1051796
3563,Michael Hoyos,52,2871500,4943380938196212,365,4995589,1670303,16704,1653599
3564,Ajdin Hrustić,47,2845700,4273208655042533,410,5277459,3537264,0,3537264
3565,Shaun Hutchinson,54,3575400,6898946574826693,438,5696006,5128137,5128137,0
3566,Jannik Huth,58,4806300,5374229240837472,523,8068785,4386008,0,4386008
3567,Rareș Ilie,56,2250100,4067163061429934,419,4573504,1327906,0,1327906
3568,Samuel Iling-Junior,46,3822600,5396064286256954,479,6989265,1542668,154267,1388401
3569,Bonke Innocent,48,1402700,7578641136210874,223,2696679,1989878,1990,1987888
3570,Fotis Ioannidis,30,4917900,6325922208877644,434,7378222,894550,8946,885604
3571,Franco Israel,42,3051700,8202100380230160,372,4986459,2173784,217379,1956405
3572,Jairo,62,3272700,6562398843155407,527,6625344,2862155,287,2861868
3573,Mato Jajalo,44,3493000,4440979714347353,370,5734326,358764,359,358405
3574,Tony Jantschke,32,955600,6205928951246219,116,1334183,810906,81091,729815
3575,Ardon Jashari,27,3574100,7589744937443135,364,5204260,2830178,28302,2801876
3576,Bakery Jatta,68,4100800,9177477852228868,548,6933464,2397434,23975,2373459
3577,Elias Jelert,39,4609300,3486834698172724,454,7438280,2992923,300,2992623
3578,Fredrik Jensen,65,4146800,5010740150547448,582,7267949,513214,513214,0
3579,Jeong Seung Hyun,49,901800,4403900485041734,200,1984930,1783260,0,1783260
3580,Jeong Tae Wook,57,4496700,7130269805743754,548,7763902,4709089,4710,4704379
3581,Alexander Jeremejeff,69,2240700,7249179760841007,419,4746783,563611,56362,507249
3582,Viktor Johansson,26,4996000,6750450173641022,390,6886309,657410,657410,0
3583,Marco John,28,3997200,3064714893208254,356,5487179,3194875,3195,3191680
3584,Lasse Berg Johnsen,67,1743100,7332686657068549,435,4730300,4673205,46733,4626472
3585,Erik,50,4285300,5451339427390414,500,7591454,7467223,0,7467223
3586,Sebastian Jørgensen,37,3450300,8319880711171287,412,6073240,1260084,0,1260084
3587,Dejan Joveljić,43,4211000,9949200105763584,495,6928424,5595751,559576,5036175
3588,Lago Júnior,35,982800,4809216006315423,155,1733214,716937,71694,645243
3589,Matěj Jurásek,30,4730900,9133241963616906,468,7323194,5670683,5671,5665012
3590,Christian Kabasele,63,2824900,6793047098789046,482,6170279,834018,8341,825677
3591,Damian Kądzior,51,4621800,6549977935549537,516,7534066,82547,8255,74292
3592,Marcin Kamiński,62,3655600,7504630660719721,596,7429844,1454520,145452,1309068
3593,Ismaël Kandouss,66,2519600,5480754741649203,450,5355564,5146257,5147,5141110
3594,Mohammed Kanno,30,387400,6943405482049747,77,622584,165037,0,165037
3595,Adam Karabec,64,2956200,7366335722016283,479,6090101,5508340,5509,5502831
3596,Mikkel Kaufmann,37,3996900,4338456320565428,363,5671127,874217,0,874217
3597,Hayao Kawabe,43,3585600,7003935997589241,406,5617857,440416,0,440416
3598,Joris Kayembe,30,2240200,5359963716147402,227,3304516,3216771,3216771,0
3599,Edo Kayembe,66,1848300,6688460448432836,396,4483842,2344496,0,2344496
3600,Will Keane,59,1089800,7781040864199041,343,3532332,3061783,3062,3058721
3601,Yannik Keitel,28,3427500,3502389002897328,303,4839246,3009414,0,3009414
3602,Olivier Kemen,25,533100,4165886171630347,87,802913,607231,6073,601158
3603,Tobias Kempe,38,1461500,8343150050629013,206,2650669,1833210,1833210,0
3604,Henry Kessler,62,2772500,6161109019223055,513,6237207,217513,218,217295
3605,Kim Dae Won,42,2727800,7411722844382970,349,5161938,605351,606,604745
3606,Kim Jin Su,57,455600,7533599963801458,236,1939260,623035,623035,0
3607,David Kinsombi,52,546100,4139005072924361,188,1574993,1274530,1274530,0
3608,Otar Kiteishvili,65,1331300,3709345556374074,348,3393357,3023881,3024,3020857
3609,Sonny Kittel,61,3041000,6798231655954825,450,6125929,815603,816,814787
3610,Felix Klaus,58,3935800,7454785378072777,533,6629008,4003390,40034,3963356
3611,László Kleinheisler,57,639700,9271338351779497,247,2087367,797408,797408,0
3612,Jan Kliment,42,3567200,5952127654660962,355,5821763,2766919,2766919,0
3613,Bautista Kociubinski,66,4173700,9567332611546191,627,8176320,5649084,56491,5592593
3614,Markus Kolke,45,2415600,7585815364948142,335,4322013,3106328,31064,3075264
3615,Juan Cruz Komar,50,4051800,6467276633617096,493,7534899,2977521,2977521,0
3616,Giannis Kotsiras,32,1668500,5622371181916781,217,2860226,2081611,209,2081402
3617,Koffi Kouao,63,305800,4915331606136709,288,2086894,1656022,1657,1654365
3618,Anton Krivotsyuk,32,4358600,9866502336911103,397,6093189,2529776,2530,2527246
3619,Nicolas Kühn,51,2810200,9055892304736133,391,5224530,2560647,0,2560647
3620,Saël Kumbedi,66,929000,8452521696893916,302,2884347,2697754,26978,2670776
3621,Solomon Kverkvelia,49,3218100,5040410746941083,457,6096588,4313574,432,4313142
3622,Roman Květ,67,388100,3027677783341268,277,2159689,451267,0,451267
3623,Konstantinos Laifis,68,582700,3473249633332655,311,2615898,953413,9535,943878
3624,Ethan Laird,67,3402700,3620669299023470,543,6508949,3259562,32596,3226966
3625,Sam Lammers,70,4429700,4196591138101992,717,9274784,8482334,849,8481485
3626,Johan Larsson,35,2078700,9404688338298922,205,3125748,2270340,228,2270112
3627,Richie Laryea,50,2656600,6158296999314716,368,4587500,3835312,384,3834928
3628,Kevin Lasagna,34,2099200,7548262266315826,263,3596155,497292,4973,492319
3629,Sandro Lauper,61,3384800,6607232317611533,549,7079389,430898,431,430467
3630,Amor Layouni,64,1190400,6764871087515053,358,3435866,776816,0,776816
3631,Tim Leibold,52,2426100,4359124783329082,384,5137172,3804701,3804701,0
3632,Álvaro Lemos,70,2030500,4953490484248921,498,5273779,755570,0,755570
3633,Timo Letschert,49,629000,3290963622978715,216,1906855,819104,8192,810912
3634,Jamal Lewis,47,3285100,4997322494913083,412,5794534,103239,103239,0
3635,Gastón Lezcano,46,733800,5258148547033063,180,1606118,919746,920,918826
3636,Jérémy Livolant,28,3131400,9328245141552453,276,4468605,3937290,0,3937290
3637,Robert Ljubicic,23,2048400,3439668567657853,183,2930719,630188,0,630188
3638,Danny Loader,36,2476300,9871012397297006,258,3823293,3578342,3578342,0
3639,Marius Lode,41,2298800,7763889682534469,319,3908768,169540,169540,0
3640,Gastón Lódico,50,2135900,5115169760438822,353,4337841,4187979,418798,3769181
3641,Aaron Long,29,1141900,4057104477789939,104,1388813,1113386,1113386,0
3642,Cadu,64,555000,3599184237588548,277,2303053,577411,578,576833
3643,Ricardo Lopes,36,3086600,6533162624650883,277,4390444,1688090,1689,1686401
3644,Lisandro López,60,796500,3832517552417005,261,2250861,1534581,15346,1519235
3645,Renzo López,45,3349100,8208536822459646,436,6152404,4661711,4661711,0
3646,Matteo Lovato,38,3697800,3094199123597368,371,5583242,4084857,409,4084448
3647,Nilson Loyola,42,3108500,5138444116498793,374,5596182,3855880,385588,3470292
3648,Silviu Lung,30,2692300,7329987657667404,268,4446213,3923087,392309,3530778
3649,Arnaud Lusamba,34,3655600,3098988185309689,390,6120193,1354902,13550,1341352
3650,Francis Mac Allister,46,784400,4849331101453309,232,2145452,1651483,16515,1634968
3651,Ramiro Macagno,32,4014600,9180031188634722,355,5984419,3011504,3012,3008492
3652,Koki Machida,42,1885600,4687794267638471,251,3491301,2572996,0,2572996
3653,José Machín,48,4625400,7663252297728235,533,7529689,4748040,4748040,0
3654,Vitolo,23,1085200,3750020107692000,101,1311142,1297741,0,1297741
3655,Mads Emil Madsen,53,2197000,6398420763394279,355,4246330,2888389,0,2888389
3656,Tiago Sá,28,4471800,9610656020961810,428,6611224,4773906,0,4773906
3657,Jonatan Maidana,51,1841100,6780854089421404,294,3701191,3586785,358679,3228106
3658,Habib Maïga,65,4176400,4017608791889771,626,7979103,3053466,0,3053466
3659,Róbert Mak,66,637600,6512433449900757,339,2873170,2604888,260489,2344399
3660,Antoine Makoumbou,51,1221500,7481578254970554,282,2762335,2621428,0,2621428
3661,Lennard Maloney,47,4240900,7647514096720705,548,7705245,7067812,0,7067812
3662,Lucas Mancinelli,62,1374100,6568636660272275,321,3303529,1078224,108,1078116
3663,Million Manhoef,69,2839300,6492574360896979,575,6223953,4050992,4050992,0
3664,Braydon Manu,34,3739300,8273703286465911,369,5637998,5567797,0,5567797
3665,Gonzalo Marinelli,43,2260200,8073721973242062,331,4016464,2829259,0,2829259
3666,Agustín Martegani,32,864500,7038875496281476,100,1148489,652396,0,652396
3667,Mauricio Martínez,59,4878200,4358400610965721,682,8511538,4411886,442,4411444
3668,Fidel Martínez,36,791000,4649796319088381,170,1650753,345484,34549,310935
3669,Damián Martínez,55,589200,7689164389932285,247,2024924,746889,0,746889
3670,Thiago Martins,66,3547400,4158971247683880,510,6693953,6359691,636,6359055
3671,Pedro Santos,34,3021300,4774817370488432,369,4760476,2074479,0,2074479
3672,Gastón Martirena,57,3993800,3814862815315957,503,6912267,6381250,0,6381250
3673,Emmanuel Mas,36,2580100,7450939182303390,311,4605845,3625269,3626,3621643
3674,Andrea Masiello,57,4146700,5688923831490225,534,7688873,997011,0,997011
3675,Rabbi Matondo,22,1945100,3795666046894085,145,2632058,1380630,1381,1379249
3676,Andreas Maxsø,24,1598200,5698766400383251,151,2251455,1304141,130415,1173726
3677,Youssef Maziz,70,3316900,5062079024868078,505,6377004,6040069,0,6040069
3678,Nathanaël Mbuku,37,4710900,3825483536828653,473,7068545,3965252,39653,3925599
3679,Kyle McFadzean,52,3004600,5129351656063649,438,5688654,1505348,1505348,0
3680,Luke McNally,60,4656200,4885822896169899,622,8344124,5011768,5011768,0
3681,Danny McNamara,41,3232400,4154638571787558,371,5297260,2411887,24119,2387768
3682,Maicol Medina,37,2136500,6827403275946707,234,3331748,2679152,2680,2676472
3683,Jan Mejdr,64,3782800,3976565192425756,565,7938051,4427969,442797,3985172
3684,Jérémy Mellot,60,652400,6998640640676506,333,3028722,1541975,0,1541975
3685,Yorleys Mena,63,3074700,6434703152519597,485,6332498,1452819,14529,1438290
3686,Houboulang Mendes,38,1000800,9166180355728496,186,2023836,1395973,140,1395833
3687,Hernán Menosse,29,4870900,4525328787973136,423,6932706,4936306,49364,4886942
3688,Bernard Mensah,65,4592900,7066239303235619,570,7410846,6403332,0,6403332
3689,Jonathan Mensah,58,3822900,8651007872382140,563,7397989,1694432,1694432,0
3690,Chris Mepham,48,1853900,7958737095356650,276,3379320,3271607,0,3271607
3691,Adrian Mierzejewski,57,3065700,5251616533479010,438,6093925,4520347,0,4520347
3692,Valentin Mihăilă,59,519800,3616493113499725,218,1742258,1039231,1039231,0
3693,Antonio Milić,40,877100,5948095571918324,184,1902532,587731,58774,528957
3694,Kamal Miller,31,4476500,4402200327100828,403,6691862,3138417,0,3138417
3695,Enzo Millot,55,2105100,6420784184416234,386,4443541,300094,3001,297093
3696,Alexander Milošević,32,4317900,7977777073593951,385,6441508,2546497,0,2546497
3697,Antonio Mirante,24,3624300,9188281456176904,318,5482547,777508,77751,699757
3698,Kento Misao,69,2339200,8768087443624325,447,4967797,2146047,0,2146047
3699,Samy Mmaee,64,1358200,8101837722321797,367,3628914,3346921,33470,3313451
3700,Brede Mathias Moe,62,1378600,8731866317577423,335,3648452,42477,0,42477
3701,Anuar,64,3197800,8173654760236404,477,6134397,341833,0,341833
3702,Horațiu Moldovan,63,4216000,9705234869965081,622,7747959,4082054,0,4082054
3703,Tobias Mølgaard,41,3665500,8335877062813521,410,5717389,4510045,45101,4464944
3704,Jayson Molumby,34,970800,6430470048322182,144,1573880,1543013,155,1542858
3705,Lautaro Morales,60,4229500,6856857172593179,638,8674851,2721514,273,2721241
3706,Júnior Moreno,22,2573000,7769336756032607,209,3572787,987578,98758,888820
3707,Didier Moreno,64,310900,5553764609532400,314,2285964,2077393,2077393,0
3708,Santiago Moreno,62,1009400,5085315620586791,346,3315495,891370,8914,882456
3709,Stefano Moreo,59,4344500,7125687664977971,533,7838297,3509581,0,3509581
3710,Mateu Morey,57,1403900,6084001181513886,266,3036566,25319,0,25319
3711,Sam Morsy,34,1293300,5343812069159329,203,2412922,395368,0,395368
3712,Dairon Mosquera,51,1128700,9029006051991195,275,3032462,62270,0,62270
3713,Jherson Mosquera,45,4015000,8940197663691359,512,7407813,3691488,36915,3654573
3714,Mosquera,64,1477900,5110201645828125,353,3748605,519486,520,518966
3715,Alex Mowatt,22,3605000,7841406923540373,325,4939104,330276,330276,0
3716,Pelly-Ruddock Mpanzu,50,2946600,3528960143089917,380,5238814,1152084,1152084,0
3717,Bali Mumba,31,1382000,5236855520328179,178,2159327,401607,402,401205
3718,Jesús Murillo,47,3442800,8112414313454159,440,6131192,438668,0,438668
3719,Sei Muroya,27,2175900,4567537990833419,176,3016515,61786,618,61168
3720,Adamo Nagalo,58,1880700,6890836572185889,370,4393883,3457587,346,3457241
3721,Kal Naismith,55,2974000,7333287501036343,435,5427714,2953030,29531,2923499
3722,Robert Navarro,51,1457900,4034957629653839,288,3387322,3131728,0,3131728
3723,Umut Nayir,53,2724600,8996837718985609,405,5223375,1973801,1974,1971827
3724,Tsiy-William Ndenge,54,2706500,5081508498864302,406,4984466,3646878,36469,3610409
3725,Ionuț Nedelcearu,64,2608000,9267542872240737,419,5468862,639750,6398,633352
3726,Jessic Ngankam,31,4148900,3356773387564944,414,6236706,1856029,18561,1837468
3727,Nathan Ngoumou,34,3204700,3515350251177225,338,5205435,1877864,188,1877676
3728,Ibrahima Niane,42,4482200,5706169766299954,447,7420830,3495867,3495867,0
3729,Fer Niño,37,2300600,8287290306214934,261,3936172,3203289,0,3203289
3730,Clinton Njie,22,3989300,3983637507074206,284,5551661,246634,0,246634
3731,Niels Nkounkou,62,2147800,6362062671372547,431,5177495,3642437,365,3642072
3732,Olivier Ntcham,22,3538000,8634988527808625,268,4640904,1126583,112659,1013924
3733,Randy Nteka,34,2414400,6461769441961566,265,3567941,2991108,2991108,0
3734,Marcelino Núñez,33,3837800,3362933725327247,349,5208292,5072095,0,5072095
3735,Christoffer Nyman,47,1338300,3547642670101772,260,2944450,940971,0,940971
3736,Aiden O'Neill,53,300200,4417604639454376,199,1399847,622228,6223,616005
3737,Oh Hyun Gyu,66,2985700,5128865304032084,508,6120320,4907521,4908,4902613
3738,Jores Okore,29,2459400,5117771813615625,245,3488813,224038,225,223813
3739,Darius Olaru,48,547200,3836498474731518,206,1723622,399612,39962,359650
3740,Marquinhos,60,1896600,9101966899210237,389,4493168,2048103,2048103,0
3741,Jérôme Onguéné,32,1403500,5757673426245010,150,2076193,108375,1084,107291
3742,Christopher Operi,24,660400,6077322901205194,58,657623,4111,4111,0
3743,Jerome Opoku,33,2468100,3186400184426852,228,3652926,381283,38129,343154
3744,Nicolás Orsini,51,3137200,3874655905620002,424,6148351,1252279,125228,1127051
3745,Cristian Ortiz,24,3542500,5160654673018033,273,4631638,2211030,22111,2188919
3746,Ben Osborn,66,754900,8298428617835442,321,3014102,982055,0,982055
3747,Sergio Otálvaro,53,3613500,4601501131817559,478,6274123,822530,823,821707
3748,Berat Özdemir,46,3048300,6677236077992647,404,5514028,2764396,0,2764396
3749,Oğuzhan Özyakup,67,3589100,6513511567814596,600,7829434,3336818,0,3336818
3750,Kenneth Paal,69,1740600,7188358922296473,430,4720715,4280799,42808,4237991
3751,Walmer Pacheco,40,1788900,6102149681012012,277,3292720,1267325,0,1267325
3752,Pacheco,70,4194000,3042433683014675,592,7519942,5956123,0,5956123
3753,Daniele Padelli,58,4003200,6665949048844377,556,6974949,5028172,0,5028172
3754,Maarten Paes,38,1369700,4029414570403758,223,2468715,543779,5438,538341
3755,Nelson Palacio,33,2001900,3261054552370234,242,3100786,1843605,1843605,0
3756,Erik Palmer-Brown,59,3693900,6154829511567413,505,6415213,501592,0,501592
3757,Aleksandar Paločević,30,365500,9266182354115684,84,605737,410485,0,410485
3758,Felipe Pardo,52,901100,5324729515288046,213,2217798,1333593,1334,1332259
3759,Park Ji Soo,54,4497800,7502417712385236,584,8158711,5256408,5257,5251151
3760,Park Jin Seob,53,2109000,5166622920885473,346,4322909,1133666,11337,1122329
3761,Anthony Partipilo,46,2451900,6691495122591448,342,4195734,699211,69922,629289
3762,Anthony Patterson,59,1432900,7363685125198427,347,3378757,1898044,0,1898044
3763,Facundo Pellistri,46,3959600,7976014891838799,434,6515495,679612,67962,611650
3764,Patrick Pentz,37,3973100,9067617461201486,443,6168422,5475671,5476,5470195
3765,Ricardo Pepi,43,3388700,9923722403360076,390,5981918,4720176,0,4720176
3766,Henrique Araújo,41,3548800,9523236240487047,419,6206670,1817935,18180,1799755
3767,Matheus Pereira,60,601300,4813982928493596,270,2207217,625356,6254,619102
3768,Fabio Pereyra,69,2048800,9533354090258267,500,5605377,5060926,507,5060419
3769,Pablo Pérez,66,3041800,3077932291588999,529,6955687,1144384,114439,1029945
3770,Hernán Pérez,61,2559900,7545370413819746,477,5761060,3229129,322913,2906216
3771,Martín Pérez Guedes,23,4134200,7904814786656506,325,5343004,2064467,207,2064260
3772,Elvis Perlaza,24,369800,7397095255613327,44,341561,243577,0,243577
3773,Gaëtan Perrin,46,1634400,8756890885850491,246,3224955,772440,7725,764715
3774,Máximo Perrone,67,939600,8339688313158758,351,3366606,2023092,2023092,0
3775,Gino Peruzzi,65,2413500,3337390493254624,443,5194671,3898548,390,3898158
3776,Marvin Pieringer,40,2846400,4288640258286550,370,4826762,4169643,4169643,0
3777,Erik Pieters,23,4343800,6151597680341761,322,5799199,2777755,0,2777755
3778,Samuel Piette,50,4007000,4089373423381735,454,6352541,5238108,5238108,0
3779,Mario Pineida,70,1925000,7685408065346413,414,4992663,892578,89258,803320
3780,Kaio Jorge,46,3509100,8095584427980402,364,5272881,610041,0,610041
3781,Ezequiel Piovi,70,865400,9997856166396371,345,3002239,2124129,212413,1911716
3782,Lorenzo Pirola,24,1491900,7953787654341115,127,2098938,419778,419778,0
3783,Felix Platte,30,1547500,6002674809241645,157,2253330,643903,64391,579512
3784,Ryan Porteous,60,620000,8484235342301504,320,2561227,2473027,0,2473027
3785,Abdón Prats,25,3430400,9926315077581409,267,4348708,2301244,2301244,0
3786,Smail Prevljak,70,1650800,9650731521064562,476,5000468,2680868,2681,2678187
3787,Jack Price,65,3524400,6263191438976674,592,7807429,4846264,0,4846264
3788,Kai Pröger,52,4884700,5404845292308160,647,8388213,5525165,0,5525165
3789,Davy Pröpper,35,4535100,5691291743206337,459,7177307,2746667,275,2746392
3790,Pubill,33,778400,8301067680961701,108,1240573,762482,0,762482
3791,Mateo Puerta,41,632400,6182221177873411,203,1714361,335498,0,335498
3792,Quiles,44,4173100,9514843399516420,522,6990094,5544010,5545,5538465
3793,Jeisson Quiñones,33,4430300,4672111664079434,447,6879763,6731054,67311,6663743
3794,Julián Quiñónes,22,3819400,9475329261986419,342,5970017,4699549,0,4699549
3795,Juan Quintero,66,4737200,5081929647212708,688,8652585,1204048,121,1203927
3796,José Quintero,36,3559600,5498650567101930,410,5971218,3491822,34919,3456903
3797,Piero Quispe,69,3029700,3944361109197386,561,6894457,6707560,0,6707560
3798,Dani Raba,30,3211200,6692247664183129,297,4830426,533593,533593,0
3799,Anthony Racioppi,64,2868700,9363880390539442,507,6349110,3288274,329,3287945
3800,Boris Radunović,62,908200,3193293187039880,286,2811316,1326543,1326543,0
3801,Jesurun Rak-Sakyi,58,4287600,8209114280006906,496,7077196,2738215,2738215,0
3802,Benito Raman,26,1749100,7490703944648668,173,2597093,606998,60700,546298
3803,Juan Ramírez,64,649600,9016778058997885,287,2596212,352418,352418,0
3804,Ignacio Ramírez,68,2704600,9040736511158038,481,5719993,1791602,0,1791602
3805,Juanpe,56,326100,7718729151726512,214,1608143,1006069,0,1006069
3806,Luca Ravanelli,47,2505000,8634885137885732,338,4507969,3874210,3874210,0
3807,Federico Redondo,40,1953100,6660860032974049,247,3480395,854070,85407,768663
3808,Ferro,43,3289800,9129848414955646,384,5920748,4893402,48935,4844467
3809,Pablo Santos,48,1473200,3758350845757734,249,2919170,1606379,0,1606379
3810,Radim Řezník,28,787700,7646550464425462,82,934887,630471,63048,567423
3811,Federico Ricca,31,3991100,8496486463251645,350,5846338,4639229,4640,4634589
3812,Matteo Ricci,63,3174400,8240605988870536,451,5523324,5333647,0,5333647
3813,Renaud Ripart,46,722100,8453018587440069,216,1966886,1244494,12445,1232049
3814,Jesús David Rivas,60,2500100,9130847408683900,434,4909718,3543204,355,3542849
3815,Dmytro Riznyk,67,3014900,3375357582291426,538,6875714,5193691,51937,5141754
3816,Patrick Roberts,42,2374500,6123165163592294,306,4354536,2908960,0,2908960
3817,Kirian,51,1863800,5260302286168594,309,3648450,3637743,363775,3273968
3818,Yonathan Rodríguez,63,3661000,4978080768937668,552,7412438,5878344,5878344,0
3819,Alan Rodríguez,57,1971400,5568329930155119,379,4635486,3759750,376,3759374
3820,Davy Roef,60,3634900,7991406222665496,561,6929428,2605121,260513,2344608
3821,Mads Roerslev,70,938800,3823783387956895,356,3509365,1812920,0,1812920
3822,Marko Rog,67,3650300,3817647279271127,608,7795690,293807,0,293807
3823,Agustín Rogel,36,1379500,5066875868941821,205,2489940,1412626,1413,1411213
3824,Marcus Rohdén,37,2913900,5060164572316180,327,4493630,768,0,768
3825,Ariel Rojas,25,4491900,4264320788901347,386,6904469,5103421,510343,4593078
3826,Maximiliano Romero,70,555500,9000172262112041,372,2986864,1318342,0,1318342
3827,Kelle Roos,36,4140400,5080683590134029,395,6872010,4716014,472,4715542
3828,Iván Rossi,50,3378900,5464112865092872,443,5948762,2916424,0,2916424
3829,Joe Rothwell,37,647200,7867163821455235,152,1408582,1036829,10369,1026460
3830,Patricio Rubio,34,4289900,9242092885996152,402,6909577,5492902,549291,4943611
3831,Miguel Rubio,60,798900,4619974176919535,293,2611275,1229465,0,1229465
3832,John Ruddy,44,4334300,9915247204936502,423,6939786,6445096,64451,6380645
3833,Modibo Sagnan,67,1496200,5710326451169638,383,4020953,182061,182061,0
3834,Borja Sainz,31,2631100,5505799634778701,269,3812415,1058571,10586,1047985
3835,Koki Saito,55,2463000,7796664809718347,414,5361884,5203924,520393,4683531
3836,Hamza Sakhi,28,1856200,4286256338349376,197,2908315,604849,604849,0
3837,Bartosz Salamon,31,4837100,8849254433009385,500,7713268,6384635,638464,5746171
3838,Víctor Salazar,32,2165500,6951242885988460,223,3124330,1130744,1130744,0
3839,Freddy Salazar,29,4724300,5605997479047541,408,6581510,1157713,1158,1156555
3840,Tobias Salquist,49,1989100,4282745005707105,350,4247487,1603181,1604,1601577
3841,Junior Sambia,51,873100,6762878476740924,239,2488009,2017650,202,2017448
3842,Matisse Samoise,47,433200,6036458793165013,171,1380920,308940,0,308940
3843,Francisco Moura,34,1004900,5687914842608184,157,1836474,1462380,146238,1316142
3844,Mario Sampirisi,58,698200,8167230574857447,276,2395373,1519883,152,1519731
3845,Carlos Sánchez,32,4207400,8943212743277550,392,5793415,3567144,35672,3531472
3846,Ricard,24,2749800,6744363238874616,191,3647796,1727552,0,1727552
3847,Arouna Sangante,24,2741100,5187928892452210,280,4312336,4043337,0,4043337
3848,Rúben Fernandes,38,1143200,4698840637894915,201,2113935,1392871,139288,1253583
3849,Aitor Sanz,59,1369300,4208205443507925,293,3238527,342637,343,342294
3850,Marcelo Saracchi,49,621400,6920814615839306,200,1684462,990452,990452,0
3851,Yusuf Sarı,70,3877600,8960735354440847,606,8016652,2296633,230,2296403
3852,Bouna Sarr,69,1276100,8062639869982837,345,3387198,2450528,2451,2448077
3853,Vincent Sasso,61,3795300,7987477652903071,563,7645282,7212685,0,7212685
3854,Joan Sastre,58,2057800,4345718089115481,380,4252240,1606015,1607,1604408
3855,Andreas Schjelderup,28,3330100,8513414088100116,293,5001076,3418243,0,3418243
3856,Fabian Schleusener,57,769700,6294991781264260,270,2523500,1932129,1933,1930196
3857,Niklas Schmidt,43,3831000,3690395142925630,476,6990463,1672293,1672293,0
3858,David Schnegg,37,3837600,9999955004226279,437,6418210,723419,723419,0
3859,Rasmus Schüller,62,798900,5040080169229117,295,2605446,1758009,176,1757833
3860,Simone Scuffet,68,1735100,8868858607772715,451,5050484,1685480,1686,1683794
3861,Mats Seuntjens,60,4110800,6273154833672687,543,7678137,4357448,436,4357012
3862,Shin Jin Ho,25,3823500,6260301616313068,319,5090517,1331398,134,1331264
3863,Otabek Shukurov,64,1049700,7959578632407999,382,3724492,1008632,101,1008531
3864,Abdallah Sima,24,4115300,7814989793023739,386,5712474,3526463,0,3526463
3865,David Simão,39,2201400,4040752075072545,289,3920694,1899709,18998,1880711
3866,Dimitrios Siovas,60,1122900,6536067677554421,288,2769027,218241,21825,196416
3867,Ibrahim Sissoko,22,2562200,6193201631328994,250,3838213,2186644,0,2186644
3868,Tim Skarke,38,1374200,6657991789995290,235,2626557,1043754,0,1043754
3869,Michał Skóraś,51,3541700,9919792842112596,417,5884810,1692165,169217,1522948
3870,Eric Smith,31,1789600,8206038178622534,178,2702602,2234030,224,2233806
3871,Tommy Smith,51,1681400,4412772399468869,325,3654415,725333,72534,652799
3872,Hrvoje Smolčić,58,1899600,5224262215881297,353,3777525,1013243,101325,911918
3873,Brandon Soppy,31,442000,7851672026929633,88,717370,470129,470129,0
3874,Santiago Sosa,66,1521700,9238526378192063,382,3852384,3808370,3809,3804561
3875,Matías Soulé,22,1771500,8431664238198486,126,2252975,944747,0,944747
3876,Hélder Costa,59,844500,9194271058326167,278,2428625,1111080,111108,999972
3877,Kamal Sowah,52,4152000,6507041144695161,533,7123727,973696,0,973696
3878,Ali Sowe,32,3482400,5329323594626667,340,5230804,5088950,0,5088950
3879,Dayne St. Clair,66,1590900,7877613910809815,393,4349654,1167699,117,1167582
3880,Jason Steele,47,3116200,3373402064347516,351,5071121,2595613,2595613,0
3881,Vladimir Stojković,58,2267100,8338436906137096,437,4672414,796819,796819,0
3882,Carlos Strandberg,26,1049400,4321681750269204,123,1580524,1352334,135234,1217100
3883,Callum Styles,60,2905900,5830121955994561,427,5369247,560360,560360,0
3884,Cristián Suárez,34,3517000,4552840477434970,315,5017977,1109916,11100,1098816
3885,Alex Suárez,29,4651000,3343647248465164,387,6479167,5670004,0,5670004
3886,Sam Surridge,33,4497200,6546927504892913,414,7157348,1590988,15910,1575078
3887,Gastón Suso,31,2696500,8958544595463492,253,4036670,24547,2455,22092
3888,Stratos Svarnas,23,4128000,7685450006485378,307,5716001,1348283,135,1348148
3889,Mile Svilar,57,364500,7942205453069107,255,2081140,1109110,0,1109110
3890,Mamadou Sylla,55,3026900,7030845598820771,460,5885334,3857246,38573,3818673
3891,Oleksandr Syrota,54,4761100,3384837855017642,543,8199809,7275279,0,7275279
3892,Tang Miao,28,812100,8513664633244011,105,1141897,555441,0,555441
3893,Iván Tapia,68,4830000,6201538380406997,696,9677104,6852255,68523,6783732
3894,Stanislav Tecl,40,2603700,8963121688735945,292,4049969,2237455,0,2237455
3895,Bryan Teixeira,69,2845900,5624057278491778,534,6303076,4774147,4775,4769372
3896,Mathys Tel,41,4311100,5818727904774089,423,6534944,2926155,0,2926155
3897,Renzo Tesuri,58,3724700,3911482028666335,523,6907230,5358779,5359,5353420
3898,Benjamin Tetteh,50,4882700,4216389113035428,599,8499383,7128384,0,7128384
3899,Isaac Kiese Thelin,35,2109000,5956327392196910,254,3538361,1662359,1662359,0
3900,Brandon Thomas,23,2513000,9650262408440994,220,3656581,471840,0,471840
3901,Erik Thommy,39,2262500,5080507571436088,299,3751444,2643955,2644,2641311
3902,Jón Dagur Þorsteinsson,36,3050900,4114002506403503,327,4745178,835106,0,835106
3903,Mads Døhr Thychosen,35,3147800,7298861390659496,362,5080761,1905479,191,1905288
3904,Frederik Tingager,67,426200,4098128409395304,337,2672148,2548239,254824,2293415
3905,Anton Tinnerholm,27,1579000,8398510429055898,124,2009334,1592542,15926,1576616
3906,Harry Toffolo,54,3194500,6766195310848525,463,5582889,2297383,0,2297383
3907,John Tolkin,44,2135900,7308633585398948,261,3626090,3116253,311626,2804627
3908,Nouhou,41,1223400,7063603399181377,203,2490476,1350301,136,1350165
3909,Lorenzo Tonelli,47,2691000,8905381942845924,373,4940070,3015806,301581,2714225
3910,Ernesto Torregrossa,48,951300,4445245341590057,221,2342157,438402,0,438402
3911,Ahmed Touba,39,2963100,8799656530319159,327,4665355,4139863,0,4139863
3912,El Bilal Touré,29,599700,3864626425708882,85,847235,591968,59197,532771
3913,Conor Townsend,48,2486200,3359839259188799,378,4536747,3627798,3627798,0
3914,James Trafford,23,1921900,6506437688017013,183,2862237,717205,717205,0
3915,Adama Traoré,50,2481700,5373825715308424,363,4559756,2916820,291682,2625138
3916,Luca Tremolada,61,3390900,4910871355662826,531,6923511,3066217,3066217,0
3917,Ruan,24,419000,9139291990213914,63,538139,243047,0,243047
3918,Zlatko Tripić,30,4121600,7062521798265697,397,5829341,4808387,481,4807906
3919,Sondre Tronstad,67,4871900,8457307541101753,625,8782105,1192633,0,1192633
3920,William Troost-Ekong,53,1477300,4147188891385291,321,3387387,1507304,150731,1356573
3921,Franco Troyansky,23,1487400,7729208738207501,98,1813645,817915,81792,736123
3922,Scott Twine,65,3042100,9632709884663135,534,6720889,6658223,666,6657557
3923,Anthony Ujah,56,707800,7460541051326068,304,2507459,773534,773534,0
3924,Jere Uronen,53,2801600,3362935400019201,383,4843859,2496694,2496694,0
3925,Gerard Valentín,34,2589400,7650732005333508,266,4145661,2708657,27087,2681570
3926,Emanuele Valeri,48,2352800,3939825697979617,311,4248512,1493710,0,1493710
3927,Yan Valery,66,2765600,9450014312109853,497,6287791,5347669,534767,4812902
3928,Mattia Valoti,61,1638200,6089672761950941,356,3582641,2354529,236,2354293
3929,Mitchell van Bergen,36,1891800,5608923361254408,237,3005841,2873513,287352,2586161
3930,Jan Paul van Hecke,32,3169100,4560715511477641,307,5025704,1007895,0,1007895
3931,Leonel Vangioni,46,4282000,7932035155045063,442,6903373,1484490,0,1484490
3932,Zinho Vanheusden,62,1938100,6690708160542196,404,4156852,522645,523,522122
3933,Juan Pablo Vargas,34,1818600,3472023021037013,221,2789831,1195726,1195726,0
3934,Jhonny Vásquez,31,901900,6266603041504169,135,1576965,203782,2038,201744
3935,Larry Vásquez,29,4771800,8725864061778112,401,6588405,3024946,303,3024643
3936,Devis Vásquez,38,2600600,7404412310263819,313,4497650,2549234,0,2549234
3937,Luis Vázquez,23,4585200,6747676060247110,347,6550111,6392785,6393,6386392
3938,Jesús Vázquez,61,2802100,7347057747089616,491,5598763,1250635,0,1250635
3939,Stefano Vecchia,60,2961000,9224289188057467,456,5968547,5850403,585041,5265362
3940,Ronaldo Vieira,37,4557200,6546322719278017,428,7188947,6044776,604478,5440298
3941,João Teixeira,35,4082800,9223736636589552,422,6065034,2127447,212745,1914702
3942,Lucas Villafañez,30,4430900,8475780213439368,386,6497103,4960419,49605,4910814
3943,Gonzalo Villar,66,856800,6689124590019997,397,3389149,743451,744,742707
3944,Nicolas Viola,42,4977200,8648867180933709,592,9035008,3599146,0,3599146
3945,Michel Vlap,43,2247800,7563169012655184,276,3575183,2372733,0,2372733
3946,Murray Wallace,44,2748200,7242399486033250,348,4627367,4458968,4459,4454509
3947,Rémi Walter,68,2628700,4537943351035351,483,5936973,4523015,0,4523015
3948,Wang Dalei,23,2125700,9999144545910114,183,3081490,2681859,26819,2655040
3949,Andreas Weimann,37,2339000,9554311760719292,253,3824002,1816327,182,1816145
3950,Tomáš Wiesner,33,1824900,4239011956143476,199,2710806,2113669,0,2113669
3951,Joe Willis,62,3249100,3377296288652715,544,6434704,3014274,3015,3011259
3952,Ben Wilmot,63,311900,5784949552539266,269,1957267,190082,19009,171073
3953,Hannes Wolf,63,4866900,4320588232297674,678,9247798,8391651,0,8391651
3954,Mert Hakan Yandaş,56,3497500,8959799875751993,553,6481734,1125771,1125771,0
3955,Jerry Yates,26,2651600,9042182434257159,231,3806627,305599,0,305599
3956,Leny Yoro,29,316800,5720039018233384,83,553252,351287,35129,316158
3957,Élie Youan,45,2839800,3337356980457904,360,5366050,452995,45300,407695
3958,Alessandro Zanoli,48,2561300,8434114323575698,333,4413533,498578,0,498578
3959,Alessio Zerbin,27,3565100,3588887302182354,355,5301650,864239,865,863374
3960,Jeroen Zoet,41,826100,6762871596006761,206,2094641,1783743,179,1783564
3961,Abdelkabir Abqar,55,1188300,4335290608192080,266,2872949,2120916,2121,2118795
3962,Ragnar Ache,43,993700,8132192588862794,184,1951789,1622037,0,1622037
3963,Lucas Acosta,30,692300,5011515130162497,93,951054,509325,0,509325
3964,Kasim Adams Nuhu,32,1053300,6314202381768929,163,1796761,1273770,127377,1146393
3965,Junior Adamu,33,3587500,6166170211268292,367,5654628,1971225,0,1971225
3966,Sargis Adamyan,22,4359300,8412056254790883,350,6147724,982296,983,981313
3967,Claud Adjapong,51,686600,4164047059251289,197,1911980,1046201,104621,941580
3968,Dapo Afolayan,41,4442800,5151251985003977,478,6924194,2765596,0,2765596
3969,Felix Agu,47,1076300,8973042134004673,231,2507798,1243518,125,1243393
3970,Naouirou Ahamada,64,1576100,9286519976479725,348,3696689,1056223,106,1056117
3971,Lucas Ahijado,61,2543700,8139037796835923,464,5719957,2640037,264004,2376033
3972,Marian Aioani,65,4396600,7398118692650142,585,7926075,4818356,4818356,0
3973,Semi Ajayi,56,2834300,4318493655983818,439,5609982,2644897,0,2644897
3974,Samet Akaydın,47,3284500,8665951848102314,406,5448704,3003710,0,3003710
3975,Ilias,56,2328000,4543359957716146,345,4504602,1327726,1327726,0
3976,Gökhan Akkan,36,3198500,4647331285711399,348,4818998,2650695,2650695,0
3977,Saleh Al Amri,26,4836500,4288381560298089,481,7721824,5932246,0,5932246
3978,Sultan Al Ghannam,42,906400,3004810313398546,172,1780792,292561,0,292561
3979,Sami Al Khaibari,53,872400,5875797608630698,253,2320641,151667,0,151667
3980,Musa Al Tamari,53,1469400,8053334513265541,326,3484494,1081571,10816,1070755
3981,Marc Albrighton,52,3746700,4766810733618469,511,7153386,999481,100,999381
3982,Jordy Alcívar,66,3434400,4260505289519092,557,6544591,1748306,0,1748306
3983,Alkain,29,2686900,6266962951270322,264,4085723,55095,551,54544
3984,Jim Allevinah,33,1776400,9846154704951555,202,2573399,719908,71991,647917
3985,Ricardo Santos,59,3852300,6104457432251885,510,6776864,2576941,2577,2574364
3986,Giorgio Altare,22,2961000,4511652100156190,221,4255745,371203,37121,334082
3987,Viti Rozada,51,2804500,5561960703983605,403,5425479,1925308,192531,1732777
3988,Antony,60,816500,5591149491463745,299,2908523,1108557,1108557,0
3989,Bruno Amione,50,374000,8255172587990175,195,1494620,879679,0,879679
3990,José Amo,62,2137200,7669492719544651,383,4235479,1008276,1008276,0
3991,Mikael Anderson,67,886500,9256481783068840,333,3085451,1274177,128,1274049
3992,Franko Andrijašević,35,4869500,3834935288827523,455,7490875,2289835,2289835,0
3993,Adil Aouchiche,30,1032700,4046238730572755,135,1716220,73842,7385,66457
3994,Julian Araujo,34,2932000,3553656748036664,325,4640929,2031762,203177,1828585
3995,Lucas Arce,37,514500,5930058777668868,159,1317746,56118,5612,50506
3996,Jorge Arias,59,1773700,3748461869032561,393,4599740,2085201,0,2085201
3997,Alexis Arias,60,2941800,6334238361314475,497,6405700,5591878,0,5591878
3998,José Arnáiz,54,4827400,7004008734496034,605,8469454,7216545,721655,6494890
3999,Zoran Arsenić,27,4585700,9391723845348836,369,6887192,4043619,0,4043619
4000,Ahmet Arslan,65,902400,5813567226929749,306,2754447,215432,216,215216
4001,Andrei Artean,68,4267100,3814495995619218,616,8003999,3914244,0,3914244
4002,Joel Asoro,70,2351100,4556542285639482,494,5952659,3683845,369,3683476
4003,Britt Assombalonga,44,3260100,3777898470582225,402,5287035,3483794,0,3483794
4004,Gustavo Assunção,25,2599000,4495705430731289,249,3883255,2851063,28511,2822552
4005,Jani Atanasov,63,1524600,9087781357902467,330,3739107,1491693,1491693,0
4006,Atienza,41,552400,9650237339420106,134,1181284,1038850,1039,1037811
4007,Noah Atubolu,63,1797000,5534684566043468,368,4156121,1561079,1561079,0
4008,Carlos Auzqui,53,2675900,3449288793654155,388,4715524,3693894,3694,3690200
4009,Írven Ávila,23,683500,8138776778982247,81,870160,323026,3231,319795
4010,Paulo Azzi,41,457800,9522818840950444,134,1032210,796340,79634,716706
4011,Volkan Babacan,36,1991900,5820408582124462,263,3218994,2723774,2724,2721050
4012,Juninho Bacuna,31,3521900,9451645578753417,309,5076640,3846900,0,3846900
4013,Aliou Badji,59,4633500,9703631256025348,577,8124089,3683504,36836,3646668
4014,Miguel Baeza,41,683400,8543741119448127,206,1930802,1143229,11433,1131796
4015,Sinan Bakış,32,1699700,8455409766794250,215,2905690,1884231,188424,1695807
4016,William Balikwisha,56,594900,8400142614132766,215,1802220,216233,21624,194609
4017,Alexandru Băluță,35,2353300,8991676929601365,262,3656428,2303667,2303667,0
4018,Lameck Banda,27,3379000,6150615760066179,290,4754012,4722141,47222,4674919
4019,Shandon Baptiste,42,2799700,3297929352597178,361,4974503,766539,767,765772
4020,Tai Baribo,57,1040200,7758883437961369,274,2757467,2337405,233741,2103664
4021,Alain Baroja,43,1733500,5111844140066743,263,3426584,2455002,246,2454756
4022,Álvaro Barreal,36,2614400,8080532112384772,309,4611375,577821,57783,520038
4023,Michael Barrios,39,1241800,8096225257549654,187,2227698,1276913,1276913,0
4024,Filipe Soares,40,4104900,7147784664266508,444,6567068,1369478,137,1369341
4025,Alex Soares,60,4899000,5669270163058086,557,7594433,3600685,3601,3597084
4026,Modou Barrow,56,2978000,9368644297077156,451,5747525,3528273,35283,3492990
4027,Kyle Bartley,55,2336300,3602134289961568,404,4624317,3670685,0,3670685
4028,Samuel Bastien,25,4114900,4625087351217060,370,6116118,3750713,0,3750713
4029,Danny Batth,42,2367900,5653060839545583,280,3884553,2895715,0,2895715
4030,Dylan Batubinsika,48,647700,4300461312815649,209,1938747,738986,738986,0
4031,Daniel Batz,56,1991100,9238308826548108,341,4248672,3003763,30038,2973725
4032,Robert Bauer,37,4964800,9246723371839643,464,7264242,1828109,0,1828109
4033,Dominik Baumgartner,45,4756700,7111357532619976,526,7590707,811944,0,811944
4034,Jon Bautista,52,4695400,6871405397901665,507,7261641,6285887,629,6285258
4035,Vakoun Issouf Bayo,46,1640200,4353390875942114,305,3495303,2060381,207,2060174
4036,Finn Ole Becker,41,4397200,8870587019649707,469,7144131,5844141,584415,5259726
4037,Chris Bedia,68,1282500,6442441319620441,344,3265899,1211109,1212,1209897
4038,Abdelkader Bedrane,26,1955700,4823648618934185,154,2523289,1558359,155836,1402523
4039,Maximilian Beier,40,1609800,7675280962168644,218,2633089,1397954,139796,1258158
4040,Alexis Beka Beka,56,931100,3721364009811186,281,2714366,325020,325020,0
4041,Alessandro Bellemo,63,378800,6897135950019879,288,2169152,1705344,17054,1688290
4042,Ahmad Benali,56,3705300,3780718776003519,497,7080953,3931297,3931297,0
4043,Carlos Benavídez,35,3061200,5525109847323708,280,4799470,413103,0,413103
4044,Leandro Benegas,53,3821700,4746397625672650,519,7643234,6886098,688610,6197488
4045,Oliver Berg,26,3380100,7961760970335799,287,4709897,4183375,419,4182956
4046,Marcus Berg,63,1857500,5226716470225842,452,4846092,2926948,2926948,0
4047,Robert Berić,54,2515300,5352716589485682,402,5088160,4472973,44730,4428243
4048,Álex Bermejo,48,1145000,5366577293488234,250,2585755,1240271,12403,1227868
4049,Bermejo,40,1375900,7954199063741014,235,2842426,1122446,1122446,0
4050,Matúš Bero,26,1978000,9933171180725283,160,2815287,956832,956832,0
4051,Berrocal,39,1756500,3015574682870760,227,2708908,535907,0,535907
4052,Omar Bertel,69,4149100,8240258051692445,615,8126842,793229,79323,713906
4053,Nahir Besara,53,4032900,6344075988090870,467,6803545,1348895,0,1348895
4054,Marcus Bettinelli,28,1892600,7729311524761997,206,2982623,2179249,21793,2157456
4055,Giulian Biancone,70,2634100,9097432754834740,461,5142250,770748,77075,693673
4056,Davide Biraschi,39,2936800,7765044379336937,330,4594315,3059185,0,3059185
4057,Colby Bishop,37,3993300,8681405591929655,456,6377584,5388265,5388265,0
4058,Mariano Bíttolo,53,4472300,7682042208560849,503,7146785,4610981,0,4610981
4059,Stipe Biuk,35,2729900,7753109507233131,278,4066644,537772,537772,0
4060,Lautaro Blanco,34,2849700,6991468360304369,274,4113296,2510524,251053,2259471
4061,Álex Blanco,50,641600,9985635768251057,209,1939955,1321031,1321031,0
4062,Brian Blasi,62,4737300,7409666560509324,575,8443941,561928,0,561928
4063,Latif Blessing,49,2372800,7587167992072986,349,4183773,1181102,119,1180983
4064,Merveille Bokadi,56,884900,7840573884971633,257,2419645,648443,649,647794
4065,Cristian Bordacahar,50,3226800,9211358598839304,408,5515811,864063,0,864063
4066,Jan Bořil,42,4271100,4174770359355734,496,7751138,1841581,184159,1657422
4067,Hugo Boumous,38,1020500,3805146738928789,157,1842405,332260,332260,0
4068,Mehdi Bourabia,37,897100,3952385417807034,154,1709817,1396679,139668,1257011
4069,Sonny Bradley,44,4175600,3802690366062389,481,7612780,655334,655334,0
4070,Robbie Brady,52,2172500,6168428019523940,316,3768055,2266037,0,2266037
4071,Diego Braghieri,67,2819600,9783140230817082,446,5571447,2145473,215,2145258
4072,Tim Breithaupt,48,306500,8650837383068439,194,1544848,1077269,10773,1066496
4073,Mark Brink,27,2703100,8851929203875508,281,4134440,2448762,24488,2424274
4074,Callum Brittain,38,4756500,9212220046632563,465,7304860,2164571,217,2164354
4075,Felicio Brown Forbes,65,669800,8429548981606685,337,2861092,2712308,27124,2685184
4076,Alan Browne,44,4808600,7861342845070054,579,8340744,4122094,412210,3709884
4077,Joe Bryan,59,1910100,3215104887292470,366,4263109,1956960,1956960,0
4078,Ola Brynhildsen,70,842400,7093155869147392,408,3559096,479173,4792,474381
4079,André Bukia,46,497000,4928135287332905,194,1727693,1033455,0,1033455
4080,Onur Bulut,34,485600,8813001829809127,98,911662,773974,0,773974
4081,Andrei Burcă,63,1463500,9844015259628616,377,3798494,1891551,1892,1889659
4082,Guillermo Burdisso,38,3696100,7763457217840406,433,5813950,3124926,3124926,0
4083,Wouter Burger,27,3149000,6992778787056976,293,4974367,4791148,0,4791148
4084,Leonardo Burián,31,2659500,6480393229263850,261,4026780,3101991,310200,2791791
4085,Reece Burke,37,415500,4380068105646717,115,901960,37616,37616,0
4086,Maxime Busi,28,500700,7071685842254176,84,702008,44155,44155,0
4087,Zymer Bytyqi,33,893400,6157103695824616,141,1571311,1003869,1003869,0
4088,Johan Caballero,49,1751900,4954536892431686,294,3568277,87716,0,87716
4089,Alejandro Cabeza,34,3011000,5611721374699970,325,4599295,164512,1646,162866
4090,Gonzalo Verdú,51,847500,8882038677629243,256,2415829,874191,874191,0
4091,Mattia Caldara,37,2566000,5809592296397512,289,4150270,2894483,0,2894483
4092,Franco Calderón,38,2875300,9652967758437287,310,4571130,2620071,263,2619808
4093,Tyrese Campbell,37,466500,3434400695732590,109,897154,459282,0,459282
4094,Maximiliano Cantera,34,1476500,5255208287056330,161,2273090,431998,431998,0
4095,Marco Capuano,45,1370300,4919036651617890,225,2649663,2062679,2063,2060616
4096,Antonio Caracciolo,36,2272700,7749369631520593,274,3650605,3396618,3397,3393221
4097,Andrea Carboni,62,4643000,3540603785242885,647,8888278,4029555,0,4029555
4098,Gonzalo Carneiro,59,2332100,3341559400376133,414,5053269,1721362,173,1721189
4099,Lionel Carole,37,611000,8004926525421284,169,1601295,1175196,0,1175196
4100,Rafael Carrascal,43,3969700,9824384677066205,453,6780924,3894774,38948,3855826
4101,Adalberto Carrasquilla,52,1554900,4879007359653348,339,3437425,2902375,0,2902375
4102,Guido Carrillo,29,461000,8032119123822438,73,602679,589006,0,589006
4103,Rasmus Carstensen,27,4937200,3289039286177192,385,7088812,4760095,476010,4284085
4104,Santiago Cáseres,26,2634900,3992128320445734,249,3929738,411953,41196,370757
4105,Eíran Cashin,40,1903500,3665953248488212,281,3515028,2968367,297,2968070
4106,Michele Castagnetti,48,4233800,4005478838305979,474,6898123,286886,0,286886
4107,Gonzalo Castellani,69,1092200,6049885274366520,347,3404697,3240272,0,3240272
4108,Jesús Castillo,66,2918700,5822996403492105,521,6489400,3884054,0,3884054
4109,Assan Ceesay,69,2115300,9120682253648235,401,4754142,4385440,439,4385001
4110,Ezequiel Centurión,26,584400,7751148073979221,67,668618,585624,0,585624
4111,Luca Ceppitelli,65,448100,9658034286381265,316,2562878,979162,0,979162
4112,Daniel Fuzato,62,3997700,3070528451053348,573,7477449,812515,81252,731263
4113,Adam Gnezda Čerin,25,2039700,5471830628366880,187,3118743,1267208,0,1267208
4114,Mert Çetin,63,566700,5429382192524643,296,2416148,4806,4806,0
4115,Edwuin Cetré,57,3581700,5640893201278222,501,7033424,5206087,5206087,0
4116,Ricardo Mangas,63,2609400,5989152002811807,438,5341708,809269,809269,0
4117,Timmy Chandler,68,576600,4404552256542601,364,3198513,1391536,0,1391536
4118,Anastasios Chatzigiovanis,52,1530200,7489644280108975,319,3555187,1963906,197,1963709
4119,Leandro Chichizola,40,2379400,3740120931713573,326,4337649,1608274,16083,1592191
4120,Choi Young Joon,48,882000,8943611737986310,238,2388857,1053437,1054,1052383
4121,Max Christiansen,33,662700,9128550780562409,104,1016510,19654,19654,0
4122,Dmytro Chyhrynskyi,32,2112100,4369035432861348,237,3359684,2922178,2922178,0
4123,Jhon Cifuente,62,4982300,5409852039196065,612,8628319,6729924,67300,6662624
4124,Ibrahim Cissé,24,2552000,9600470155527982,191,3268953,2296725,0,2296725
4125,Steve Clark,41,4529500,4925261866838290,524,7237217,6452781,645279,5807502
4126,Leighton Clarkson,65,3598700,4673024495341495,558,7218809,5579971,558,5579413
4127,Elias Cobbaut,30,1264400,6675171152979618,134,1753298,87075,8708,78367
4128,Maxime Colin,26,3816900,8143638110592933,382,5549216,2287970,2288,2285682
4129,Lucas Colitto,23,933700,3850789658668144,64,942725,470940,0,470940
4130,Álex Collado,60,1866600,7637311350140453,369,4355703,3087579,30876,3056703
4131,Aaron Collins,56,358000,3121800016616132,238,1904010,1492967,1493,1491474
4132,José Contreras,42,4971400,7270075502571940,476,7752211,5578417,0,5578417
4133,Sébastien Corchia,53,2890800,5322534578245356,422,5254776,769407,770,768637
4134,Kamil Çörekçi,67,2426200,9848836327147666,422,5407488,3379838,0,3379838
4135,Mateo Coronel,52,3234100,7138943874004031,400,5636381,3805751,380576,3425175
4136,Washington Corozo,32,2513600,5524163748768444,233,3791561,3047217,0,3047217
4137,Rober Correa,28,1793500,3752572752130445,200,2651817,2008470,2008470,0
4138,Àlex Corredera,65,3830800,7739392812192034,599,7983817,473953,0,473953
4139,Guzmán Corujo,52,3953500,7600920976562805,482,7150895,3370914,0,3370914
4140,Aldo Corzo,26,4278000,5245336315211649,373,6570669,270482,271,270211
4141,Logan Costa,50,2574400,8818555006093701,384,4619971,3464650,34647,3430003
4142,Gabriel Costa,40,1436200,4245325840628086,232,2902886,756207,757,755450
4143,Matteo Cotali,38,4771800,3734091556000966,430,6482288,5529544,552955,4976589
4144,Gaëtan Courtet,56,4314300,7628643195673076,616,8546481,4261060,42611,4218449
4145,José Crespo,45,4843400,8087628274757606,504,7657603,4143134,4144,4138990
4146,Charlie Cresswell,40,3321400,3321789062801529,373,5433818,3749414,3750,3745664
4147,William Cuesta,22,3804200,7917127963479955,306,5647448,3832895,0,3832895
4148,Joffrey Cuffaut,48,1516400,5838270481569269,283,3243729,1391604,139161,1252443
4149,Jason Cummings,56,507300,9522632100760270,260,2021446,363070,363070,0
4150,Pedro Sá,28,606400,8911003822374559,68,681613,116532,0,116532
4151,Wylan Cyprien,67,4513000,9380194461095805,634,8798691,3770384,3770384,0
4152,Marco D'Alessandro,56,2590300,4442894900043742,404,5449554,2050948,0,2050948
4153,João Gamboa,44,1616700,7849548646593987,257,2896029,2504532,2504532,0
4154,Leonardo Lopes,38,4997400,4142211548986806,478,8316260,1453082,14531,1438551
4155,Gustavo,47,1069100,4945452688215639,231,2287882,1428014,1429,1426585
4156,Mats Møller Dæhli,70,4083300,9096643787125317,590,7985194,7066054,0,7066054
4157,Johan Dahlin,39,3479400,3181710256182731,370,5330405,3775204,37753,3737451
4158,Harry Darling,45,605500,6314055565431979,172,1500292,916632,916632,0
4159,Lukas Daschner,64,3175300,9760440231658212,505,6181128,2693988,0,2693988
4160,Mohammed Dauda,66,3899200,5411882078708431,594,7032163,5097522,509753,4587769
4161,Adam Davies,30,1903400,6863800883824493,224,2967168,2706190,0,2706190
4162,Ulises Dávila,37,1043600,7349493384444537,155,1928986,1394610,140,1394470
4163,Leif Davis,27,2187400,4567007004712922,178,2809621,544754,0,544754
4164,De La Fuente,52,4244600,9138039626278002,490,7586889,1568407,0,1568407
4165,Hernán De La Fuente,54,487800,7703456305998074,218,1927868,1331411,0,1331411
4166,Pedrão,36,1079400,8005563976045027,195,2000741,989494,0,989494
4167,Afonso Sousa,25,2969300,6781117289857068,252,4406384,1947789,195,1947594
4168,Nicolas De Préville,69,4332800,4465471045188182,704,9333047,4392168,0,4392168
4169,Daniel,47,3704800,6798120497118235,486,6904001,4143209,0,4143209
4170,Fabiano Souza,33,4370600,7310689278554156,435,6234830,3529878,0,3529878
4171,Jordy de Wijs,46,2424900,8838201572768427,366,4413733,3868581,3868581,0
4172,Ciprian Deac,35,4749100,7647837552333021,444,7175486,1808366,1808366,0
4173,Del Moral,40,2227000,6113986047857250,280,3657351,3634290,3635,3630655
4174,Mark Delgado,70,2890500,8070614272390220,521,6482206,5610700,0,5610700
4175,Olivier Deman,32,1197400,9397147876734324,127,1767242,1403683,14037,1389646
4176,Muhammet Demir,42,2171900,8396282219095387,296,3682012,1887783,1887783,0
4177,Alec Deneumostier,41,2366200,7075246981323487,354,4411182,3785687,3785687,0
4178,Nelson Deossa,46,1092500,3342942111575474,235,2365635,1125607,0,1125607
4179,Halil İbrahim Dervişoğlu,36,1244700,5633319309989610,171,2105189,583145,58315,524830
4180,Rémy Descamps,39,3681300,3018762843106697,370,5546805,3477654,34777,3442877
4181,José Devecchi,36,4089900,5926607229036774,400,5822661,570737,5708,565029
4182,Valerio Di Cesare,55,4765800,8259689329240527,625,8642745,6733782,67338,6666444
4183,Raffaele Di Gennaro,61,1972600,9869478449732469,379,4639013,1460385,147,1460238
4184,Matteo Di Giusto,67,3849200,5629797493316237,538,7050508,5912271,5913,5906358
4185,Abdoulay Diaby,67,2505300,7364574731362181,458,5658725,3249515,325,3249190
4186,Ismaël Chester Diallo,54,3662600,4444441233538048,463,6883374,133920,13392,120528
4187,Moussa Diarra,64,1676600,8762632214059709,377,4158374,18008,181,17827
4188,Juan Cruz,38,366200,7178184515258867,130,943656,724851,72486,652365
4189,Pedro Díaz,43,1589800,6022957591206924,235,2921824,384794,0,384794
4190,Bakaye Dibassy,46,3763400,7642726035057295,403,5972610,985335,98534,886801
4191,Famara Diédhiou,58,2688700,9391017132146829,468,5840218,5514965,5515,5509450
4192,Kevin Diks,51,3149600,8080285895581197,445,5547063,3228483,0,3228483
4193,Mohammed Diomande,61,3928200,5026092422231208,543,7379811,5204159,0,5204159
4194,Federico Dionisi,46,1291500,8495593260677290,279,2838249,2575960,0,2575960
4195,George Dobson,36,2616100,6425794975718749,302,4391999,231332,2314,229018
4196,Tyrhys Dolan,43,4615300,6939220505277813,484,7358203,1211102,1211102,0
4197,Alfredo Donnarumma,65,2022500,9010732423317265,418,4784870,4463258,44633,4418625
4198,Jonathan Dos Santos,38,3825100,8745281827636093,422,6340226,2800980,0,2800980
4199,Lucas João,59,1442600,4706311106773939,291,3116450,1640937,1640937,0
4200,Daniel Penha,26,577800,8944576245056826,75,722524,366497,36650,329847
4201,Ismaël Doukouré,61,4025700,5147115849635164,529,6904384,4134863,41349,4093514
4202,Artem Dovbyk,28,3073000,9858856080860974,263,4309839,494614,0,494614
4203,Nikola Dovedan,52,2906800,7405273767924913,438,5976710,2074657,208,2074449
4204,Mohamed Dräger,62,923100,8816730086115922,312,2953939,1364630,0,1364630
4205,Radu Drăgușin,67,2889600,3989537587545587,486,5975734,3102301,3102301,0
4206,Cody Drameh,62,701500,4044817382725225,333,2937537,857792,85780,772012
4207,Ibrahim Drešević,62,4960500,6306029887830363,612,8876961,5504587,550459,4954128
4208,Matthieu Dreyer,62,2161200,8532268214598413,365,4569628,2765304,276531,2488773
4209,Josip Drmić,34,3090900,7786829281002015,325,4760692,3533167,0,3533167
4210,Vladyslav Dubinchak,52,322400,7260917287055421,247,2058887,1750039,175004,1575035
4211,Jeremy Dudziak,38,2719800,3169175978063314,284,4200415,3121469,312147,2809322
4212,Marko Dugandžić,39,2242900,8023182309328897,258,3803419,386386,3864,382522
4213,Jimmy Dunne,49,1857300,6508879349407659,292,3461967,54982,5499,49483
4214,Jefferson Duque,53,472400,5166414609246597,215,1834691,1061728,1061728,0
4215,Erik Durm,51,3774500,9494767007496662,472,6764017,55298,0,55298
4216,Lyndon Dykes,22,4589200,9393350031068235,299,5701722,2520746,0,2520746
4217,İrfan Can Eğribayat,31,3315000,4752443486300067,340,5474411,3139200,3140,3136060
4218,Farid El Melali,46,2954600,8172656817316193,354,5010048,2000763,20008,1980755
4219,Eren Elmalı,52,2987900,5823305498805366,394,5004178,1811229,0,1811229
4220,Julio César Enciso,50,2272400,9466304630233356,317,4163249,1698083,1699,1696384
4221,Eraso,60,2504200,6874817439328715,414,4709215,185331,1854,183477
4222,Juan Espínola,43,3943400,5343836123127207,492,7130732,1648234,1649,1646585
4223,Andrey Estupiñán,43,1399400,6402564117051927,248,2801338,1062389,1062389,0
4224,Ched Evans,35,1049400,4305186842468558,164,1786786,1072214,0,1072214
4225,Diego Fagundez,64,935000,7214177726783218,285,2717548,776795,777,776018
4226,Franco Fagúndez,38,3519100,5981828100306093,405,5603954,2952382,29524,2922858
4227,Cláudio Falcão,32,3366300,8246670610780411,358,5372012,2896539,0,2896539
4228,Maximiliano Falcón,56,4507700,8144946102987320,574,7911424,7067715,707,7067008
4229,Mamadou Fall,57,330800,7704295470540189,226,1703818,567825,56783,511042
4230,Wuilker Faríñez,32,400100,6603594665316009,76,636750,221176,0,221176
4231,Kaiky,33,2681900,6585104485562231,323,4439475,2171670,0,2171670
4232,Tomané,62,1616800,9410799651313053,367,3796605,1660931,1661,1659270
4233,Julián Fernández,47,2954400,5839172090926089,424,5235724,1830674,183068,1647606
4234,Matías Fernández,56,1210600,3205473170440553,285,3002418,1908204,1909,1906295
4235,Nicolás Fernández,40,1014500,6705752619369278,208,2232469,1459461,0,1459461
4236,Fernando Fernández,41,3490800,4674880395732500,396,5286231,1361033,136104,1224929
4237,Roberto Nicolás Fernández,47,1909800,7210520281432206,331,3580935,865184,0,865184
4238,Álvaro Fernández,24,1549900,6115083265515516,146,2054369,1507441,151,1507290
4239,Gianluca Ferrari,26,4082500,3064282547359856,325,6114375,4794670,0,4794670
4240,Jota Silva,35,3855500,8251999149812799,388,6109189,2662747,2663,2660084
4241,Nicolás Ferreyra,57,847400,6327164961481816,259,2446650,2237163,0,2237163
4242,Dominik Fitz,49,4350600,7354426706904244,465,7467738,1023863,0,1023863
4243,Edison Flores,55,1492900,4091207728232002,329,3846831,2833451,283346,2550105
4244,Mamadou Fofana,66,1857900,6367755760363792,398,4153884,738712,73872,664840
4245,Moryké Fofana,67,1782000,6226022986466749,416,4161223,2207330,2207330,0
4246,Michael Folorunsho,43,2535600,7016918438171610,321,4199424,860718,0,860718
4247,Fontàs,27,2805500,3334608268699796,232,3764867,749530,0,749530
4248,Carlos Forbs,62,4473400,7117771538394671,617,8154422,676977,0,676977
4249,Marcus Forss,64,2659200,5879098100037678,468,5577707,1939,1939,0
4250,Francesco Forte,69,4046300,7520083186833166,589,8112574,534350,0,534350
4251,Rodrigo Martins,22,2013500,5795806628179480,151,2490268,983392,9834,973558
4252,Iver Fossum,35,952000,4991825495382107,157,1813296,224292,224292,0
4253,Matija Frigan,33,1002100,7776588767345137,131,1585959,1471713,147172,1324541
4254,Ruben Gabrielsen,58,1239100,7320833074525631,344,3434407,1121172,11212,1109960
4255,Pablo Galdames,69,4907600,7474363751683463,695,9350026,5840665,0,5840665
4256,Sam Gallagher,32,3504400,8411025348904498,353,5546306,3305064,3305064,0
4257,Mattheus Oliveira,54,1405300,9650741752293858,291,3233021,2791462,27915,2763547
4258,Lucas Gamba,53,2405700,4257456776014707,358,4491964,4466493,446650,4019843
4259,Fran Gámez,47,2764700,9615472925427291,349,5019574,1898861,1898861,0
4260,Cristian Ganea,61,3624900,7242787298773058,494,6494414,2815041,0,2815041
4261,Diego García,52,4704600,6707976000918873,530,8407156,5166216,5167,5161049
4262,Imanol,65,1682900,5184378584885522,368,3730627,2076266,0,2076266
4263,Juanma García,51,4428600,4960655948644831,531,7809903,1924655,1925,1922730
4264,Óscar Pinchi,27,3393300,6978240666078014,299,5179212,1332678,133268,1199410
4265,Walter Gargano,45,3638500,6954085183256961,387,5636612,1516833,152,1516681
4266,Stefan Gartenmann,38,2601100,7003388510630938,261,3974196,3031376,3031376,0
4267,Jusuf Gazibegović,22,2834100,9966793346463990,252,3837779,719738,7198,712540
4268,César Gelabert,65,4505600,8181938937309096,632,7833889,4768152,4768152,0
4269,Jérémy Gélin,70,3826100,4310306805116826,592,7383880,4941024,4941024,0
4270,Denis Genreau,42,996300,7879100392023970,216,2386588,40448,0,40448
4271,Pieter Gerkens,40,2619700,7903867740506334,347,4785905,2591914,2591914,0
4272,Abdulrahman Ghareeb,47,704900,3841489794902020,214,2003781,1293139,1293139,0
4273,Lautaro Giaccone,33,4268700,3748089302132835,461,6928030,1222551,1223,1221328
4274,Benedikt Gimber,40,3952500,8754783189651030,441,6259361,4107139,41072,4066067
4275,Milton Giménez,34,543200,8808550000444733,115,1100344,169788,1698,168090
4276,Daniel Ginczek,32,671900,8562697326283472,96,1065441,643352,6434,636918
4277,Josh Ginnelly,39,1758100,4322411172183955,225,3005120,1078311,1078311,0
4278,Federico Girotti,65,1456400,7840375749762915,391,4090441,3292673,3292673,0
4279,Goh Young Jun,69,2671800,7710129671020775,462,5544838,3941374,0,3941374
4280,Camacho,64,2556500,9970177056333901,467,5531158,1663013,0,1663013
4281,Gastón Gómez,36,1451500,8469828996726506,194,2384641,417515,0,417515
4282,Roderick Miranda,42,1763400,4042169930167989,278,3344032,2730024,274,2729750
4283,Gastón González,67,1509900,7782562922035832,353,3608964,303166,30317,272849
4284,Oumar Gonzalez,40,912300,6384594741690686,191,1985331,745578,0,745578
4285,Joan González,63,4449500,7337509450643150,621,8147036,5088372,0,5088372
4286,Diego González,39,4208400,6893978722712959,495,6950969,6402655,0,6402655
4287,Borja Bastón,57,1118000,9694342909708726,304,2808367,2660287,26603,2633684
4288,Jaume Grau,51,1403900,4201293963864868,240,2791000,355662,355662,0
4289,Etienne Green,37,1658900,9771301089083129,203,2627225,1836406,183641,1652765
4290,Anto Grgić,42,710600,6091657288754423,185,1779048,327469,0,327469
4291,Andreas Gruber,35,533400,7078809076220315,107,999382,106139,1062,105077
4292,Marc Gual,67,2375300,3480373667250890,415,4953544,2897786,28978,2868808
4293,Guerrero,55,2593300,5104995913159957,385,5175358,174333,0,174333
4294,Evann Guessand,40,2025700,3988960750042930,270,3595288,789751,790,788961
4295,Tomás Guidara,31,2344600,8952448692401529,263,3533507,485851,0,485851
4296,Guima,27,4760200,5137835244974466,374,6756430,4423310,0,4423310
4297,Rafik Guitane,29,3872800,5216068185369439,353,5975158,2946168,2947,2943221
4298,Simon Gustafson,65,4420000,4234582526262730,678,9033531,524178,524178,0
4299,Kevin Gutiérrez,63,3534300,3451066531077064,553,7222005,5846530,5846530,0
4300,Yeison Guzmán,52,2545100,3263560142190682,377,4687488,143379,0,143379
4301,Ha Chang Rae,27,3450600,8584535404788424,279,5143199,1297599,130,1297469
4302,Hayden Hackney,69,372700,9614652476980827,278,2036369,523529,523529,0
4303,Florent Hadergjonaj,68,2050000,3392433947577257,493,5581465,5034259,0,5034259
4304,Kian Hansen,31,989000,6973999634314849,126,1405031,313093,0,313093
4305,André Hansen,36,2563300,4619667250613565,282,4165297,1099552,10996,1088556
4306,Emil Hansson,43,1675100,9895847701517467,277,3385511,2622640,2623,2620017
4307,Hákon Arnar Haraldsson,44,4308500,4779610204867476,546,7518103,1408205,1408205,0
4308,Doğucan Haspolat,39,2826500,8818612250721180,319,4734182,901031,0,901031
4309,Kristoffer Haugen,24,2196300,7460500466879595,152,2469957,723776,72378,651398
4310,Kylian Hazard,60,1369200,9460080550774159,300,2972191,571168,0,571168
4311,Michael Hector,54,4925100,5988288735076574,642,8367303,6325157,632516,5692641
4312,Ryan Hedges,51,728200,7614394874760187,248,2285522,436935,437,436498
4313,Matt Hedges,67,4215800,5805319493886509,659,8411507,7252609,72527,7180082
4314,Niklas Hedl,59,3827100,3295783165827687,519,6887878,2836717,0,2836717
4315,Simon Hedlund,38,1321200,3478855209500896,222,2373537,2315236,2315236,0
4316,Gauthier Hein,38,3039600,8830060074934495,319,4712799,270091,2701,267390
4317,Rouwen Hennings,63,2000500,3289700813926175,413,4567464,118445,11845,106600
4318,Vladimir Hernández,46,628100,9289749264287555,182,1741210,770748,7708,763040
4319,Javi Hernández,36,4811300,4439249777179498,479,8346183,856483,857,855626
4320,Moritz Heyer,70,3951600,6766255834674647,637,8143590,8049182,80492,7968690
4321,Scott Hogan,59,2744600,3647493844150243,436,5456584,1621730,1621730,0
4322,Libor Holík,22,3995600,9091114603915855,347,5971905,332186,0,332186
4323,Emil Holm,36,4171100,5921419286133144,378,6273644,720931,0,720931
4324,Carlo Holse,45,3743400,8273604541293437,415,6596503,6138214,61383,6076831
4325,Gerrit Holtmann,44,3662800,7375029174077829,415,6047432,3859457,3859457,0
4326,Hong Chul,35,4576400,3713102450472012,438,6810915,4638721,46388,4592333
4327,Mathias Honsak,38,4609100,5143220088133069,425,6983201,2441313,2441313,0
4328,Jannes Horn,46,2842600,5996076364577705,406,5315795,3012934,0,3012934
4329,Majid Hosseini,34,3722000,4578731197827233,372,6079640,383236,383236,0
4330,Jonny Howson,62,2945900,3917190764248107,476,6184366,4039600,403960,3635640
4331,Andrew Hughes,50,1718900,3864184494988233,334,3831866,1761025,176103,1584922
4332,Niklas Hult,70,4760800,4466549965029790,666,8577968,4715070,0,4715070
4333,Adrien Hunou,53,1444900,8036835624187392,287,3370805,1112580,1113,1111467
4334,Romario Ibarra,40,590500,6136472713704530,189,1562054,1408891,140890,1268001
4335,Salvador Ichazo,45,2588500,6501725308127274,332,4753503,1247099,1247099,0
4336,Pietro Iemmello,23,4796700,8219261377555295,430,7486705,5815859,5816,5810043
4337,Jesús Imaz,42,2411400,8144876800457431,308,4539448,4402231,0,4402231
4338,Kastriot Imeri,45,3360200,4551586150777706,447,5693099,1697780,1697780,0
4339,Juan Infante,26,1723100,8623819948624533,154,2298434,649663,649663,0
4340,Emanuel Insua,42,4216300,7847139466613982,413,6543557,5923773,0,5923773
4341,Insua,65,377000,9879178020119775,332,2681406,2210446,0,2210446
4342,Andrei Ivan,30,1913500,8317572686667081,195,2943155,916342,916342,0
4343,Lachlan Jackson,70,4681800,8882298459939139,652,8813744,1195993,0,1195993
4344,Filip Jagiełło,69,2013400,8315706975931518,455,4709222,2314628,0,2314628
4345,Ablie Jallow,44,2411100,7783075693596080,321,4383139,3492222,3493,3488729
4346,Robin Jansson,64,1192600,5958028663453706,313,3077352,718485,7185,711300
4347,Leonardo Jara,28,1652800,3426360763432595,171,2416364,402045,4021,398024
4348,Adis Jasic,49,3586500,3416147754061116,468,5949271,4400882,0,4400882
4349,Corentin Jean,50,647100,4802385722330549,185,1751843,885,0,885
4350,Artur Jędrzejczyk,43,3683700,8718416664376019,411,5590512,5535788,553579,4982209
4351,Peter Vindahl Jensen,47,4489200,7294359321001062,451,7127959,2289063,2289063,0
4352,Reinier,30,1771700,6234343447263291,166,2540300,1680069,0,1680069
4353,Jesús Jiménez,27,3982100,8087883209947245,342,5843372,5279580,0,5279580
4354,Dennis Johnsen,45,3100800,7201224105408840,433,5435717,1296160,129616,1166544
4355,Sean Johnson,43,2184900,5910372223662583,310,4153593,1163867,11639,1152228
4356,Daniel Johnson,54,2352700,5835947520427967,365,4417780,4172941,4173,4168768
4357,Filip Jörgensen,46,3296300,9154530532269559,391,6015035,1578066,157807,1420259
4358,Ju Se Jong,37,512800,7921293538087283,170,1533302,859510,859510,0
4359,Simen Juklerød,38,2042400,6545021992273993,250,3100659,1028263,102827,925436
4360,Jhojan Julio,30,1100000,4737388553525646,157,2003145,723171,723171,0
4361,Sory Kaba,66,2401800,7543256310014707,454,5466490,3047492,0,3047492
4362,Hassan Kadish,29,462100,7274762001588619,84,770480,576954,0,576954
4363,Lovre Kalinić,27,2927000,5420439551608502,282,4086439,987402,0,987402
4364,Yayah Kallon,36,2119200,4317394222714500,226,3315774,2820957,283,2820674
4365,Samuel Kalu,70,1757700,9350497129351274,391,4059943,2215999,22160,2193839
4366,Bingourou Kamara,43,4622400,8032884025434042,536,7747798,913539,9136,904403
4367,Kei Kamara,32,4150800,4826009580346289,437,6519832,428647,4287,424360
4368,Takuro Kaneko,69,2943900,9309914166592494,539,6504670,1023610,0,1023610
4369,Kang Sang Woo,47,2919500,5316864801308234,404,5489242,198649,199,198450
4370,Kenan Karaman,26,1220600,6699988275263202,136,1759858,1231217,124,1231093
4371,Erce Kardeşler,67,706200,7952011487436237,396,3483446,1281893,1282,1280611
4372,Mandela Keita,60,2105700,5630224474749174,410,5007850,3733912,3733912,0
4373,Cheick Keita,26,2715100,5042909021611851,256,4006281,2597013,260,2596753
4374,Martin Kelly,56,1792500,7661091361337538,348,3998418,2769515,2769515,0
4375,Reda Khadra,37,2430800,9882119131757308,298,4437479,2487344,2487344,0
4376,Kim Kee Hee,27,4341400,8825370013645430,441,7107409,7000505,0,7000505
4377,Kim Do Hyeok,65,2482600,4231065201451325,458,5295543,1128682,1128682,0
4378,Kim Jin Hyuk,60,4257400,4204532220687764,584,7838152,2100920,2101,2098819
4379,Stephen Kingsley,60,1824400,8996051496751559,369,4128620,2468840,0,2468840
4380,Joshua Kitolano,26,3349200,8007705725980141,266,4620608,2656362,0,2656362
4381,Sofian Kiyine,54,4090200,7921545050540953,527,7089864,3962841,39629,3923212
4382,Philipp Klement,61,4429800,6179929601036825,596,8121960,2811726,282,2811444
4383,Ko Jae Hyeon,70,1858200,3364625949226878,442,4472700,1787728,0,1787728
4384,Moussa Koné,29,499900,5305441391535809,91,783579,105524,0,105524
4385,Ibrahima Koné,56,1041500,5379543714743558,336,3022278,1703094,1704,1701390
4386,Terence Kongolo,59,1771100,6964179719550812,340,3687806,1159521,1160,1158361
4387,Giannis Konstantelias,39,4704300,7593550961363924,472,7562890,4730800,4731,4726069
4388,Leonardo Koutris,36,3867200,9563098878774797,428,5777423,2515343,2516,2512827
4389,Viktor Kovalenko,44,3936300,7808452949982280,427,6102432,886436,886436,0
4390,Kacper Kozłowski,33,1669100,7874075703228913,184,2515627,986052,98606,887446
4391,Kazuki Kozuka,24,2909100,7208581152341867,262,4320736,1450407,14505,1435902
4392,Michiel Kramer,46,1537200,5412935264769755,281,3264683,2232949,224,2232725
4393,Matías Kranevitter,32,3160800,8420903116341249,306,5031888,3348339,3349,3344990
4394,Nicolai Larsen,22,3239100,8819267067031098,299,4428930,2556351,0,2556351
4395,Joaquín Laso,31,816400,3013298396316855,106,1150828,385629,3857,381772
4396,Josh Laurent,65,1887000,9398577508114380,435,4571432,4362684,0,4362684
4397,Julien Le Cardinal,62,2116300,4073526457148400,448,4772556,2284707,2285,2282422
4398,Antoine Leautey,66,2230700,8341958789987703,483,5370261,347582,347582,0
4399,Lee Han Beom,29,3502000,9022845855462668,284,5096988,4037751,4038,4033713
4400,Lee Yeong Jae,52,4512600,4864094605423718,556,7877525,2502935,2503,2500432
4401,Lee Jin Hyun,61,2112200,6835709564585993,384,4312711,3948305,0,3948305
4402,Lee Chung Yong,56,1150100,6549891427402745,274,2795297,2736195,274,2735921
4403,Robert Leipertz,28,4846400,7551066907614667,370,6620113,4382584,438259,3944325
4404,Toni Leistner,46,3905100,9973596427961294,485,6762924,6332415,63325,6269090
4405,Tomás Araújo,32,1258900,8004209823299313,153,1932475,278470,0,278470
4406,Brayan León,36,3458400,7746329388987849,327,5702339,783942,783942,0
4407,Luis Fernando León,22,1870900,4860758910516288,178,2735734,662108,6622,655486
4408,Ryan Leonard,38,1479300,4933429476640692,197,2428518,992658,9927,982731
4409,Oscar Lewicki,68,1037700,7155418528844522,362,3585765,70056,0,70056
4410,Andreas Linde,64,2195100,5234476444560960,432,5403365,226769,0,226769
4411,Liu Binbin,35,1687400,9029958860519431,250,3222312,3128788,31288,3097500
4412,Gautier Lloris,40,2004200,4877779295237761,290,3935360,1271500,128,1271372
4413,Saba Lobjanidze,33,2233800,9605899147874417,236,3550728,2909258,2910,2906348
4414,Joe Lolley,26,4847000,5327500072082182,465,7943020,3326142,3326142,0
4415,George Long,55,3674000,6617119088982920,512,6946015,1519188,151919,1367269
4416,Santiago Longo,59,3893700,4659354348065772,524,7118494,3672131,367214,3304917
4417,Pablo López,37,2726900,4793656719226163,271,4103752,496339,4964,491375
4418,Julien Lopez,45,4918900,8862864000208051,508,7662725,7363852,73639,7290213
4419,Marcos López,28,2876600,7899979996759117,259,4314186,2667746,267,2667479
4420,Lluís López,54,808100,3910294404425339,262,2419713,717367,0,717367
4421,Jhilmar Lora,42,1449300,7598048107591163,239,2815366,637639,637639,0
4422,Daniel Lovitz,52,1561700,3350860696079651,302,3171947,682555,683,681872
4423,Jamal Lowe,54,3091300,6201175989642172,401,5486314,754854,0,754854
4424,Leandro Lozano,47,2523600,9994316167913879,339,4564473,4164819,0,4164819
4425,Gustav Ludwigson,47,747600,9016837251708304,200,1925832,734832,0,734832
4426,Gonzalo Luján,25,650600,5271640027830003,70,744544,729689,0,729689
4427,Joe Lumley,60,3379600,8040554946773552,519,6736965,3414232,0,3414232
4428,Fabian Lustenberger,58,1451600,4219376455369320,303,3247450,919700,0,919700
4429,Lefteris Lyratzis,52,1145800,9409175419383092,258,2732761,2561083,2562,2558521
4430,André Ferreira,52,566700,4322832779393182,236,1997737,1954826,1955,1952871
4431,Matej Maglica,66,986500,9129055418964861,354,3106713,2235017,22351,2212666
4432,Raffaele Maiello,46,332800,7356516320345672,156,1202234,891281,891281,0
4433,Radosław Majecki,59,2060300,6884896383085479,399,4601631,346339,34634,311705
4434,Cephas Malele,31,3102100,5572860717470562,316,5091511,5088233,509,5087724
4435,Yunus Mallı,48,1681800,5735565240098056,269,3201887,796705,797,795908
4436,Facundo Mallo,46,3510600,7124411335414382,429,6099241,4734829,0,4734829
4437,Maurice Malone,60,2464100,3702011346318554,460,5267853,4222945,422295,3800650
4438,Leonardo Mancuso,25,2412400,9806812644791217,169,3012896,624994,6250,618744
4439,Anthony Mandréa,31,951300,4358442079800746,148,1582202,1180648,11807,1168841
4440,Thomas Mangani,34,2388100,6603094990965620,253,3655158,1662241,0,1662241
4441,Myziane Maolida,62,1547400,3737699756195071,349,3705977,1623101,16232,1606869
4442,Sékou Mara,50,1745600,4635056026609719,299,3330376,2707468,0,2707468
4443,Nikola Maraš,65,4484100,5250038169204708,596,8638542,2308,0,2308
4444,Vincent Marchetti,43,595100,4690195763295088,166,1464186,37543,0,37543
4445,Emiliano Marcondes,44,1241000,8756342111856728,235,2356486,1620893,163,1620730
4446,Diego Mariño,58,4501100,9655168276405187,558,7610949,1072442,108,1072334
4447,Oscar Taty Maritu,28,400900,6449495687016056,82,640152,600591,0,600591
4448,Iván Márquez,41,2975000,4822218553248450,322,4462444,682016,0,682016
4449,José Mari,60,811100,6160470248680739,294,2625745,2168296,2169,2166127
4450,Javi Martínez,67,2192900,3365261528303482,506,5854962,4778110,4778110,0
4451,Álex Martínez,54,353200,9709721077650588,209,1661848,646685,64669,582016
4452,Ángelo Martino,47,4145400,4082450408141459,422,6933279,1240158,12402,1227756
4453,Iván Martos,70,3504200,5795370647883041,592,7330702,1126649,1127,1125522
4454,Aleš Matějů,28,1315300,8150889236729095,130,1628382,196022,19603,176419
4455,Facundo Mater,58,2102900,7882486976010703,381,4609497,1009596,1010,1008586
4456,Marc Mateu,48,3334700,6242574502803184,384,5472909,9282,929,8353
4457,Uroš Matić,52,4945300,6032803182918883,560,8468656,1548947,1548947,0
4458,Henning Matriciani,40,3064300,3231210620090875,367,5020019,2381796,0,2381796
4459,Chrislain Matsima,52,3780300,5403477957528354,491,6681550,1916096,1917,1914179
4460,Mamadou Mbaye,34,2479100,3519308175706608,309,4097686,2274396,0,2274396
4461,Isaac Mbenza,60,798400,7491881887853323,287,2701039,574263,5743,568520
4462,James McAtee,33,2372200,8663327093053719,238,3737868,1944268,1945,1942323
4463,Sam McCallum,55,4986800,8440760480831424,557,7737401,289331,28934,260397
4464,Ali McCann,35,1827700,9852341007496996,190,2642016,2460108,2460108,0
4465,Dax McCarty,45,3774700,3225558338152745,454,6850779,989826,98983,890843
4466,Ross McCrorie,68,2958800,3595485612542575,531,6919019,1909027,1910,1907117
4467,Flavio,51,1184300,4576099549725482,282,2771533,1939697,0,1939697
4468,Alejandro Medina,52,2799700,5206316479589801,364,4641104,2344940,23450,2321490
4469,Yakou Méïté,22,4696200,8928186665304924,415,7204394,5515238,552,5514686
4470,Marcelo Meli,57,1653600,4728697885851763,371,4139703,3866868,387,3866481
4471,Dario Melnjak,40,1486400,5854822583191828,226,2627749,239078,2391,236687
4472,Armando Méndez,55,4784400,5735028762862395,635,8496037,4605784,0,4605784
4473,Jérémy Ménez,45,3032900,8289297603788882,329,4633861,950008,0,950008
4474,Gideon Mensah,52,1684300,5744225242942683,319,3303525,2143979,215,2143764
4475,Meseguer,28,4027500,9135830294275930,336,5267080,4982711,499,4982212
4476,Karol Mets,61,496800,3163041341212095,250,1993361,1680018,168002,1512016
4477,Melle Meulensteen,45,516600,9887198636770501,148,1316307,774899,0,774899
4478,Eric Meza,55,3722600,9019100185741174,477,6727058,2511857,2512,2509345
4479,Giannis Michailidis,68,4466800,5624335490173348,632,8753811,5674900,567490,5107410
4480,Pedro Mendes,70,4052200,3253094331335271,584,8022892,7960929,79610,7881319
4481,Bojan Miovski,59,1312800,9338226024931606,311,3138898,3067110,0,3067110
4482,Ignasi Miquel,68,1414400,4131067996065312,401,3770948,1614698,16147,1598551
4483,Ignacio Miramón,28,1319900,5225700945697101,162,2109954,1488546,1489,1487057
4484,Koji Miyoshi,54,1740700,9193164010239660,356,4047876,3719726,3719726,0
4485,Filip Mladenović,31,2181500,4168997245483490,226,3046760,2385041,238505,2146536
4486,Ryan Mmaee,44,4888700,7572493396235993,542,8424269,1955015,196,1954819
4487,Sadegh Moharrami,47,4798300,4702866283987640,518,8106787,5779775,578,5779197
4488,Tobias Mohr,67,1244700,7518670927873517,362,3737052,444629,444629,0
4489,Mollejo,31,4682700,8721118700142809,420,6968721,5242105,5242105,0
4490,Walter Montoya,42,4496300,4709184748790425,466,7336107,6714576,671458,6043118
4491,Alfredo Morales,48,2412500,6491729384636309,349,4256158,2632971,263298,2369673
4492,Jon Morcillo,66,2018300,3122294740641444,381,4333504,2947908,2947908,0
4493,Paulo Estrela,48,339700,8376265427455260,222,1589550,1169205,11693,1157512
4494,Sávio,56,4011400,9824948157023322,497,7125356,6014236,0,6014236
4495,Víctor Moreno,46,4569400,7829114968716749,513,7751467,7515108,752,7514356
4496,Marcelo Moreno Martins,45,1861000,5500874395812969,272,3261410,2303177,2303177,0
4497,Aidan Morris,62,4794400,5805323543526561,612,8239237,6018649,601865,5416784
4498,Olimpiu Moruțan,51,2329900,7032517098691585,365,4577459,1219341,1220,1218121
4499,Rafa Mújica,54,4394100,4364176658063506,533,8296193,7479916,747992,6731924
4500,Jackson Muleka,43,876500,8002862124509456,204,2035411,1272362,1272362,0
4501,Jannik Müller,42,527400,3314762037214208,146,1369242,251981,25199,226782
4502,Abdul Mumin,68,3266200,3138246059920304,545,6766232,1349801,135,1349666
4503,Radosław Murawski,43,4099200,6506533695826941,462,7094386,1335158,1336,1333822
4504,Thomas Murg,41,3817800,6284404619187437,412,5715070,3808783,3809,3804974
4505,Damián Musto,26,3549900,9311396595983560,314,4697025,3693983,3694,3690289
4506,Junior Mwanga,65,3750700,8581616262359471,622,8217048,3355317,0,3355317
4507,Andrey Santos,42,720100,4209949279533179,208,1868160,641980,641980,0
4508,Mickaël Nadé,59,2219300,3049374637471309,423,5215427,4812227,48123,4764104
4509,Juan Ignacio Nardoni,26,1671800,8139875181883290,138,2244615,602572,603,601969
4510,Alassane Ndao,50,778800,9504136221869455,254,2379770,1503948,15040,1488908
4511,Dan Ndoye,48,2758800,8591738073860170,351,4580421,3933203,394,3932809
4512,Sean Nealis,60,2398500,8317399088564377,401,4699474,3985021,39851,3945170
4513,Loïc Négo,64,1185500,4268810281941096,297,3002070,1353120,1354,1351766
4514,Dan Neil,27,1466400,4626205940593367,156,2108804,264742,2648,262094
4515,Phil Neumann,26,1348000,7275015136461221,121,1790470,759294,759294,0
4516,Roman Neustädter,52,4194100,7190123761470588,487,6906369,6728637,0,6728637
4517,Filipe Ferreira,55,3368600,6251855328572017,426,5795053,833408,83341,750067
4518,Ivan Nevistić,53,3005800,7932511517102243,389,5103914,4587182,459,4586723
4519,Joe Newell,34,3242700,4144101511481352,340,5375693,130103,13011,117092
4520,Yvan Neyou,40,1883300,6238382596268364,233,3017659,2852557,2852557,0
4521,Jeremy Ngakia,70,2697900,9086040839808329,499,5765758,2340886,235,2340651
4522,Håvard Nielsen,48,3821300,9830410378863157,402,5981521,2083797,0,2083797
4523,Riad Nouri,42,4612600,3151973822114580,532,8498883,7003133,7003133,0
4524,Bartosz Nowak,29,865000,4547629617945309,109,1316114,829856,82986,746870
4525,Miguel Cardoso,67,3724800,5540708824536181,591,7767983,1064679,106468,958211
4526,Callum O'Dowda,39,1541800,5423195971726176,228,2684552,1735316,173532,1561784
4527,Jay O'Shea,54,1872100,8502255026983787,328,3768241,3697711,370,3697341
4528,Lawrence Ofori,58,1409700,7825567681814040,317,3542682,86095,0,86095
4529,Chiedozie Ogbene,30,4980800,7110473360380197,453,7723699,5365680,5366,5360314
4530,Florent Ogier,29,4150800,9347574483256647,415,6469695,4197860,0,4197860
4531,Braian Ojeda,62,441800,6410184373684938,306,2621150,1530238,153024,1377214
4532,Chima Okoroji,46,3714600,4351058730650130,424,5887220,2226035,2227,2223808
4533,Maduka Okoye,25,2876000,5511925911705231,233,4072883,983066,0,983066
4534,Kiko Olivas,26,2104000,4435440509846438,218,3092956,3075182,0,3075182
4535,Jorge Fernandes,47,468500,3970484460109438,161,1419428,1225314,122532,1102782
4536,Kenneth Omeruo,49,2526600,7696716181516172,342,4634604,2123707,2123707,0
4537,Andrew Omobamidele,63,3991400,4598820328507165,572,7280325,3096946,0,3096946
4538,Ado Onaiwu,22,2163000,3600758841682546,192,3192655,2378203,0,2378203
4539,Nicolás Oroz,66,1639600,9886980413592473,381,3967148,923461,9235,914226
4540,Kevin Ortiz,68,4442000,5425251251906146,722,9409039,2839140,284,2838856
4541,Joao Ortiz,46,4360900,4315759433038612,528,7609369,6871357,688,6870669
4542,Horacio Orzán,65,3241100,3089484129417696,585,6948944,4153366,416,4152950
4543,Gabriel Osho,56,2316800,9827660697120709,371,4422631,3391139,3392,3387747
4544,Milutin Osmajić,49,4246200,5186198363017828,552,7777592,1822100,18221,1803879
4545,Yordan Osorio,29,2409900,7833243702398738,265,3523598,2636716,0,2636716
4546,Levin Öztunalı,69,3494600,8665976602180138,485,6184716,1877349,188,1877161
4547,Sergi Palencia,42,3243700,9034523859267625,377,5175252,836935,8370,828565
4548,Victor Pálsson,36,4796000,8698192273087378,468,6924820,6442285,644229,5798056
4549,Miloš Pantović,35,1889600,3652670374831619,227,3011249,112136,112136,0
4550,Aitor Paredes,61,2130000,6530134387802539,444,5142042,3936329,39364,3896965
4551,Park Seung Wook,68,2064800,6825390015296030,467,5505925,4753651,0,4753651
4552,Nicolás Pasquini,63,1697400,7833296074105103,350,3925888,692754,69276,623478
4553,Felix Passlack,60,1310900,7899298593533366,309,3149414,1028184,102819,925365
4554,Louis Patris,25,4660300,9153359178910665,408,6863859,3441162,3442,3437720
4555,Leonardo Pavoletti,22,1163400,6859106677755404,79,1238535,401653,402,401251
4556,Matty Pearson,52,1598800,8744197127784323,319,3548838,1460808,1460808,0
4557,Tomáš Pekhart,49,1584200,6681734307791133,299,3151020,774076,775,773301
4558,Nathan,65,2141700,9681713042582980,410,4668889,3531012,353102,3177910
4559,Timothée Pembélé,36,2025000,4341841352057125,252,3518755,379326,3794,375532
4560,Alexandre Penetra,54,1852100,5937359991250435,319,3833881,574684,574684,0
4561,Juan Carlos Pereira,24,632800,5433086098778974,47,599625,176055,1761,174294
4562,Sebastián Pérez,24,4778200,5807673653333319,365,6785644,4969875,4969875,0
4563,Njegoš Petrović,22,2126300,8813164810967686,199,3042772,1339072,1339072,0
4564,Patrick Pflücke,47,4512900,7439978116076602,559,8282317,7565671,0,7565671
4565,Harry Pickering,68,2178500,5583384038724453,416,4480833,1158881,1158881,0
4566,Hamilton Piedra,43,4623300,7955071609468732,498,7901523,3241767,324177,2917590
4567,Iván Pillud,62,801700,5321248936111128,256,2277750,2091001,210,2090791
4568,Markus Pink,33,4714400,3303457878538090,424,6669419,857915,8580,849335
4569,Robert Piris Da Motta,56,1995500,8818965248675310,382,4322510,3373160,0,3373160
4570,Mauro Pittón,32,3127600,5576510817518326,291,4458331,3609695,361,3609334
4571,Julian Pollersbeck,43,353000,8425715198498410,158,1135621,59144,59144,0
4572,Andy Polo,56,3759900,5497248411951948,511,6762828,2507504,2507504,0
4573,Matt Polster,30,809700,7824495294678546,99,1094795,267421,268,267153
4574,Giacomo Poluzzi,35,3763200,9157875434631060,383,6232582,5233288,524,5232764
4575,Octavian Popescu,62,4634600,5070988927024023,630,8777038,3192655,320,3192335
4576,Lucas Possignolo,70,4983900,9429207293139281,760,9452836,2930376,294,2930082
4577,Postigo,67,2216000,4684624781640092,431,5250492,4131774,4132,4127642
4578,Nick Powell,28,1300100,5964662107996464,143,1936967,419351,0,419351
4579,Tomás Pozzo,56,1382500,6038881438789010,345,3879716,428795,0,428795
4580,Lucas Pratto,55,477700,3645464716278871,244,2070178,839771,83978,755793
4581,Ángelo Preciado,63,1213400,3693953161297756,321,3172527,1348688,13487,1335201
4582,Adonis Preciado,25,2256800,3736576348986934,196,3173076,2723519,2724,2720795
4583,Gianluca Prestianni,26,1429800,9583905273326128,132,1964597,1667950,16680,1651270
4584,Dirk Proper,35,1207800,3620856356517873,182,2208605,1162308,11624,1150684
4585,Cameron Puertas,63,1107400,9585035409632749,322,3011345,1450737,1451,1449286
4586,Ignacio Pussetto,34,2245200,5606203613366566,239,3476320,1239107,0,1239107
4587,Robin Quaison,35,3983600,9672937910661733,438,6692494,42124,4213,37911
4588,Leonel Quiñonez,30,3916400,5063887231430978,410,5874504,2326344,232635,2093709
4589,Aldair Quintana,60,4755900,4151594457797634,556,8110021,1289906,129,1289777
4590,Alberto Quintero,39,3313200,9571954062099633,364,5488561,2114111,211412,1902699
4591,Risto Radunović,41,1666900,7175410803232742,235,3122995,2701608,270161,2431447
4592,Yanis Rahmani,38,2193400,3608202198266980,271,3574974,2207994,22080,2185914
4593,Benito,31,2216500,5056084255363400,217,3222703,2612722,261273,2351449
4594,Aaron Ramsey,45,4499800,5691562701416778,534,7366477,4854941,48550,4806391
4595,Rene Renner,69,526100,8135805876375315,283,2546040,1351791,0,1351791
4596,Leandro Requena,44,1604200,3834005552681833,246,3204513,1815899,181590,1634309
4597,Paolo Reyna,24,2646700,5708260576043938,209,3667818,1992671,1992671,0
4598,Bryan Reynolds,53,2880400,4612754722844195,438,5663232,3164623,31647,3132976
4599,Ricardo Ryller,65,402200,9435384319042278,241,2011012,738843,7389,731454
4600,Andrés Ricaurte,44,3536800,8741299045472570,377,5791536,187745,0,187745
4601,Mikel Rico,33,1718000,7953773221099742,183,2677515,2414962,0,2414962
4602,Emil Riis,53,1056800,4826665643291168,287,2691656,172992,0,172992
4603,Alexander Ring,61,3605900,8037302800117039,475,6696426,5489472,5490,5483982
4604,Juan David Ríos,55,2887500,5502612817743596,467,5422165,1335800,133580,1202220
4605,Josh Risdon,64,1671700,5088611736420111,353,4111988,1561175,0,1561175
4606,Marlon Ritter,44,1004800,4780200504365015,219,2259491,1497022,14971,1482051
4607,Williams Riveros,67,998400,8273255908219199,375,3391107,607082,0,607082
4608,Callum Robinson,22,2980800,3377442092205888,238,3999943,602748,0,602748
4609,Gerson Rodrigues,41,2361300,3845810494678118,321,4296868,889823,8899,880924
4610,Léo Jabá,41,926000,7529520990978292,210,2117086,1818944,182,1818762
4611,Carlos Rodríguez,54,533300,9884772743622145,248,2094881,553757,5538,548219
4612,Diego Rodríguez,54,2669500,4271902224981527,433,5766055,379924,0,379924
4613,Chema,69,1498300,9669984251439773,440,4198362,94058,0,94058
4614,Andy,38,2163900,7480681131170987,253,3584889,1072625,107263,965362
4615,Jony,58,1185100,3497569625220156,289,2972571,2417010,2418,2414592
4616,Alvaro Rodríguez,37,4748400,4378803243430324,438,7534947,2772404,27725,2744679
4617,Manuel Roffo,46,1963200,4276892858447429,290,3785651,3597622,35977,3561645
4618,Iván Rojas,24,2612400,4709373967165830,195,3611813,2257918,0,2257918
4619,Santiago Rojas,33,2124900,7401053728835145,213,3097584,2256266,2256266,0
4620,Enzo Roldán,50,3668700,7287139562256204,436,6089065,4878952,487896,4391056
4621,Simone Romagnoli,40,2136700,5995579789383994,265,3488403,1524939,0,1524939
4622,André Rømer,56,1071800,9779945050187114,284,2868470,540096,5401,534695
4623,Farley,61,2840300,5492656094006159,486,5988780,281270,281270,0
4624,Keegan Rosenberry,55,4237900,5162944877731139,539,7753774,3649605,3649605,0
4625,Loreintz Rosier,55,2767400,3976350837299841,409,5403051,3076903,3076903,0
4626,Bryan Rovira,40,4529100,8866731143724993,484,7595564,55181,0,55181
4627,Kye Rowles,50,3083500,8915726731789818,387,5625146,4458363,0,4458363
4628,Waldo,59,1605700,8029735875429084,331,3510875,1469695,146970,1322725
4629,Pablo Ruiz,24,3226900,9175004469263899,270,4708063,620673,0,620673
4630,Sergio Ruiz,48,3404200,5563115052137215,407,5821176,4860170,487,4859683
4631,Ramiro Ruiz Rodríguez,60,3731300,9916843992905386,531,6983752,3571796,3571796,0
4632,Patrick William,49,351200,5259595557339055,180,1437224,494205,495,493710
4633,Marwane Saadane,37,4192500,7710341315768527,441,6495992,5440562,544057,4896505
4634,Stefano Sabelli,67,2339300,7182940217126609,511,5885045,366279,3663,362616
4635,Abdelhamid Sabiri,29,3976300,7959708349185066,357,5821881,1213619,1213619,0
4636,Ismael Saibari,34,3180800,4602485146462759,317,5310485,5181181,0,5181181
4637,Maximiliano Salas,45,4270100,7434775677334462,520,7942435,4015805,402,4015403
4638,Saúl Salcedo,26,3129300,9683615029576660,236,4256468,3068190,307,3067883
4639,Brian Salvareschi,31,1788400,5953212788944012,198,2881120,779615,0,779615
4640,Mamadou Samassa,58,2369400,8681374321359300,387,5139209,1248868,1249,1247619
4641,Fabián Sambueza,55,3095200,7636710594056956,486,5897006,3653223,36533,3616690
4642,Sergi Samper,53,1274800,4035874848891401,298,3088826,2911322,291133,2620189
4643,Alfons Sampsted,43,2855700,7166337529985607,341,4576218,3769323,37694,3731629
4644,Rubén Sánchez,32,3472400,7395974229653261,348,4939651,1884509,1885,1882624
4645,José Sand,35,4831700,8934557341170565,525,8172040,4171729,0,4171729
4646,Philippe Sandler,44,2094400,5826235475073341,326,3776563,543057,544,542513
4647,James Sands,23,1541200,6280225250940592,146,2114147,706854,706854,0
4648,Roque Santa Cruz,44,2032200,8276254271019317,316,3975323,963167,0,963167
4649,Danilo Santacruz,52,2902700,7823068132808091,482,5781925,270988,0,270988
4650,Nathan,32,968900,4899056428681047,129,1508061,415631,4157,411474
4651,Tayyip Sanuç,22,4265900,9703472973305132,338,5570185,3046110,0,3046110
4652,Noah Joel Sarenren Bazee,53,4348600,9080553788720655,531,7569205,2657137,0,2657137
4653,Amin Sarr,41,4367200,7364305903956045,412,6533968,2986724,0,2986724
4654,George Saville,50,4044100,7210452387361809,446,6263676,4104950,41050,4063900
4655,Daniel Schmidt,24,4070700,3278411218710398,316,5858309,1455480,145548,1309932
4656,Jan Schöppner,65,459200,5376590436036865,263,2068419,1743525,1744,1741781
4657,Ignacio Schor,68,2533000,9895384897418212,455,5418871,929872,930,928942
4658,Alexander Schwolow,22,958400,7539023002209668,93,1208034,546810,5469,541341
4659,Luis Segovia,36,3990200,9638855217581372,396,6353133,4905250,490525,4414725
4660,Ken Sema,63,4026600,8687636965397920,556,8039086,33112,0,33112
4661,Alfa Semedo,67,2857300,5991851352637858,546,6793628,1444845,14449,1430396
4662,Antoine Semenyo,68,3222700,4602612179262210,533,6590357,2428587,242859,2185728
4663,Adrian Šemper,40,2246000,9535039491972596,255,3687320,2052811,0,2052811
4664,Seol Young Woo,48,4013100,7790150041825172,454,6933575,5728647,57287,5671360
4665,Nico Serrano,52,3714300,8128200400501145,507,6613197,657222,6573,650649
4666,Kevin Sessa,24,2967500,9751995169895268,286,4346580,1467249,14673,1452576
4667,Michal Ševčík,57,4622800,3263176820820877,573,7811931,1477783,0,1477783
4668,Juan Sforza,53,3839000,5207685515425058,509,6462033,1940393,195,1940198
4669,Giuseppe Sibilli,59,1000600,4252306297731068,309,2905472,1909398,1910,1907488
4670,Vincent Sierro,34,4499100,5079493752621081,426,6997469,1110560,0,1110560
4671,Tim Siersleben,27,1207700,9267330319071335,94,1439322,569604,569604,0
4672,Romário Baró,40,3709300,8658765378180044,393,6323081,3339657,3340,3336317
4673,Victor Braga,27,443000,7409637561811159,67,554805,304716,3048,301668
4674,Igor Silva,69,2505000,4913340922994365,486,5575746,2331697,23317,2308380
4675,Reis,40,3705000,4635194419446843,358,5942386,3012317,302,3012015
4676,Bressan,54,1813900,7360701984741250,341,3794198,3783350,37834,3745516
4677,Doğukan Sinik,59,1186600,3023189262186266,330,3372434,1766341,0,1766341
4678,Tobias Sippel,48,1324800,4097900895797974,244,2720344,885357,885357,0
4679,Hugo Siquet,39,4060300,7660773185728296,463,6958346,3464477,347,3464130
4680,Regan Slater,44,1281100,3578392156698028,242,2704380,996898,100,996798
4681,Rafa Soares,54,4003900,3903388294764800,521,7610362,794504,7946,786558
4682,Thibo Somers,68,3540700,3753979567702159,583,7445945,6243879,625,6243254
4683,Song Min Kyu,56,4794200,4591932815922644,562,8396194,4121332,41214,4080118
4684,Joel Soñora,69,3249800,8055454116429493,557,6603243,6035449,6036,6029413
4685,Christian Sørensen,61,3127800,8420695116238889,564,6708617,5914124,592,5913532
4686,Frederik Sørensen,34,4421200,8387249376886910,441,6978283,4252946,4253,4248693
4687,Mario Soriano,22,3672400,5213070934305838,256,4854992,1339040,134,1338906
4688,Alberto Soro,65,3535200,5092303803256694,560,7203106,2285587,0,2285587
4689,Luca Sosa,65,833100,5270317975837891,300,2793968,156983,15699,141284
4690,Gonzalo Sosa,62,3654900,7009346879181526,544,7212884,4483264,0,4483264
4691,Alexis Soto,52,3831400,6128982092500100,502,6839863,971758,0,971758
4692,Leonai,41,1302200,5120536894872546,227,2652928,1466154,0,1466154
4693,Sem Steijn,42,3692700,3107357116882006,391,5641234,628709,629,628080
4694,Leonidas Stergiou,24,4517500,7287207536894711,423,6464265,1110279,11103,1099176
4695,Enda Stevens,62,4160700,3346716020140077,589,7812108,3606498,0,3606498
4696,Leo Štulac,54,1984100,7268992964659795,340,3947583,3449975,345,3449630
4697,Ivan Šunjić,28,3369600,8705689994554524,268,4772175,3442729,34428,3408301
4698,Adrian Șut,47,1646700,8990652261073343,300,3294892,2137317,214,2137103
4699,Abakar Sylla,23,3949200,5541692228574321,350,5750258,5642003,5643,5636360
4700,Vicente Taborda,56,1401800,6908843767431131,274,3096595,811244,8113,803131
4701,Benjamin Tahirović,32,3109600,5769076807394997,325,5171065,893613,8937,884676
4702,Ismael Tajouri-Shradi,48,2667300,3615216799719023,341,4437888,2576945,257695,2319250
4703,Florin Tănase,38,1265000,4099754665259222,190,2133198,432476,432476,0
4704,Rodri Tarín,67,1130100,3391287203417573,372,3760481,53582,0,53582
4705,Ștefan Târnovanu,57,2680500,7930382217561633,368,4476443,3872213,0,3872213
4706,Martín Távara,63,2974500,5332534542779754,472,6263730,17367,17367,0
4707,Mahmut Tekdemir,33,4718100,7682896472303531,428,6493565,809555,810,808745
4708,Lino Tempelmann,26,1408200,3741389954808649,146,2075694,385873,3859,382014
4709,Arnau Tenas,37,3663400,9219491965145751,407,6466625,4901958,0,4901958
4710,Robert Tesche,39,2617900,8298662609559280,303,4398002,2483040,2484,2480556
4711,Sorba Thomas,43,1832300,5887192486450993,276,3628919,1143251,114326,1028925
4712,Tiago Orobó,46,2257700,6882044651081747,285,3624300,2572289,0,2572289
4713,Timor,25,1415800,8294841686934506,148,1953527,836156,83616,752540
4714,Fernando Tobio,23,1721900,8692637796016007,136,2283780,540294,0,540294
4715,Boris Tomiak,48,4476600,4411287657955606,530,7394803,4527495,453,4527042
4716,Pablo Torre,45,422500,6145313732418930,145,1211687,1141020,1141020,0
4717,Isaak Touré,38,2659000,3558767327431273,331,4431957,3338136,3338136,0
4718,Mattéo Tramoni,47,3290000,9905049759491533,425,5876036,3253789,326,3253463
4719,Enrique Triverio,45,4286500,8314820154841362,414,6656359,2902630,291,2902339
4720,Christos Tzolis,41,1091100,8576735447851235,207,2123418,901788,901788,0
4721,Manfred Ugalde,57,3523500,3883467208593301,475,6771610,792408,79241,713167
4722,Iké Ugbo,36,632000,5328605382203207,137,1305877,1119742,112,1119630
4723,Jacob Une-Larsson,29,1011900,9410116181380654,134,1529611,224464,0,224464
4724,Benjamin Uphoff,70,3485900,7080770827794619,569,7042759,1981653,199,1981454
4725,Rodrigo Ureña,34,1021500,6577960551532927,152,1781306,1651398,166,1651232
4726,Fernando Uribe,31,2488200,4095721397684374,262,3752789,3624075,3624075,0
4727,Moses Usor,54,773300,9663621659712879,237,2144756,344790,0,344790
4728,Albert Vallci,39,874800,9304672958859759,171,1766731,1670883,167089,1503794
4729,Jules Van Cleemput,56,2356300,9322864166844625,355,4501023,705654,706,704948
4730,Thomas van den Belt,47,2991800,8866845341025371,402,5385376,402047,0,402047
4731,Rick van Drongelen,53,2177500,6968916725540916,366,4402400,2344679,234468,2110211
4732,Stijn van Gassel,42,4620000,6655990763517624,493,7133717,5050252,5050252,0
4733,Tom van Weert,63,802900,6964081641883295,342,3154440,382949,383,382566
4734,Charles Vanhoutte,22,2354100,6780161576663665,177,2752267,2033779,0,2033779
4735,Jordi Vanlerberghe,43,3431100,3934588881959966,386,5474003,2893944,2893944,0
4736,Barnabás Varga,51,2845200,9327631834816577,375,4943292,4425507,4426,4421081
4737,Sebastian Vasiliadis,55,4228100,7996964624656316,551,7260676,4901330,0,4901330
4738,Nikola Vasilj,43,3853400,3655622081814389,428,6518131,5130517,5130517,0
4739,Johan Vásquez,25,2159900,4744971915263325,198,2975188,2775512,278,2775234
4740,Cristian Vega,38,980800,4366490965195466,138,1614435,205864,2059,203805
4741,Gustavo Henrique,33,1012400,7089054923383637,123,1591982,83149,8315,74834
4742,Gastón Verón,27,4760700,3221312078124463,437,7457529,5408489,541,5407948
4743,Paulinho,48,3754000,5588212528949422,467,6630139,834869,834869,0
4744,Joel Pereira,22,2452300,8645739917982010,211,3537198,3212971,322,3212649
4745,Oliver Villadsen,25,4308400,8265627363985651,346,5712839,1110251,1111,1109140
4746,Carlos Villalba,54,1011200,4147960770253506,233,2334021,750268,750268,0
4747,Carlos Villanueva,42,4712600,5419444903279635,550,7945188,6897292,6898,6890394
4748,Alessandro Vogliacco,61,3710200,4821826121851950,515,7310384,1312035,13121,1298914
4749,Andreas Voglsammer,41,2038900,7492842822931291,306,4183915,2834564,2835,2831729
4750,Bart Vriends,46,1810100,6779062019252734,299,3639671,2381772,238178,2143594
4751,Giacomo Vrioni,49,1671900,9277268383731418,339,3916522,3743140,375,3742765
4752,Hauke Wahl,32,2168800,8451870003483152,239,3594526,3101256,31013,3070243
4753,Sebastian Walukiewicz,56,1058100,3692935778200437,281,2727892,1149007,115,1148892
4754,Tsuyoshi Watanabe,63,1959100,6188508841120713,350,3810452,508993,0,508993
4755,Brice Wembangomo,42,4136100,5311252506219248,427,6607770,4986971,498698,4488273
4756,Scott Wharton,54,3799100,6877924187334115,494,6713155,2666353,266636,2399717
4757,Gustav Mendonca Wikheim,61,4346500,8167227101413330,589,8284061,284667,28467,256200
4758,Joe Williams,59,4349700,6240176851848578,575,7884861,2132515,214,2132301
4759,Josh Windass,38,4256500,5559943200959626,459,6828772,4346232,434624,3911608
4760,Richard Windbichler,40,2713100,9362890242750083,353,4480217,3956985,0,3956985
4761,Scott Wright,55,2327700,4685514041057808,365,4760160,4296768,4297,4292471
4762,Paweł Wszołek,61,2986100,4763758220393191,517,6469984,4386606,4386606,0
4763,Güven Yalçın,62,1975800,4641696750246660,374,4058798,1149767,11498,1138269
4764,Kelvin Yeboah,41,3940100,7393624256056228,485,6884477,2345188,2346,2342842
4765,DeAndre Yedlin,55,1877800,9287532478872158,332,4212924,2702833,0,2702833
4766,Darlin Yongwa,69,3998900,8086096918715102,608,7801924,6815370,68154,6747216
4767,Gabriele Zappa,34,3927800,7783625042976596,374,5870721,5684143,0,5684143
4768,Gyasi Zardes,59,3964100,8200493639688788,507,7009274,2980617,0,2980617
4769,Benedikt Zech,36,1175000,4070236413120933,166,1897121,1130195,114,1130081
4770,Deyovaisio Zeefuik,28,3089100,8327578480390397,318,4706797,1163309,116331,1046978
4771,Jordan Zemura,31,4118600,9176435806004810,401,6700139,987834,0,987834
4772,Zhang Yuning,39,2503400,3221378659611343,332,4328183,2961383,2962,2958421
4773,Zhou Dingyang,57,3834600,6933250446967198,520,7242921,3319539,33196,3286343
4774,Luca Zidane,67,1924300,4033094517123276,441,4687653,3096365,0,3096365
4775,Philipp Ziereis,61,671800,8365896708534693,323,2858073,2062691,20627,2042064
4776,Nermin Zolotić,69,2491700,3306554268323984,450,5312129,3524178,352418,3171760
4777,Juan Zuluaga,26,2118900,7044923838920666,175,2868461,1989146,1989146,0
4778,Rayane Aabid,28,332000,7042276138872489,41,261880,126761,0,126761
4779,Matthis Abline,66,2330600,8470562269153889,461,5247410,804637,805,803832
4780,Peter Abrahamsson,23,3840400,4603436975105984,326,5324019,1054880,1054880,0
4781,Afonso Freitas,63,1344800,6138755768081509,342,3496270,1243805,1244,1242561
4782,Jonás Acevedo,70,4938300,5840982344686209,727,9073477,6318667,63187,6255480
4783,Boadu Maxwell Acosty,22,857800,6167147338276064,81,1063633,446451,4465,441986
4784,Sam Adekugbe,52,2338600,3891395526167948,359,4187474,702299,0,702299
4785,David Affengruber,56,3911400,7266856167713739,521,7692943,94551,946,93605
4786,Saad Agouzoul,58,4314900,7020541999908880,509,7132238,5217021,5218,5211803
4787,Marc Aguado,46,1101600,9390940711677866,267,2884060,1961065,19611,1941454
4788,Martín,48,1086600,8845784898065788,232,2432976,1953355,19534,1933821
4789,Ahn Young Kyu,69,3294500,3457712622805503,561,6692861,6048959,0,6048959
4790,Youssef Aït Bennasser,46,3029400,5018658250913508,404,5637129,1308566,1308566,0
4791,Marley Aké,69,4813200,8403669635360871,700,8991648,3182205,3182205,0
4792,Marvin,63,3446400,9532434366947894,515,6262109,5052560,50526,5002034
4793,Babajide David Akintola,37,2350800,7349731050895105,271,3795501,2654762,265477,2389285
4794,Chadrac Akolo,49,4434600,9263378927912720,514,7211562,5753664,575367,5178297
4795,Abdulelah Al Amri,43,2876000,9537799311049346,340,4908387,2782914,0,2782914
4796,Abdulrahman Al Obud,34,1884300,3081827826469572,220,2857032,1123478,0,1123478
4797,Mohammed Al Owais,41,4941900,5507910458437948,473,8064101,3964017,39641,3924376
4798,Fernando Alarcón,58,4614600,6277864938229459,591,8147462,612681,6127,606554
4799,Jostin Alarcón,55,4994000,5129757279554002,592,8509543,2307785,23078,2284707
4800,Diego Alende,46,3871700,5627030542017447,476,7052280,2957709,295771,2661938
4801,Faride Alidou,40,4738900,7050111602643107,504,7542581,5510641,5511,5505130
4802,Nabil Alioui,51,872200,5000391802108063,235,2186148,1096857,0,1096857
4803,Joe Allen,25,1164100,7082302366509078,90,1376062,166725,166725,0
4804,Júnior Urso,66,3919000,9734170636149846,581,7308441,4358816,435882,3922934
4805,Zlatan Alomerović,24,378900,7267368301705662,48,383597,156534,157,156377
4806,Skelly Alvero,32,1200900,3909304856244887,177,2073067,302459,302459,0
4807,Lisandro Alzugaray,28,2180600,4704732677189834,207,3114049,2625684,263,2625421
4808,Nicolas,31,3974200,8887769605579160,346,5325014,2557850,2557850,0
4809,Komnen Andrić,60,1196500,3597851121951646,319,3136962,2542318,0,2542318
4810,Andújar,27,1561500,5294141734232546,152,2167140,1661016,166102,1494914
4811,Iván Angulo,59,4787000,6119259189075131,644,8169203,4849597,485,4849112
4812,Bryan Angulo,36,1929600,4839173957186269,222,3174820,2186132,0,2186132
4813,Taylan Antalyalı,24,4686500,9270072686112384,354,6370718,216963,21697,195266
4814,Mirko Antonucci,35,2465600,4843039134929227,277,3878877,1103354,1104,1102250
4815,César Araújo,24,3426700,3282877293005544,310,4961684,177437,178,177259
4816,Héber,63,1819100,5718630722508901,372,4288547,2831273,0,2831273
4817,Scott Arfield,46,3249700,7405673749952690,411,5603884,3580587,358059,3222528
4818,Junior Arias,59,4604500,7970845115625849,533,8231098,6404235,0,6404235
4819,Blas Armoa,22,4771000,7365504749418326,380,7151221,5519020,5520,5513500
4820,Toluwalase Arokodare,53,4769700,3675148583382417,557,8156410,5977397,0,5977397
4821,Arribas,50,4740000,4346837810405856,572,8726155,101622,102,101520
4822,Anderson Arroyo,47,2904400,9834675281998640,420,5751101,1176832,1176832,0
4823,Dixon Arroyo,48,4068300,8447448009482650,500,7273541,5585517,55856,5529661
4824,Hakan Arslan,42,2189600,8387649140691107,313,4119817,1949384,1950,1947434
4825,Carlos Ascues,27,714200,6583005581684986,81,871253,387692,38770,348922
4826,Gjermund Åsen,52,3445700,6255894027553246,504,6494601,5819481,0,5819481
4827,Lorenz Assignon,47,4784500,3765988147505541,534,8277728,7738466,77385,7661081
4828,Edson Aubert,27,4400900,9764062442375414,384,6462043,221384,221384,0
4829,Jonas Auer,63,4563600,9389013017525115,593,8519985,7193654,720,7192934
4830,Cédric Avinel,22,650900,7986701389009786,41,508771,371798,371798,0
4831,Finn Azaz,23,4980900,4173040862775218,439,7130103,2158633,0,2158633
4832,Iván Azón,63,1870900,6650945291331073,419,4772382,4082,0,4082
4833,Renzo Bacchia,34,1091600,8155477948916007,174,2093598,86208,863,85345
4834,Janik Bachmann,58,1193700,9973568309469825,324,3196668,1834306,1834306,0
4835,Tomás Badaloni,62,3014300,3878694869132097,437,5223854,1486307,148631,1337676
4836,Jaime Baez,35,2959400,5082837706693234,267,3929286,3466001,347,3465654
4837,Jonas Bager,40,4093600,7251290082493567,460,6501472,3680147,368015,3312132
4838,Hattan Bahebri,63,4115400,6716354927608884,587,7917150,923059,924,922135
4839,Dilane Bakwa,70,1605900,3135797948328081,365,3792510,720597,0,720597
4840,Thierno Baldé,43,2266200,7714586645958472,316,4124682,687021,687021,0
4841,Carlos Baleba,38,3268200,5922024196668886,340,5189171,3733883,374,3733509
4842,Jure Balkovec,59,4184000,3879605532120511,582,7742061,2456763,0,2456763
4843,Abdoulaye Bamba,56,2804600,5666871683297398,411,5197111,2178372,2179,2176193
4844,Yacine Bammou,42,2820600,9874559101945531,390,5013928,1872923,0,1872923
4845,Nicușor Bancu,31,2785000,6303592522213147,262,4050000,1152859,115286,1037573
4846,Beni Baningime,67,372300,6661292226606949,319,2339427,859254,0,859254
4847,Rayyan Baniya,44,4417200,9692303421058588,482,6694292,315497,315497,0
4848,Baltasar Barcia,52,2750200,3331009140599423,394,5206161,4002020,4003,3998017
4849,Antonio Bareiro,41,4835600,3208496681983960,457,7879651,168775,1688,167087
4850,Bruno Barticciotto,30,2265200,6642262707132104,224,3350282,2305236,2306,2302930
4851,Cole Bassett,48,4373000,8866184556025273,508,7841324,5528922,552893,4976029
4852,Nick Bätzner,34,732700,3815256074264585,142,1365376,1187842,119,1187723
4853,Jonathan Bauman,57,3362200,8717283261363863,489,6027258,4260847,0,4260847
4854,Juan Bauza,49,2258700,7272507360741672,313,4318205,2183997,2183997,0
4855,Nathan Baxter,39,3005300,8246335117210448,326,4906045,398368,3984,394384
4856,Cyrille Bayala,34,2901000,6001357811246888,303,4529987,2484902,249,2484653
4857,Timo Becker,50,4916200,4278672018249849,521,8242889,1681052,1681052,0
4858,Diego Bejarano,42,3131700,6023340873560851,398,5198673,4577787,457779,4120008
4859,Jérémie Bela,50,3712900,7084868612909831,439,6396880,803604,0,803604
4860,Jeanuël Belocian,55,2844500,3007581322802518,382,5293960,2885792,289,2885503
4861,Mortadha Ben Ouanes,47,4659600,9923258750337226,526,7578203,6630838,0,6630838
4862,Jonathan Benítez,47,378700,8680857273782945,184,1550584,173786,173786,0
4863,Loris Benito,38,1574800,4964565709004328,222,2845999,2065206,2065206,0
4864,Rubén Bentancourt,22,1783200,9905865953467001,145,2295222,2126616,21267,2105349
4865,Adrián Bernabé,25,1588600,7734448152292336,144,2226260,2109527,210953,1898574
4866,Alexandro Bernabei,40,1233200,9763908258910377,225,2668465,1668979,1669,1667310
4867,Maxime Bernauer,30,4961300,9315100346815875,456,7781535,7086629,0,7086629
4868,Antoine Bernede,69,4447400,3798954951424427,624,8495258,7629516,0,7629516
4869,Léider Berrío,41,3861700,4399284370944420,484,7187902,5173590,518,5173072
4870,Jason Berthomier,27,3957100,8780312229486054,362,6379206,2371529,0,2371529
4871,Max Besuschkow,64,2694400,4550550272017528,486,5697794,2707805,270781,2437024
4872,Gonzalo Bettini,66,698900,9548065867384963,293,2638129,1492599,1492599,0
4873,Luis Binks,59,3529300,7993310818407490,537,7330550,7293626,7293626,0
4874,Mickaël Biron,50,1044500,9909131496894648,255,2494405,164855,0,164855
4875,Henrik Bjørdal,30,3810600,7188086016255957,381,5888049,3444842,344485,3100357
4876,Miha Blažič,43,1714600,9176856512370621,256,2980996,1734118,173412,1560706
4877,Herbert Bockhorn,62,1764300,8805115428010509,348,4188695,3182437,3182437,0
4878,Luciano Boggio,61,4522200,3753226165651948,598,8381294,7070947,0,7070947
4879,Bruno Gaspar,49,468700,7456767644309385,193,1717930,163453,163453,0
4880,Quentin Boisgard,59,4316200,7120048398880072,576,7818143,7551053,7552,7543501
4881,Facundo Boné,52,775500,7109324739741341,219,2054429,676485,676485,0
4882,Taylor Booth,28,642700,8404218669542607,88,831339,321912,0,321912
4883,Julian Börner,56,710700,7015147775059859,231,2076577,1873104,187311,1685793
4884,Jordan Bos,51,2257700,4702191337901852,377,4249886,1266136,1266136,0
4885,Endre Botka,65,1024300,8232848371562207,367,3363126,2730148,2730148,0
4886,Mattia Bottani,67,4029800,8760819487454708,655,8078833,128204,12821,115383
4887,Badredine Bouanani,70,361600,8208237284192187,357,2658117,1604080,16041,1588039
4888,Agustín Bouzat,61,872600,8174117650117753,324,3063976,1302597,131,1302466
4889,Josh Bowler,27,2057900,3603802810003940,153,2868614,787347,787347,0
4890,Michael Boxall,69,4526200,5027083156221728,724,9435670,7390762,73908,7316854
4891,Liam Boyce,47,3996900,9451089183737782,521,7126668,5721851,57219,5664632
4892,Tyler Boyd,69,2035100,4187420493349867,468,5383113,144528,144528,0
4893,Flavien-Enzo Boyomo,63,864300,7109104000660058,315,2687277,559859,560,559299
4894,Quentin Braat,36,1193000,7083755664704390,161,1898468,43991,4400,39591
4895,Conor Bradley,59,1388200,9529569635567977,330,3492559,1496779,149678,1347101
4896,João Moutinho,31,4608400,7028371890926871,446,7223930,3284853,3284853,0
4897,Cameron Brannagan,59,592600,4629526624450062,287,2376687,1508958,1509,1507449
4898,Matthias Braunöder,67,1466500,5927536841320281,348,3773065,2971966,297197,2674769
4899,Néstor Breitenbruch,70,2325800,7711269535675912,447,5228217,1650229,166,1650063
4900,David Brekalo,43,1812000,6499159182420742,258,3145875,2330623,234,2330389
4901,Abel Bretones,27,629100,5591345035269476,95,928794,677514,6776,670738
4902,Jake Brimmer,62,3859800,9325465824696188,571,7718548,506479,506479,0
4903,Miguel Brizuela,58,1976100,5617521791422581,378,4091667,1964728,196473,1768255
4904,Nathan Broadhead,55,4204700,8827606989898675,500,7530762,2315503,0,2315503
4905,Jacob Brown,52,4157000,6947788885851513,527,7195617,1927328,1927328,0
4906,Massimo Bruno,63,1771100,7356092266446841,331,3831132,61099,611,60488
4907,Marcel Büchel,37,483700,7002446065964962,132,1112353,457213,457213,0
4908,Dave Bulthuis,69,632000,8033432232690673,329,2630666,2418455,2418455,0
4909,Facundo Buonanotte,59,821300,8931299489096486,298,2885285,2831200,284,2830916
4910,Delano Burgzorg,50,1535500,7176235891643206,299,3281207,14292,143,14149
4911,Oliver Burke,46,3227200,5108789022144467,394,5212656,2246693,2247,2244446
4912,Wes Burns,66,1369000,3069411126141544,345,3643592,10409,0,10409
4913,Jack Byrne,36,761400,7793835390194180,157,1572793,1476041,1477,1474564
4914,Nelson Cabanillas,35,527800,6720065668578632,103,955307,612976,6130,606846
4915,Rodrigo Cabral,70,407000,7098272659606616,316,2370151,2231988,224,2231764
4916,Alejandro Cabrera,35,4196600,7120357578850580,451,7210786,6380460,0,6380460
4917,Víctor Cabrera,70,462800,3279913686316369,309,2503667,2296020,2297,2293723
4918,Luis Adrián Caicedo,62,1750100,6142887492087983,416,4805711,3088175,0,3088175
4919,Arturo Calabresi,63,764300,7259257252624770,310,2617266,974818,0,974818
4920,Iván Calero,23,2646200,7723496316325861,211,3885885,600852,6009,594843
4921,Fabrizio Caligara,55,1856000,7938832343901790,320,3919926,1851616,0,1851616
4922,Rudy Camacho,69,1556900,7466999804124577,427,4407878,668038,66804,601234
4923,Ibrahima Camará,49,1073600,6342901095533717,294,2709305,1143173,0,1143173
4924,Facundo Cambeses,39,944900,9333570186811426,156,1709514,39268,39268,0
4925,Allan Campbell,32,324800,4403575186247046,103,787615,356595,357,356238
4926,Gastón Campi,54,4564900,9956853009455543,544,8188499,7856687,785669,7071018
4927,Ángelo Campos,43,1272100,3095617954009160,233,2702441,2363697,237,2363460
4928,José Canale,31,2166000,9277770822811342,231,3404815,2374410,23745,2350665
4929,Antonio Candela,41,3444400,3962641411182680,338,5254334,92299,9230,83069
4930,Luis Cangá,26,3808500,7871119630103670,306,5105905,4223012,4224,4218788
4931,Thomas Cannon,45,4628000,5174608659903798,498,8052663,5573567,558,5573009
4932,Russell Canouse,59,877600,8293725637530481,301,2937554,140272,140272,0
4933,Cantero,37,2209300,9515369013069448,308,4033683,1717322,1717322,0
4934,Gustavo Canto,63,2646800,8243974241143873,430,4972249,1331139,1331139,0
4935,Elio Capradossi,25,3583400,9522046968381259,301,5113880,3646912,0,3646912
4936,Bryan Carabalí,40,688800,3292990767933944,146,1399379,982435,983,981452
4937,Danilo Carando,39,1498500,6128280242297791,215,2514203,1478007,1479,1476528
4938,Michael Carcelén,28,2151200,6575216611683613,221,3232781,1951756,195176,1756580
4939,Felippe Cardoso,25,4523000,9218685973611668,339,6242028,193550,194,193356
4940,Agustín Cardozo,67,4359400,9148003558361546,610,8440458,2503048,2503048,0
4941,Thiago Cardozo,51,378000,9346817765322800,203,1474093,808850,0,808850
4942,Luis Cardozo,33,1952600,6481424865218763,210,2937727,82041,0,82041
4943,Ángel Cardozo Lucena,27,3689700,5794547451277113,312,5261457,3609197,3610,3605587
4944,Carmona,34,738300,4598527447760024,141,1447646,482774,48278,434496
4945,Ronie Carrillo,26,4664400,5425805830942042,417,7288104,2415166,2416,2412750
4946,Wilder Cartagena,26,4640000,9343664744930540,388,6884791,3974178,3974178,0
4947,Hayden Carter,23,754200,3742397470046052,80,928352,466883,0,466883
4948,Tiago Casasola,64,734000,8569302913733191,298,2617805,2280360,2281,2278079
4949,Daniele Casiraghi,64,3295100,8765739070337978,579,7143850,6600867,6600867,0
4950,Dário Essugo,58,766700,7961252179294723,281,2585579,1840600,18406,1822194
4951,Nicolás Castro,50,3562500,8607504079145582,489,6635455,3967112,396712,3570400
4952,Cristian Castro Devenish,67,3782100,7232528856673298,510,6523562,3078917,308,3078609
4953,Juan Ignacio Cavallaro,51,3575700,7951604795063569,472,6141517,4957707,4957707,0
4954,Jason Ceka,67,2758000,8796886612959056,496,6065387,1451972,145198,1306774
4955,Žan Celar,39,4047200,5566450711145461,393,6146801,1403846,141,1403705
4956,Ricardo Centurión,54,4060900,9247444918857801,522,7912790,699556,700,698856
4957,Alberto Cerri,47,924900,8403008816574560,254,2328026,1598504,1599,1596905
4958,Ezequiel Cerutti,57,994100,8541451538011849,292,2915861,2856403,28565,2827838
4959,Mehdi Chahiri,43,2264900,6700238114249518,286,3824636,646639,646639,0
4960,Giorgi Chakvetadze,47,2068200,9620202768719714,326,4097522,3395290,3396,3391894
4961,Juan Camilo Chaverra,66,507400,3719449031550066,279,2423732,2415588,24156,2391432
4962,Nanu,65,1443300,5583328532324337,367,3830076,2428108,2428108,0
4963,Jacob Christensen,23,3925000,7423705875951265,261,4988515,4649339,465,4648874
4964,Diego Churín,24,2324100,7419046053060814,202,3302596,1122646,0,1122646
4965,Darko Churlinov,47,3184400,6844588957437383,369,5612491,4269174,0,4269174
4966,Yanis Cimignani,62,1602600,5170126867876980,325,3665745,3412397,3413,3408984
4967,Daniel Ciofani,32,2424100,9434081478125158,277,4143090,3017703,0,3017703
4968,Seydouba Cisse,27,813600,6982516095570662,91,1002056,648698,648698,0
4969,Eldar Ćivić,36,1686600,8840891876545826,186,2587062,1900415,0,1900415
4970,Jake Clarke-Salter,43,3975100,7091293296529556,508,7369333,3475378,348,3475030
4971,Valentin Cojocaru,38,1626300,6839654969729074,233,2694377,1659236,1660,1657576
4972,Jack Colback,49,4450900,7232835476217214,529,7664856,7535888,0,7535888
4973,David Čolina,52,3830800,7618116365580856,468,6922587,3358186,0,3358186
4974,Jamilu Collins,39,500000,5329866206852145,143,1271202,247972,24798,223174
4975,Arnau Comas,22,4913100,3330399817851504,386,6981697,1889040,1889040,0
4976,Andrea Compagno,31,1060800,3180156278517891,126,1614281,668330,668330,0
4977,Nélson da Luz,64,3987300,8325359107431962,575,7318119,4687487,468749,4218738
4978,Amara Condé,26,2677100,8220025849474672,249,3776541,403013,4031,398982
4979,Tomás Conechny,30,3731500,4375460706341043,359,5718078,3093644,0,3093644
4980,Luca Connell,56,2596700,3093543854707378,420,5556744,1776988,178,1776810
4981,Aaron Connolly,67,2118800,5129627671040361,435,4754417,3649304,36494,3612810
4982,Harry Cornick,47,950100,6655256594289867,254,2594106,1474776,14748,1460028
4983,Gabriel Cortez,35,2470900,8188413885708092,290,3941112,3318308,0,3318308
4984,Pedro Álvaro,41,1022200,4659087485207691,186,1956242,1244129,124413,1119716
4985,Gaëtan Coucke,70,1368600,5458576977016717,394,3994748,3977464,0,3977464
4986,Domen Črnigoj,63,572300,8815845660268173,282,2243759,163998,16400,147598
4987,Marco Curto,67,916500,9074558439883565,378,3400708,1725336,0,1725336
4988,Olivier Custodio,43,3360800,3804199837712076,389,6072923,5585599,55856,5529743
4989,Tommaso D'Orazio,56,1939200,5136946914966316,383,4175665,2286058,228606,2057452
4990,Bradley Dack,68,4670400,5514342375767523,681,8358303,7011383,702,7010681
4991,Filip Dagerstål,49,3280300,9676693255372778,449,6474070,3526002,352601,3173401
4992,Aymen Dahmen,61,1346000,9267549587807974,344,3535784,2282082,0,2282082
4993,Thomas Dähne,34,1165100,4504802460321246,133,1752426,636565,63657,572908
4994,Jesper Daland,22,1432400,7095126302033073,97,1518693,817944,0,817944
4995,Amadou Dante,33,3095600,3367159574056080,307,4690705,3033459,303346,2730113
4996,Pál Dárdai,38,1470400,8243815689767584,201,2450987,1355517,136,1355381
4997,Achraf Dari,62,4391500,6373452853297915,551,7491204,1985201,1985201,0
4998,Jay Dasilva,61,2044200,9427621878979352,398,4452478,2546025,2547,2543478
4999,Jonas David,44,1581400,7975918426774373,308,3319595,2255623,2255623,0
5000,Jonathan de Guzmán,65,1510400,5817740869275446,364,3778190,1393287,139329,1253958
5001,Arthur,49,1297200,8722765937713183,273,2896611,1603680,1603680,0
5002,Mees de Wit,40,2756900,9839644593129674,296,4284649,1922316,0,1922316
5003,Alessandro Deiola,30,1431000,5493975284515503,185,2363009,81488,81488,0
5004,Enrico Delprato,54,3479700,6388536216673121,452,5892720,4741535,0,4741535
5005,Yusuf Demir,39,2043000,9604790839587244,242,3017297,27609,0,27609
5006,Deng Hanwen,38,3010000,7792559983668771,385,5715921,3465900,347,3465553
5007,Kévin Denkey,27,3035800,3287418478064511,306,4384838,2931219,29313,2901906
5008,Laurent Depoitre,51,1856800,7277770511654214,355,3919699,2977937,0,2977937
5009,Grady Diangana,69,3365500,5810151487357145,569,7049591,3075365,3075365,0
5010,Juan Ignacio Díaz,35,1555500,6430488525013472,177,2287505,215205,2153,213052
5011,Gabriel Díaz Núñez,62,1893900,8821328432602959,403,4589288,4356537,4357,4352180
5012,Dennis Diekmeier,23,1679400,5243193807204758,152,2351184,1160975,1160975,0
5013,Mitchell Dijks,51,1543100,8501486698228996,298,3493718,3058657,305866,2752791
5014,Anfernee Dijksteel,32,3297300,5659427857745523,367,5602073,4942610,0,4942610
5015,Loïs Diony,60,4042900,3152778139344801,580,7660953,6739106,673911,6065195
5016,Alex Dobre,31,702800,7020453834346656,129,1333500,1202927,1203,1201724
5017,Damjan Đoković,48,2837700,5297790036048595,350,5087377,3105359,311,3105048
5018,Hugo Gomes,32,4683200,3418335115036764,457,7150773,2982079,2982079,0
5019,Fabricio Domínguez,56,1176100,6450127853593927,306,3069801,1651644,1651644,0
5020,Carlos Domínguez,65,3592300,6138827590395979,508,6624483,3061460,0,3061460
5021,Alejandro Donatti,27,1747800,8675204888582279,151,2234774,77845,7785,70060
5022,Varela,54,2638100,9177317182914596,440,5307927,4546515,4546515,0
5023,Tommy Doyle,30,4714700,9036398202143190,421,6852141,5816178,5816178,0
5024,Vetle Dragsnes,57,2926800,7508671065634494,479,6092285,528411,529,527882
5025,Ferdy Druijf,42,870500,3253650489978446,172,1740519,802246,802246,0
5026,Alejandro Duarte,22,437400,3681881919067808,37,309080,105135,0,105135
5027,Bruno Duarte,29,3515600,6059721291633723,341,5467913,2124208,21243,2102965
5028,Jhon Duque,51,4151900,8612647282110476,521,7426927,2516098,0,2516098
5029,Uroš Đurđević,46,4939500,7652002333671446,520,7976809,2638879,2639,2636240
5030,Josh Eccles,50,976100,4173351234069822,209,2290473,2178279,0,2178279
5031,Malcom Edjouma,50,4594100,8341198364424213,530,8036279,1862756,187,1862569
5032,Victor Edvardsen,59,2995700,5535835342714966,441,5610083,1165259,1166,1164093
5033,Georgios Efrem,51,2299500,7072678250981058,358,4470443,2235059,2235059,0
5034,Khalid Eissa,57,4136900,3149347364184817,552,7402859,565950,5660,560290
5035,Ovie Ejaria,36,3782800,9048919175323765,379,5468386,3885998,0,3885998
5036,Marvin Ekpiteta,26,3319500,8961549192061569,295,4772322,3400261,0,3400261
5037,Caleb Ekuban,48,1318200,4107483418764170,290,3055575,1646933,16470,1630463
5038,Mo El Hankouri,36,4988300,7646942007757699,489,7996160,5380434,5381,5375053
5039,Mounaïm El Idrissy,54,3937600,3894381050804498,572,7207744,6033820,604,6033216
5040,Daniel Elfadli,45,1196500,3913621363949737,226,2309683,440482,4405,436077
5041,Edgar Elizalde,34,2488200,5851457113685924,246,3685748,1502031,151,1501880
5042,Mahir Emreli,28,3935800,3270310870877453,309,5187456,855031,8551,846480
5043,Eom Ji Sung,30,2021500,5825993723103204,238,3310689,3010940,3011,3007929
5044,Yusuf Erdoğan,60,427000,4278811082653212,260,2154139,139855,140,139715
5045,Patrick Erras,23,540100,8590137342599343,67,677488,6408,0,6408
5046,Anderson Esiti,33,1875000,6064132118814936,206,3001966,2969317,2970,2966347
5047,Dani Tasende,26,3083100,6595088338448023,286,4440757,3270744,3270744,0
5048,Carlos Esparragoza,30,686600,9076405142513826,119,1164108,1135276,113528,1021748
5049,Sebastiano Esposito,49,328600,5830474372376385,209,1607729,1281916,1281916,0
5050,Gonçalo Esteves,51,1326900,3430691769795204,259,2640154,235512,2356,233156
5051,Nahuel Estévez,49,3162800,6311138848874647,443,6176984,4713159,471316,4241843
5052,Marcelo Estigarribia,34,2590300,7267594128241293,239,3801685,2995310,29954,2965356
5053,Marcelo Estigarribia,42,3893700,7404811110977421,400,6314881,989154,0,989154
5054,Giovanni Fabbian,24,2512600,7632960034881435,204,3163376,2340359,234036,2106323
5055,Noah Fadiga,33,425900,9338731993280952,118,945720,228739,0,228739
5056,Mamadou Fall,24,2860900,3073384000410931,261,4329169,4186699,41867,4144832
5057,Andrew Farrell,66,1190100,9632001263922167,343,3569689,267638,0,267638
5058,Abdul Fatawu Issahaku,69,1364800,9681022616030846,351,3590087,629496,629496,0
5059,Andrea Favilli,67,2017100,3006233541760130,415,4672365,2188199,219,2187980
5060,Aleix Febas,64,2166200,9132477577901811,433,5114408,28173,0,28173
5061,Joan Femenías,35,3999600,4498682969007240,424,6999503,2271801,227181,2044620
5062,Joca,40,1622000,8634100741950563,236,2909672,2320495,232050,2088445
5063,Clayton,67,1555900,5790394490262732,327,3370971,880816,0,880816
5064,Sebastián Fernández,47,3326800,7131183478913752,378,5759956,995057,100,994957
5065,Ronnie Fernández,41,3155300,5610342741042390,412,5440020,2946722,2946722,0
5066,Alex Ferrari,31,571200,7995773927258136,107,1074901,583105,5832,577273
5067,Cristian Ferreira,53,3141200,8546689163029274,458,5649389,4113612,412,4113200
5068,Carlos Eduardo,63,2700800,8417640650608797,410,5441365,4159658,416,4159242
5069,David Ferreiro,64,3535800,8565494552613096,533,7122755,3828256,0,3828256
5070,Cristopher Fiermarin,58,987800,9785584397661278,275,2702706,880635,880635,0
5071,Alfreð Finnbogason,58,4764100,4749285846713624,653,9308759,2209354,2209354,0
5072,Hampus Finndell,66,3401500,9190740130449450,585,7229262,6959713,696,6959017
5073,Luca Fiordilino,65,735000,6871156635597598,257,2466875,2411581,241159,2170422
5074,Ryan Flamingo,31,2305300,4752665224229937,277,3863754,3371530,338,3371192
5075,Florian Flick,52,1162000,8280811286847136,250,2546613,1820575,18206,1802369
5076,José Florentín,36,4621700,7368707095199010,465,7317474,1933162,0,1933162
5077,Yahia Fofana,40,1244800,5770374133325037,223,2629582,2380058,239,2379819
5078,José Fontán,38,3777400,5725197662652275,415,5952761,3245491,325,3245166
5079,Lyle Foster,38,2909100,4141713352624114,310,4698184,4419659,442,4419217
5080,Morgan Fox,38,1325700,7296468878032562,191,2303775,1894338,0,1894338
5081,Marcel Franke,56,4607600,8221282989337556,608,8533441,5380660,5380660,0
5082,Jérémy Frick,56,4345900,7757203365742074,534,7923251,1215633,121564,1094069
5083,Lukas Fröde,62,3558900,6406096834006984,518,7285960,6029223,0,6029223
5084,Martin Frýdek,49,1793200,5707271862381084,273,3534888,2266650,22667,2243983
5085,Leonel Galeano,47,1738000,5022176047988302,260,3121563,1312669,13127,1299542
5086,Jonathan Galván,57,3576800,4742274858321355,498,7138847,5105929,0,5105929
5087,Mateo Gamarra,69,2308500,5803563397134071,473,5487979,4698441,469845,4228596
5088,Gao Zhunyi,38,3155300,7769760143515547,393,5828898,4756918,47570,4709348
5089,Carlos Garcés,49,729000,5356119611389611,192,1781816,1069343,0,1069343
5090,Matías García,70,2075200,6511939549866441,469,5249795,3602768,360277,3242491
5091,Saúl,23,4409000,3107786028343674,383,6591260,2354172,2355,2351817
5092,Víctor García,44,1540100,4314595765779944,249,2900904,1236178,12362,1223816
5093,Juan Carlos Gauto,66,4895400,6868184151587587,685,9397431,7796455,7797,7788658
5094,Dwight Gayle,23,2997300,3824195544617855,239,3907555,1561972,15620,1546352
5095,Johannes Geis,65,4264600,8917426248260314,676,8636097,2004073,200408,1803665
5096,Paolo Ghiglione,41,4066000,9222465427679284,460,6954646,2246818,0,2246818
5097,Ben Gibson,35,436500,8102469691129595,88,761520,654308,0,654308
5098,Macaulay Gillesphey,63,497800,6990513348124590,312,2544958,356689,0,356689
5099,Álvaro Giménez,30,3526400,5223943495932918,310,5284935,3214565,322,3214243
5100,Nicholas Gioacchini,60,2061700,5977086694586380,396,4536394,609268,610,608658
5101,Klaus Gjasula,50,1981300,6488773713099024,293,3557669,3095515,0,3095515
5102,Justen Glad,28,1959600,8826461042892172,230,3353683,1771944,177195,1594749
5103,Glauder,69,486200,9058580462124134,320,2688398,1292899,1293,1291606
5104,Ettore Gliozzi,63,1070400,7235843819642868,322,3337743,1732818,173282,1559536
5105,Matt Godden,55,566100,5314767682549832,251,2081899,1684728,16848,1667880
5106,Mauro Goicoechea,51,1796500,8262427150555861,313,3563225,3162293,3162293,0
5107,Amer Gojak,40,4845700,5308189966065921,534,8045744,3444780,3445,3441335
5108,Vítor Gomes,23,3907200,8480928507749777,326,5763865,5242453,525,5241928
5109,Iván Gómez,37,1315800,8430342978789764,169,2010489,1648604,0,1648604
5110,Dani Gómez,53,4765600,9417631800592174,536,8130940,6406357,640636,5765721
5111,Josué Sá,56,1071500,7885314411853845,269,2677592,2438425,0,2438425
5112,Lucas González,57,4601800,6249377922212584,597,7615386,5585076,5585076,0
5113,Sebastián González,52,2193500,8516961513652787,373,4357455,2535475,25355,2510120
5114,Alexander González,26,4258600,6714330154261034,401,6177372,1905698,190570,1715128
5115,Diego González,53,2580400,7139866241005371,376,5024594,2337866,234,2337632
5116,Rubén Alves,61,4074900,3208836356212430,549,7472742,1518955,151896,1367059
5117,Rober,26,2925000,5573705414114136,240,4310948,601296,0,601296
5118,Fabio González,69,3927300,4271690282429482,595,7242025,2671039,268,2670771
5119,Curtis Good,69,1749500,5251048729935934,469,5086768,778524,0,778524
5120,Yeison Gordillo,54,4745500,9493486162480682,561,8719316,5610945,5610945,0
5121,Constantin Grameni,39,3772300,7730603062316081,416,6105158,319076,31908,287168
5122,Samuel Grandsir,38,3558200,8635085572568389,406,6121497,4435983,44360,4391623
5123,Adrian Grbić,70,1093000,7016024293770141,317,3181925,2339945,234,2339711
5124,Julian Green,23,1930600,4203087011108181,167,2674661,2507557,0,2507557
5125,Sam Greenwood,50,1023600,8711468034871482,277,2757071,1267352,126736,1140616
5126,Ján Greguš,25,2337000,6637946873590112,231,3520406,1424865,142487,1282378
5127,Sebastian Griesbeck,57,487000,7271367744267968,273,2371357,1238283,123829,1114454
5128,Lennart Grill,40,3859200,6958063863204331,394,6556326,5307748,531,5307217
5129,Joao Grimaldo,65,681800,6859686988244596,328,2679475,66564,6657,59907
5130,Jeppe Grønning,22,1876800,4959906594757043,135,2386916,711398,711398,0
5131,Christian Groß,69,2412900,8096238716030169,473,5568115,1764852,17649,1747203
5132,Gabriel Gudiño,53,1176800,5926493188566945,313,3029727,2642910,0,2642910
5133,Lamine Gueye,27,4685400,9807308430144215,407,6910005,4721528,4721528,0
5134,Baptiste Guillaume,65,2675600,5056731107144855,458,5204832,4909196,4910,4904286
5135,Jérémy Guillemenot,34,1691400,3022076100562282,214,2633817,1906441,1907,1904534
5136,Régis Gurtner,52,3260300,9875648595355407,471,6275851,1840990,18410,1822580
5137,Rodrigo Guth,23,3127600,4711821477288112,265,4302272,2341279,235,2341044
5138,Christian Gytkjær,42,1102600,3556895069797287,197,2245692,2105837,0,2105837
5139,Gabriel Hachen,55,4979300,7815148912595828,636,9580550,4257665,4258,4253407
5140,Oussama Haddadi,40,4479400,7994920454804883,466,6643705,3304556,0,3304556
5141,Teenage Hadebe,70,2301400,8431466909856192,496,5374808,3702649,3703,3698946
5142,Jaouen Hadjam,55,937100,9735955688992907,271,2767969,395906,396,395510
5143,Rafael Haller,34,3724900,5186211213332109,363,6078348,1217356,12174,1205182
5144,Johannes Handl,41,2654400,7610023062387595,307,4601684,2322557,0,2322557
5145,Tim Handwerker,26,1111300,6735515088376309,117,1520932,43543,436,43107
5146,Florent Hanin,61,3408600,7662690977138898,501,6724735,135052,136,134916
5147,Benjamin Hansen,35,822600,8713638080942494,156,1712526,1010734,1010734,0
5148,Kristoffer Lund Hansen,64,2909100,7259220094927655,447,5219101,1755646,176,1755470
5149,Daiki Hashioka,47,2459400,6936965734794206,369,4845548,2888883,0,2888883
5150,Philip Heise,36,4771800,9549265431945672,454,7289498,4717818,47179,4670639
5151,Eduardo Henrique,36,559400,7797546230385480,121,1074783,130988,1310,129678
5152,Diego Herazo,29,3277200,7042172827600961,276,5058833,1766111,1767,1764344
5153,Leonardo Heredia,43,2214200,5817203309981868,307,3772633,1097784,110,1097674
5154,Jonathan Heris,49,1452300,6580292925633450,257,2822109,626029,626029,0
5155,Lucas Hernández,34,3929600,8594895919398138,358,5720256,1683800,1684,1682116
5156,Jannis Heuer,27,3550000,4249846708207654,305,5290089,1821952,1821952,0
5157,Marcel Hoffmeier,68,3310500,5569238106553720,607,7002646,3554253,0,3554253
5158,Benedict Hollerbach,47,755800,4651887979175931,226,2196137,734657,0,734657
5159,Justin Hoogma,55,2926100,8885194867197027,411,5773868,4020176,40202,3979974
5160,Fraser Hornby,55,4108700,4392260831349997,515,7000836,5398230,539823,4858407
5161,Conor Hourihane,42,4780600,5063700468310356,555,7905035,97275,0,97275
5162,Robin Hranáč,27,2488200,8474664427406017,207,3534220,501196,0,501196
5163,Florian Hübner,58,694500,9489975084614129,249,2256836,1235938,0,1235938
5164,Jan Hurtado,33,518700,9126178429119063,99,897017,823777,823777,0
5165,Denis Huseinbašić,23,2161400,8477575292878512,179,3092910,548467,54847,493620
5166,Bilal Hussein,25,1283700,6610492059843800,148,1963267,843658,844,842814
5167,Antony Iannarilli,30,1026900,9116971021369628,120,1381822,1347376,0,1347376
5168,Danylo Ignatenko,57,4456000,4027896852377105,494,7556694,6070964,608,6070356
5169,Michael Ihiekwe,49,1799400,3831291435351745,316,3671111,540239,0,540239
5170,Marko Ilić,45,2432400,5756961746061188,305,4197220,4077986,0,4077986
5171,Stanislav Iljutcenko,67,4645500,8386788498582089,670,8761789,4308705,4309,4304396
5172,Nikolas Ioannou,67,4311900,7558635761460136,603,8230777,314917,0,314917
5173,Andy Irving,39,2475300,5244177034739405,294,4429929,416972,417,416555
5174,Thomas Isherwood,34,3608800,9232351079456621,427,6490162,4661923,46620,4615303
5175,Eugenio Isnaldo,52,3411800,6847817554111260,491,6833466,5704208,57043,5647165
5176,Aljaž Ivačič,60,2492900,9538774738965846,464,5388782,3796371,380,3795991
5177,Robert Ivanov,51,3994200,9505095226537982,470,7401567,1934923,0,1934923
5178,Emmanuel Iyoha,47,1454600,4741861890409451,261,2916427,1203190,1203190,0
5179,Ahmed Jahouh,69,1867500,7257275018781475,405,4624254,3571866,357187,3214679
5180,Matty James,68,3166500,9117158165384112,578,6780295,5504694,55047,5449647
5181,Saidy Janko,33,3893600,9082952438697192,384,6331381,3528138,3529,3524609
5182,Oscar Jansson,62,3880600,9877063955959551,523,6934382,6562099,0,6562099
5183,Mohanad Jeahze,24,519500,9046312309690437,42,401044,383239,383239,0
5184,Marko Jevtović,31,1242100,5671232286226422,139,1761991,1399931,14000,1385931
5185,Leandrinho,70,759700,9991043423638108,301,2768128,717108,0,717108
5186,Kamil Jóźwiak,56,4946100,6623076601412962,603,8237527,4147605,0,4147605
5187,Sebastian Jung,65,300400,6999063547666583,258,1904432,542821,5429,537392
5188,Jung Woo Young,68,4875600,7514756127424446,663,8462196,683256,0,683256
5189,Issa Kallon,51,3139300,3313017975866955,447,6139496,4495991,0,4495991
5190,Wilfried Kanga,32,1468400,5796515595407109,179,2199438,1798359,1798359,0
5191,Evans Kangwa,47,1445600,3198370872490871,258,2803469,1793475,17935,1775540
5192,Ousmane Kanté,25,2217900,5454377544959009,191,3126183,2068367,2068367,0
5193,Bartosz Kapustka,35,1083400,6447187098058656,150,1794825,1510541,0,1510541
5194,Neraysho Kasanwirjo,48,4422400,6282965799662141,483,7485342,3461865,3462,3458403
5195,Grigoris Kastanos,28,485900,8197644773575024,81,725762,237378,237378,0
5196,Florian Kastenmeier,36,308700,5880189282927266,83,616697,178278,1783,176495
5197,Elhan Kastrati,33,1540200,4735343523136070,178,2150445,161195,0,161195
5198,Nikola Katić,66,662700,7470413846196719,262,2354220,1826119,1827,1824292
5199,Noah Katterbach,40,1472500,9232280005032528,219,2766831,1350632,135064,1215568
5200,Mark-Anthony Kaye,48,1954300,6741438793537885,339,4054402,3671841,0,3671841
5201,Ibrahima Kébé,69,631200,8828727853386299,362,2922798,2456289,2457,2453832
5202,Oluwatosin Kehinde,30,3760700,6403993151740019,349,5684982,1187406,1188,1186218
5203,Jason Kerr,35,4848100,7329194905352223,480,7740165,3254081,3254081,0
5204,Kim Min Woo,48,3676500,7311879585225532,519,6805998,3432355,34324,3398031
5205,Kim Oh Gyu,35,3791000,8672944836783339,393,5827362,1061012,10611,1050401
5206,Kim Young Bin,25,3514900,7044429449686022,290,5267031,3100741,310075,2790666
5207,Gadi Kinda,28,1952000,9533434574945233,208,3064456,2528530,0,2528530
5208,Christian Kinsombi,59,629900,5530808301914135,312,2569836,152838,152838,0
5209,Cédric Kipré,38,1688400,9290561613188178,241,3075382,314976,314976,0
5210,Kai Klefisch,31,956100,5647930106619469,139,1512977,965543,966,964577
5211,Jason Knight,41,1191600,9359492247092995,204,2210041,1226615,12267,1214348
5212,Mats Knoester,60,2495200,6475937128730236,400,5097055,4548980,0,4548980
5213,Christoph Kobald,27,1892000,6019294650519839,162,2534618,1835589,0,1835589
5214,Ransford-Yeboah Königsdörffer,25,1853000,7798720946602181,199,3058611,1000519,0,1000519
5215,Yevhen Konoplyanka,47,3480800,7151708241296166,470,6321581,3411561,3411561,0
5216,Björn Kopplin,27,555800,7844308228491399,83,766425,488374,0,488374
5217,Georgi Kostadinov,61,3074000,5211973255590238,510,6095833,5779879,578,5779301
5218,Efthymios Koulouris,43,776600,4343533864815907,205,2107968,86878,869,86009
5219,Adnan Kovačević,53,847700,3900596279841417,241,2486559,233356,23336,210020
5220,Kevin Kraus,22,3088700,4294593443875892,265,4654862,4170153,41702,4128451
5221,Bas Kuipers,27,3735500,9819986106143579,357,5803495,263013,264,262749
5222,Patryk Kun,69,512800,7115072446365399,308,2668533,2278825,22789,2256036
5223,Edvin Kurtulus,58,4685100,8840575468640837,599,8956508,4714054,0,4714054
5224,Dereck Kutesa,39,2789100,9081682740570590,298,4466761,3503598,35036,3468562
5225,Berkan Kutlu,62,3164300,4067892746618280,480,6074666,1213437,122,1213315
5226,Moritz-Broni Kwarteng,34,990400,6350808072553980,159,1804643,614430,614430,0
5227,Enock Kwateng,38,1938100,6743790787983529,273,3555121,37938,3794,34144
5228,Mathías Laborda,53,1036500,4782834135209594,287,2755154,2389650,23897,2365753
5229,Yasser Larouci,54,2515700,6125632248402853,412,4844441,2974374,2975,2971399
5230,Lars Olden Larsen,41,2737500,7473213351031594,318,4328908,3230887,0,3230887
5231,Bryan Lasme,68,901500,4193657593970412,363,3226398,2440660,0,2440660
5232,Paul Lasne,24,1367400,4961400987456276,141,1957340,1764569,0,1764569
5233,Latasa,26,3646800,7968729089147599,316,5155252,799821,800,799021
5234,Emmanuel Latte Lath,24,1783100,7218655624878586,183,2420643,2276190,22762,2253428
5235,Danny Latza,43,1320800,7400568653188990,227,2786309,2664498,26645,2637853
5236,Tobias Lauritsen,51,451200,5845906408813558,191,1473477,76153,7616,68537
5237,Nikolai Laursen,52,1874100,7614341561088473,333,4072946,911584,91159,820425
5238,Dimitri Lavalée,36,450900,6457950073968404,111,885176,480580,4806,475774
5239,James Lawrence,67,2472100,6070530624428510,438,5306338,1047270,104727,942543
5240,Théo Le Bris,69,3582500,5826258819279945,557,7392136,5859396,0,5859396
5241,Randall Leal,53,1399900,7346424255998278,334,3473156,581212,58122,523090
5242,Nicola Leali,26,4044900,8339485638692328,393,6447175,1096451,10965,1085486
5243,Marcos Ledesma,38,4824000,8357527565425898,429,7469308,2393542,240,2393302
5244,Lee Myung Joo,25,4681900,4195328945960547,390,6800546,3109178,3110,3106068
5245,Lee Dong Kyeong,69,2142900,5057644603402575,405,4795303,3258923,3259,3255664
5246,Lee Ki Je,60,463500,7988953974778451,266,2335254,196351,196351,0
5247,Jordan Lefort,23,2559200,8723485899503973,190,3277627,592873,0,592873
5248,Alan Lescano,55,2958200,6605248351442558,442,5407155,1407725,14078,1393647
5249,Maxime Leverbe,58,3518700,4298557846601388,484,6649410,5581625,55817,5525808
5250,Dylan Levitt,37,3188400,9416624095710211,365,5205505,5076520,0,5076520
5251,Bruno Leyes,41,4518000,6889922921455462,481,7228313,6091605,6091605,0
5252,Li Lei,65,3820000,8588996909349964,523,7432404,1409194,1410,1407784
5253,Mansur,34,3375500,4396844194116363,361,5709591,1121580,113,1121467
5254,Dimitris Limnios,57,1841700,6356378920376423,339,3850668,2456644,2457,2454187
5255,Liam Lindsay,70,4860000,9974481674101369,713,9581699,6123888,6123888,0
5256,Liu Dianzuo,33,2608700,4112453744059829,240,3503788,1989335,198934,1790401
5257,Jake Livermore,42,4520600,7514536575290424,461,7024061,3162973,0,3162973
5258,Marin Ljubičić,54,2549300,9791347240323195,380,4851279,3257548,3257548,0
5259,Sebastian Lletget,33,1711900,5353144915787916,232,2814302,1596518,159652,1436866
5260,Victor Lobry,33,2824500,7428573964018435,255,3997654,3274616,32747,3241869
5261,Luka Lochoshvili,22,4770300,4127136434911903,362,6256366,1941658,1941658,0
5262,Daniel Londoño,63,1010800,3899721218073585,316,3136556,1783142,0,1783142
5263,Kevin Long,63,573200,6592496474898960,274,2343091,1434884,1435,1433449
5264,Julián López,35,2357500,8931802336404204,247,3618744,1716273,171628,1544645
5265,Javi López,58,2527100,8838455893134312,411,5365570,4212587,42126,4170461
5266,Álex López,25,2773300,3735786341023907,241,3951862,1860419,1861,1858558
5267,Joseph Lopy,44,4421100,4614350122766243,538,7904427,5706080,5707,5700373
5268,Iker Losada,23,2782300,8458398971431570,228,4002806,3588686,35887,3552799
5269,Loureiro,25,2519400,3631320540791653,197,3478526,917288,917288,0
5270,Raúl Alberto Lozano,43,3659700,3777517703552536,437,6295033,5395185,0,5395185
5271,Sergio Lozano,63,1233900,8199528756004720,321,3087376,75730,0,75730
5272,Ivan Lučić,67,2313100,7498319142156783,471,5481853,3248022,0,3248022
5273,Felix Luckeneder,70,1828200,5393266668054529,499,5055566,2490585,2490585,0
5274,Mauro Luna Diale,69,1812500,3317866231530216,432,4758268,1767541,1768,1765773
5275,Lucas Lund,68,3583500,6062703359581736,525,6869521,3613511,3614,3609897
5276,Youssouf M'Changama,70,3082300,8897887894472316,539,6642739,1510506,15106,1495400
5277,Awer Mabil,38,4949900,6852392592580221,526,7733461,5838389,5838389,0
5278,Tomás Ribeiro,65,2765400,7223783518598244,416,5217370,2672933,26730,2646203
5279,Shuto Machino,32,2248900,3176303127851800,239,3487923,47767,4777,42990
5280,Alejandro Maciel,49,1498200,6033850422346715,284,3014132,1310174,0,1310174
5281,Nicolas Madsen,63,3613000,3573636895576725,630,8123184,4871020,0,4871020
5282,Julien Maggiotti,67,1633000,8155453753722082,470,4584582,2243711,22438,2221273
5283,Frank Magri,33,1500700,7868273282728250,212,2678258,2155646,2156,2153490
5284,Thorsten Mahrer,65,4331800,3469415384732668,630,8535673,5927409,5928,5921481
5285,Denil Maldonado,54,3094700,5328999851110729,393,5279809,2396880,0,2396880
5286,Scott Malone,22,679600,7540271589470401,38,572958,246291,0,246291
5287,Vincent Manceau,26,4755900,6676857828943488,423,6670259,3567445,35675,3531770
5288,Cyril Mandouki,32,4014600,4494413190877501,400,6382578,825659,8257,817402
5289,Cristian Manea,67,4184200,7841763222996201,618,8131255,599194,0,599194
5290,Martin Männel,38,1099800,9858987070046358,181,2035976,2004566,201,2004365
5291,Matías Mansilla,27,4037600,7755139825682111,379,6022885,4529973,4529973,0
5292,Nico Mantl,57,4966400,4443291490263538,615,8263344,2252215,0,2252215
5293,Harisson Marcelin,58,4146600,8341513932775618,494,6944362,3617675,0,3617675
5294,Antonio Marchesano,56,2506000,5380633916010052,370,4415559,3114852,31149,3083703
5295,Sasha Marcich,23,1481100,4857045848635242,138,2005030,1256118,1257,1254861
5296,Mirko Marić,34,3595200,9696898183919391,381,5614822,4228983,42290,4186693
5297,Higinio,34,727800,9000125869698308,137,1252942,696480,0,696480
5298,Rodrigo Márquez,51,3671600,6431852984646604,483,6945035,6321035,632104,5688931
5299,Christian Marrugo,61,673100,8835722560964466,278,2416174,1094829,0,1094829
5300,Andrés Martín,50,2127700,8036493765270159,352,4175485,1548912,0,1548912
5301,Hugo Martínez,57,1595900,5190000931754494,322,3356003,876098,876098,0
5302,Tomás Martínez,68,2056500,4923692514683892,458,5255721,947199,94720,852479
5303,Marc Martínez,47,2219500,5947481791816301,361,4332990,4330543,434,4330109
5304,Marvin Martins,37,2466900,7224721229031416,273,4047535,2097990,20980,2077010
5305,Núrio Fortuna,45,705900,5832650955983937,173,1649855,788930,7890,781040
5306,José Matos,67,2714100,8661135237160469,500,5429308,3155724,0,3155724
5307,Brice Maubleu,51,2765100,4586405095015526,462,5642744,1606081,1606081,0
5308,Walter Mazzantti,56,4712900,6778267885987562,548,8076578,3419216,0,3419216
5309,Simone Mazzocchi,41,3718600,5753363630241264,440,6535013,2142550,21426,2121124
5310,Xavier Mbuyamba,40,2622500,4898413605806379,326,4519000,1975382,0,1975382
5311,James McClean,44,3697700,5070554724813191,401,5787928,3860273,386028,3474245
5312,David McGoldrick,61,3895500,8649988259457548,517,7029662,1870224,187023,1683201
5313,Jon McLaughlin,70,3826000,9052261496900426,521,6748870,2422107,24222,2397885
5314,Bamo Meïté,41,2585300,5071371624880332,375,5016818,3050653,306,3050347
5315,Kevin Méndez,44,2481700,9985658403914115,387,4798879,1478540,148,1478392
5316,Juan Ignacio Méndez,57,1234600,4112930137438144,320,3116333,1058049,10581,1047468
5317,Cristian Menéndez,32,672700,5374460341419184,106,1044466,153931,0,153931
5318,Nicolas Meriano,25,2033900,6599647114824604,154,2521370,2235679,224,2235455
5319,Maikel Mesa,52,1409300,6815258722024362,304,3516717,341480,341480,0
5320,Marco Meyerhöfer,33,369400,7079224443779493,95,693550,111070,1111,109959
5321,Alessandro Micai,47,1372900,7428036743540768,245,2892742,2441085,2441085,0
5322,Mathieu Michel,46,4345600,5757499941973167,502,6953760,2821114,282112,2539002
5323,Clément Michelin,57,3643400,5540711432833508,549,7059415,1558544,155855,1402689
5324,Florian Miguel,46,2959700,5694973120364354,394,5577523,4780939,0,4780939
5325,Enea Mihaj,33,4886100,9855150524294423,483,7532626,6235474,623548,5611926
5326,Pedro Milans,41,1298400,7384455570867843,216,2496247,46422,46422,0
5327,Julián Millán,57,914700,7820707505763807,313,2825477,2729769,0,2729769
5328,Tyler Miller,56,1810600,7286850008636800,332,3950392,2623739,2623739,0
5329,Dardo Miloc,28,4895000,5428803123230985,412,7082581,6965497,69655,6895842
5330,Billy Mitchell,48,1772200,8398553210597455,304,3506485,2678774,0,2678774
5331,Gerasimos Mitoglou,56,1581100,5290310607441703,327,3751399,3610965,0,3610965
5332,Jan Mlakar,62,1726600,7728926118968517,351,3908086,1849295,1849295,0
5333,Kevin Möhwald,62,2288100,7103334858769561,399,4720186,1125845,0,1125845
5334,Adrien Monfray,44,342400,3368737790932828,182,1341283,1122648,11227,1111421
5335,Jordy Monroy,38,2659800,3460544829394634,309,4272783,4122897,4122897,0
5336,Miguel Monsalve,57,331300,9995420142311505,245,1976605,1500709,1500709,0
5337,Fredy Montero,58,2617300,6614558119895703,456,5553451,2366884,236689,2130195
5338,Clemente Montes,65,4236300,3441181453371079,637,8651211,7514212,7514212,0
5339,Felipe Mora,65,4723400,6301057443934339,692,10013033,7473658,0,7473658
5340,Steven Moreira,53,845000,7767074581654188,255,2323345,537553,538,537015
5341,Neyder Moreno,55,4268700,5639049275146393,521,7192948,3756186,376,3755810
5342,Hildeberto Pereira,28,595800,9600382707763949,97,939145,201947,20195,181752
5343,Sergio Mosquera,49,4767200,4019371027978307,501,7740318,6800647,0,6800647
5344,Lebo Mothiba,49,2350000,9447991158611768,368,4764686,4461556,44616,4416940
5345,José Moya,42,1240900,8545299658861369,213,2386793,2104700,2104700,0
5346,Sebastián Moyano,57,4634700,3950496313390693,574,7659078,2133515,21336,2112179
5347,Paul-José Mpoku,25,2231300,3503740283397731,211,3223740,2090373,2091,2088282
5348,Miro Muheim,65,1974800,9178081946254429,383,4088145,480223,48023,432200
5349,Lukas Mühl,24,4936600,4472399129755397,355,7039909,5370604,53707,5316897
5350,Samuele Mulattieri,31,4560200,6160190019763023,408,6484338,3714061,371407,3342654
5351,Fejsal Mulić,25,2406800,7950578494329191,210,3149915,717007,71701,645306
5352,Andreas Müller,50,3318100,6208768455714018,395,5928651,5184304,519,5183785
5353,César Munder,37,1636500,9524032287006107,217,2687555,844753,0,844753
5354,Rodrigo Muniz,23,1267400,7493593343576404,139,1769827,107112,0,107112
5355,Ezequiel Muñoz,59,3014300,3538873651753593,425,5900373,5177295,0,5177295
5356,Javi Muñoz,34,2266200,9537470416193185,268,3688422,1024930,103,1024827
5357,Nicola Murru,24,1481100,3097311709279393,134,2085921,984013,0,984013
5358,Joel Mvuka,26,4799200,3304165484519791,448,7511570,4251527,4251527,0
5359,Kévin N'Doram,42,2548000,8726453180597632,322,4360807,4135775,413578,3722197
5360,Andy Najar,29,4475800,8089378137491358,371,6188590,5555845,5555845,0
5361,Nikolas Nartey,45,4476000,7858008687166450,518,7771770,3480732,0,3480732
5362,Kyle Naughton,55,540800,6516095840423259,239,1967084,1552841,155285,1397556
5363,Gustavo Navarro,43,4716100,9266010655044238,545,8062852,2253331,226,2253105
5364,Federico Navarro,56,606100,8908531743303124,248,2239413,628230,0,628230
5365,Raúl Navarro,38,4216200,4916572617967461,432,6365885,6272267,6273,6265994
5366,Rassoul Ndiaye,60,2268500,5935862239025385,418,4760314,250422,25043,225379
5367,Dieumerci Ndongala,56,917700,9193251290434059,293,2759727,638441,6385,632056
5368,Paul Nebel,67,4943700,6902251328610581,723,9756129,5728757,5728757,0
5369,Loïc Nestor,45,3292000,3631776406032306,415,5746481,4992420,4992420,0
5370,Perry Ng,41,905200,4417935235857316,221,2215198,1216450,1216450,0
5371,Roland Niczuly,51,1926100,7199200058965854,289,3333714,2061299,2062,2059237
5372,Juanjo Nieto,40,3609000,6984624389786061,386,5451225,2334961,2334961,0
5373,Jannis Nikolaou,50,2524700,5832943180472035,381,5011238,3500027,0,3500027
5374,Gustaf Nilsson,54,803100,9939687420042694,245,2145372,1222888,0,1222888
5375,Nolaskoain,30,2069200,6344070067146142,218,3327980,812565,0,812565
5376,António Filipe,25,1649900,3002338659695323,191,2590485,1934654,19347,1915307
5377,Rhys Norrington-Davies,52,1798100,6678000810778430,317,3727253,3412149,0,3412149
5378,Diego Novaretti,26,1414600,6775534509641042,141,1941094,1894633,18947,1875686
5379,Joaquín Novillo,35,913000,5330702854806806,130,1434933,842287,0,842287
5380,Hugo Novoa,43,559500,4023427397164390,199,1654024,1291331,129134,1162197
5381,Vas Nuñez,50,490400,7613650498473138,228,2014730,1933384,194,1933190
5382,Fabian Nürnberger,59,2239300,5382852635561630,384,4630645,228692,228692,0
5383,Ørjan Nyland,59,371500,6411085700385464,210,1757932,222490,0,222490
5384,Mark O'Hara,24,2223000,6218275419714006,189,2919469,1320941,133,1320808
5385,Max O'Leary,40,4693300,6515717286986559,426,7260414,5057895,505790,4552105
5386,Luke O'Nien,25,2701400,9542409626243358,222,3643614,3071419,0,3071419
5387,Michael Obafemi,42,1163500,6418715428479009,218,2390245,1600732,160074,1440658
5388,Tim Oberdorf,28,3615300,5622129727034072,374,5529972,249813,0,249813
5389,Raphael Obermair,28,1647500,8453740938918650,201,2563324,774930,77493,697437
5390,Ryoya Ogawa,70,1841500,3642628937691202,478,5142943,2501206,250121,2251085
5391,Koki Ogawa,69,1844400,9070887925703915,435,4436896,3411745,0,3411745
5392,Oh Seung Hoon,68,4792600,5398160446576533,681,9523644,2289172,0,2289172
5393,Dani Ojeda,66,3402300,5252642321510990,608,7311172,3217167,322,3216845
5394,Olaetxea,64,3442100,4165450604232171,542,6995305,5074827,0,5074827
5395,Victor Olatunji,22,2543400,5879152262563225,211,3527624,2511659,2511659,0
5396,Tiago Dantas,40,3209400,7635590349625850,377,5198746,2368022,2369,2365653
5397,Marco Túlio,60,1226700,6921153573842224,303,3178594,1281344,1282,1280062
5398,Kewin,63,1764100,3337111387528228,324,3861178,1935333,194,1935139
5399,Anderson Oliveira,38,3465300,6221962213269971,352,4998159,957833,0,957833
5400,Auli Oliveros,37,1601600,9915933401011143,261,3123857,2293185,229319,2063866
5401,Thomas Lehne Olsen,30,603500,9649651724569438,106,1057619,119143,11915,107228
5402,Jacob Ondrejka,50,3899100,9065806906236941,525,7197258,3808820,380882,3427938
5403,Fred Onyedinma,56,4918100,3262954137370999,594,8412759,1699324,16994,1682330
5404,Jayden Oosterwolde,24,4538200,4771477347825602,367,6958246,3148205,0,3148205
5405,Óscar Opazo,43,1780400,8093127391813369,263,3006109,1329119,132912,1196207
5406,Ulises Ortegoza,37,4029400,5602481370793358,400,5888402,1043243,0,1043243
5407,Guillermo Ortíz,28,2741800,9051890001465712,276,4578385,2389162,239,2388923
5408,José Ortíz,24,533300,7765056849670671,48,494445,196242,1963,194279
5409,Abiel Osorio,65,1930400,9639506319848499,376,4466630,1119196,1119196,0
5410,Luca Oyen,49,3603000,4605391568003952,422,5916056,3093197,0,3093197
5411,Liam Palmer,39,4849500,5391776597498851,504,7304484,1593759,15938,1577821
5412,Kasey Palmer,26,3803600,5925403441461705,362,6118388,3730946,373095,3357851
5413,Alex Palmer,24,3027700,7751301337687407,286,4377727,3107316,0,3107316
5414,Jonathan Panzo,60,419300,7001131540307017,266,2200653,81805,0,81805
5415,Kevin Paredes,32,2735100,4295826956402505,278,4038363,18135,18135,0
5416,Tim Parker,68,3951400,7636455948040982,621,8024100,1894902,189491,1705411
5417,Abdulkadir Parmak,68,2871100,9432320271530751,492,6070270,2334894,233490,2101404
5418,David Pavelka,58,1469100,8001712679195153,359,3660294,2697589,26976,2670613
5419,Bailey Peacock-Farrell,55,4879200,5617420896818014,546,7511379,214834,0,214834
5420,David Pech,68,2977800,8949492362545301,544,6936746,5965522,0,5965522
5421,Kristian Pedersen,69,1111100,8980103131708453,389,3552223,2685376,26854,2658522
5422,Gianluca Pegolo,37,1988700,9566442467694258,247,3523964,269660,0,269660
5423,Peter Pekarík,43,822100,9069569488048112,177,1720862,1359651,1359651,0
5424,Alisson Safira,56,4451800,9798805489239916,542,8276614,1468625,147,1468478
5425,Matías Pellegrini,28,4164200,6676639023416289,356,6237248,3600327,0,3600327
5426,Marco Pellegrino,43,1986400,9070622831273246,287,3538742,1365992,1366,1364626
5427,Felipe Peña,56,3582200,9626345838198057,527,6870092,122197,12220,109977
5428,Geisson Perea,32,3114200,5598447924336441,283,4518334,2637262,26373,2610889
5429,Damián Pérez,33,436900,8350846789832906,103,800565,217567,2176,215391
5430,Danny Pérez,22,913800,6655611514557463,65,1006742,545491,545491,0
5431,Gonzalo Pérez,58,993000,7539000070117944,291,2918075,2209529,2209529,0
5432,Pedro Perlaza,33,1894600,4710168062992696,198,2984718,1680344,0,1680344
5433,Jean Carlos Pestaña,69,1471100,6878375652866805,403,4265947,97475,9748,87727
5434,Claudiu Petrila,69,1371600,9076032385780239,423,3998182,3947454,0,3947454
5435,Léo Pétrot,28,637600,6696816993994349,94,892735,834795,8348,826447
5436,Matt Phillips,35,4521500,8207761227304405,460,7072626,3465434,0,3465434
5437,Jaden Philogene,29,3375500,4059962248873053,318,5129541,2154839,215484,1939355
5438,Fafà Picault,59,487300,5308283742920394,274,2153299,1419695,0,1419695
5439,Cristiano Piccini,57,1485900,7874041748705541,337,3737010,1608619,160862,1447757
5440,Roberto Piccoli,48,882100,4847465453854745,206,1999883,938559,9386,929173
5441,Florian Pick,53,2342100,9739623513675381,355,4812226,2274814,0,2274814
5442,Charles Pickel,66,3256700,9218707286754001,556,7096007,4552113,4553,4547560
5443,Santiago Pierotti,32,4263000,5862807828786800,458,7323120,3666624,0,3666624
5444,César Pinares,26,1154200,7115755933204871,137,1827371,1049182,105,1049077
5445,Bruno Piñatares,22,4383700,5126430011489281,353,5926307,2975515,0,2975515
5446,Rafael Barbosa,47,1121000,3492704763096917,254,2664526,531249,532,530717
5447,Oscar Piris,35,1389200,4533465622172812,169,2163224,1835728,183573,1652155
5448,Bruno Pittón,31,715600,5586519551778793,99,1092900,173919,1740,172179
5449,Rodolfo Pizarro,38,1687700,4850741206437059,210,2851889,1656864,1656864,0
5450,František Plach,39,4482000,7233776859962869,485,7482217,7196516,0,7196516
5451,Przemysław Płacheta,63,2393700,4047629630808124,451,5280225,4835021,483503,4351518
5452,Tin Plavotic,41,4681700,5859779744705320,456,6915713,2921115,0,2921115
5453,Pleguezuelo,45,405000,7582105100271263,151,1307747,482705,0,482705
5454,Andy Polar,26,4981100,9816764892933224,462,7289806,6810473,68105,6742368
5455,Paxton Pomykal,68,3687600,8581850894900566,551,6724661,1534175,1535,1532640
5456,Manolo Portanova,41,2794000,4186179146123107,297,4725929,954996,95500,859496
5457,Brad Potts,56,2182800,6725293926750881,423,4924202,1638962,1638962,0
5458,Cameron Pring,68,4119000,5669915177405533,605,8568943,579801,579801,0
5459,Alex Pritchard,50,2629200,5111436031788475,403,5260874,3451156,0,3451156
5460,Tymoteusz Puchacz,35,1767800,3999686990039747,196,2592107,1138735,114,1138621
5461,Raffaele Pucino,25,673700,7374615238400413,58,696593,633489,633489,0
5462,Arnau Puigmal,59,4387700,9788437446361704,535,8018418,3059733,305974,2753759
5463,Eduardo Quaresma,69,1518300,4711729039093426,474,4721361,1110528,11106,1099422
5464,Déinner Quiñones,27,2388300,5395264633159382,211,3237882,1754219,1755,1752464
5465,Joe Ralls,34,2055200,7231313254217156,240,3145439,855812,856,854956
5466,Anthony Ralston,63,1867000,8936338747014196,351,4037377,1990792,199080,1791712
5467,Ylber Ramadani,64,712000,3101638327401421,295,2726713,344706,3448,341258
5468,Iván Ramírez,69,4767300,7857165363641797,724,10159621,42010,42010,0
5469,Alejandro Ramos,28,4499100,7537378800096213,405,6326660,2076916,0,2076916
5470,Joe Rankin-Costello,30,1815700,3239273845078547,171,2698284,1141539,0,1141539
5471,Filippo Ranocchia,63,1895400,3952115297906229,400,4660286,3868548,38686,3829862
5472,Nicolai Rapp,58,4778000,3483226083674602,564,8046781,6729958,673,6729285
5473,Joher Khadim Rassoul,67,1468800,9585421330778125,354,3486509,3383866,33839,3350027
5474,Andrei Rațiu,40,599300,4993529552678228,188,1727317,1512347,152,1512195
5475,Rayan Raveloson,26,3220300,6047957419337258,297,4456107,4281919,429,4281490
5476,Martín Rea,39,4848000,3752704726060393,471,7692504,4429239,0,4429239
5477,Juan Carlos,40,1171900,6831457406949568,202,2398354,726136,72614,653522
5478,Abderrahman Rebbach,28,3243200,6851971346406258,303,4880135,1042490,105,1042385
5479,Jorge Recalde,52,2602100,3174201949348672,385,4956186,4107594,41076,4066518
5480,Erlend Dahl Reitan,25,4265000,9417056425158034,369,6074971,1719652,1720,1717932
5481,Nicolás Reniero,30,1545700,9733611727321869,175,2468546,2354903,2355,2352548
5482,Guillaume Restes,24,4747400,7453685183124952,436,6932771,540544,541,540003
5483,Oriol Rey,51,4420000,6402559390940774,576,7484913,5244459,525,5243934
5484,Andrés Reyes,57,1643400,7045510318560794,352,3883575,2843649,0,2843649
5485,Lorenzo Reyes,69,2666300,3357172591889679,464,5635363,5022377,503,5021874
5486,Brayan Riascos,31,3317000,4707966438386620,329,5223591,3442075,345,3441730
5487,Amir Richardson,32,2689100,4398925527601889,275,4025111,301351,0,301351
5488,César Rigamonti,25,1009800,3157365477773534,98,1284846,496972,497,496475
5489,Rubén Darío Ríos,68,3219700,9742022411921365,523,6604543,5394607,540,5394067
5490,Ríos Reina,33,3369800,9892444783470790,345,5341309,5260571,0,5260571
5491,Rémy Riou,64,3259100,8575144720223937,489,5968703,4349026,4349026,0
5492,Andrea Rispoli,28,2032300,8964725273615775,188,2751422,2118493,211850,1906643
5493,Ciro Rius,29,2193500,8006140899591521,198,3167984,2664699,0,2664699
5494,Christian Rivera,47,1885000,9081728056678448,298,3566254,1164314,116432,1047882
5495,Rodrigo Rivero,44,2302900,5674667310399002,327,4131921,1728659,172866,1555793
5496,Carlos Rivero,51,2369900,4608198587749691,421,5011812,3908484,390849,3517635
5497,Cristian Rivero,30,4747300,4388108784541647,470,7246700,6506775,6506775,0
5498,Rúben Lima,60,4178300,8139297153391520,546,7552974,1601698,160170,1441528
5499,Jannik Rochelt,47,2410400,7331320478385942,341,4454659,2765746,0,2765746
5500,Igor Thiago,29,3514400,5572197720501409,319,4897239,807918,807918,0
5501,Rúben Ribeiro,67,3617100,9625893893052803,531,6969562,2544049,0,2544049
5502,Facundo Rodríguez,31,3856800,4261218227101318,360,5612462,4814698,0,4814698
5503,Santiago Rodríguez,56,3650300,6230410325424956,467,6473259,4758655,4758655,0
5504,Arley Rodríguez,42,3979000,8767789539552659,403,6164148,4732572,0,4732572
5505,Salomón Rodríguez,26,2289400,5908468176604168,243,3580032,3235809,323581,2912228
5506,Alan Rodríguez,25,1127100,4135740555103250,99,1435128,1287569,129,1287440
5507,Riki,62,1313000,3139834083133699,365,3520243,2979989,2980,2977009
5508,Maximilian Rohr,42,4456000,3140575839174231,552,8422538,7927515,7927515,0
5509,Leo Román,51,1259800,3505366818230351,293,3067754,1846327,18464,1827863
5510,Taras Romanczuk,53,369600,7537629740501200,232,1705276,545644,0,545644
5511,Nicolás Romero,39,3272100,8936021768645671,417,5794557,3847429,3847429,0
5512,Santiago Romero,57,1638700,7062267641987653,316,3534287,244064,2441,241623
5513,Luka Romero,49,2578700,7812990893780734,340,4711329,406378,4064,402314
5514,Michael Rose,40,1539400,7663970094030468,206,2552169,1261656,127,1261529
5515,Dany Rosero,22,2182100,8654058548157722,206,3050121,2590312,0,2590312
5516,Steve Rouiller,58,3655300,6391636834641344,538,7511479,5473130,0,5473130
5517,Kevin Rüegg,66,2686400,3094942547178822,444,5405598,4670546,467055,4203491
5518,Matteo Ruggeri,35,4647600,4954875606791328,461,7142671,3704683,0,3704683
5519,Jean Ruiz,45,903200,3004954752123784,200,1919300,1419403,1419403,0
5520,Ryu Jae Moon,25,2645400,9302424887180094,220,3612598,3282293,0,3282293
5521,Ignacio Saavedra,61,4353700,9003421493897367,658,8748170,4701217,470122,4231095
5522,Cheikh Sabaly,67,469500,4024912769411269,254,2056201,68170,682,67488
5523,Michal Sáček,65,1852400,6721268219904269,424,4723384,2213845,221385,1992460
5524,Moïse Sahi,45,4629000,8470046798426335,557,7658847,3286481,328649,2957832
5525,Théo Sainte-Luce,42,3050200,9768413011167606,353,5062813,4510159,0,4510159
5526,Marco Sala,67,2351900,3846972417974753,524,6043720,161984,0,161984
5527,Shurandy Sambo,43,526000,3813757767771112,189,1654366,1300371,130038,1170333
5528,Adrián Sánchez,38,3969400,3906114434762342,446,6457130,4979003,0,4979003
5529,Juan Sánchez Miño,64,4598100,8480236764679922,628,8293708,3628503,36286,3592217
5530,Philipp Sander,60,1519400,9861619744018029,328,3350137,972942,973,971969
5531,Federico Santander,34,4544800,6901180838528651,409,6324719,3917328,3917328,0
5532,Hernâni,22,1403100,3088723105150516,139,1884686,903909,0,903909
5533,Derick Poloni,40,2380900,5578539798793259,288,3814909,1876243,188,1876055
5534,Kingsley Sarfo,37,2474900,7280902019859582,295,3982637,902203,902203,0
5535,Dario Šarić,37,3840200,6846376936379048,438,6454520,2183851,2183851,0
5536,Elías Sarquis,36,4943500,6299159809142583,541,7875311,6924321,6924321,0
5537,Ľubomír Šatka,27,4467400,4193318105419756,374,6290583,5518880,5519,5513361
5538,Filippo Scaglia,23,1082300,3131323845355200,104,1403307,439893,0,439893
5539,Dan Scarr,49,1817800,6906708916277870,308,3707147,2004967,200497,1804470
5540,Thorsten Schick,46,721600,5013135446076379,196,1902563,1235219,0,1235219
5541,Kingsley Schindler,26,4267300,7649125260433650,373,6516252,318702,31871,286831
5542,Fabian Schnellhardt,29,4915500,3743013905960038,485,7948816,7880257,7881,7872376
5543,Josh Scowen,58,3092400,4508274226418845,451,5620378,4383036,0,4383036
5544,Vladimir Screciu,36,678500,5719735239625717,132,1250115,655261,655261,0
5545,Eddie Segura,68,1603900,8190707968310399,437,4408497,2810304,2810304,0
5546,Josep Señé,34,4623900,8447503034387984,427,6878950,1886728,188673,1698055
5547,Bruno Sepúlveda,50,1328900,9540673266167066,280,2923764,15403,0,15403
5548,Janni Serra,64,4219900,9829439227582696,552,7692226,1875350,18754,1856596
5549,Samuel Shashoua,62,3546900,9705286488434711,535,7260629,4236912,4236912,0
5550,Graeme Shinnie,28,3770400,7113155568763486,298,5024643,3633071,363308,3269763
5551,Toby Sibbick,64,1178300,6476801526287833,374,3616588,3389231,338924,3050307
5552,Benjamin Siegrist,62,4616200,5580797396692198,546,7693603,7074854,0,7074854
5553,Kaj Sierhuis,55,686900,9548741973007385,280,2406615,1222485,0,1222485
5554,Kendrys Silva,58,4843800,6107019703396083,647,9496948,9322062,9322062,0
5555,Walterson,28,4716500,3018246431834446,386,6728107,1836424,1836424,0
5556,Rui Costa,54,1971000,4822784302613623,352,4026558,2347592,2348,2345244
5557,André Luís,51,3316000,3923101904753224,459,5768065,2407491,240750,2166741
5558,Ba-Muaka Simakala,24,510200,6037978159317345,42,414140,131749,0,131749
5559,Danel Sinani,56,2951900,3692505588816703,463,5902872,1688521,1688521,0
5560,Nikola Šipčić,62,561800,7233860249665843,313,2669785,1394125,13942,1380183
5561,Bartosz Slisz,70,1507200,6515865330547162,350,3678227,3436300,3437,3432863
5562,Michael Smith,32,3458500,5230272095644937,316,5135794,485277,485277,0
5563,Alex Smithies,24,4166900,9112063694644107,355,6428406,1817806,181781,1636025
5564,Jesús Soraire,45,695700,5543068027034012,156,1569300,1321331,133,1321198
5565,Jacob Sørensen,58,2713300,6628270052162313,438,5177386,2996217,2997,2993220
5566,Deian Sorescu,45,2935300,4614080763028575,375,5307910,3369875,3370,3366505
5567,Leandro Sosa,67,2786600,4764323241726880,509,6174954,491295,49130,442165
5568,Ismael Sosa,44,2165100,3495685678737631,308,3734609,2988170,298817,2689353
5569,Eduardo Sosa,64,1575800,3559417676180107,360,3785289,1858108,1858108,0
5570,Leandro Sosa,29,1658800,8346388938624225,173,2543721,2353279,0,2353279
5571,Marquinhos,31,2130800,7406746449341319,219,3452355,1437655,143766,1293889
5572,Saïdou Sow,52,816300,3679331411708446,283,2665203,275361,2754,272607
5573,Dennis Srbeny,39,3220900,8795358916655523,337,5078075,746101,0,746101
5574,Marius Ștefănescu,63,4324300,5840110627143298,600,7881061,3098740,0,3098740
5575,Pascal Stenzel,49,1602500,8201484487612263,267,3142343,965180,965180,0
5576,Greg Stewart,26,445300,8904387749256765,86,758915,364170,364170,0
5577,Dante Stipica,62,3300200,3921314325412108,575,6827873,1370652,0,1370652
5578,Max Stryjek,37,623100,5719495918057180,123,1084111,1036748,103675,933073
5579,Lucas Suárez,50,2454600,9123536572540284,388,4963361,3162823,31629,3131194
5580,Pavel Šulc,26,4642000,4838630640631917,365,6959455,3011637,3011637,0
5581,Mateo Sušić,29,2037900,7544704501920139,198,2789911,1790097,179010,1611087
5582,Gustav Svensson,47,2476600,7750960881795220,368,4781305,623250,624,622626
5583,Sammie Szmodics,68,1981100,4575544415185869,466,4847752,2751237,276,2750961
5584,Haris Tabakovic,23,659500,7755439045189487,33,494204,59491,0,59491
5585,Panagiotis Tachtsidis,63,1970800,3109606087141558,404,4614142,1713059,17131,1695928
5586,Anas Tahiri,46,2349200,8633508182502128,320,4222414,973079,0,973079
5587,Fabian Tait,23,2867300,4261647814458152,202,3575667,1891521,18916,1872605
5588,Maksym Taloverov,49,3017900,5664145668905651,454,5918395,2131459,2132,2129327
5589,Chiquinho,52,3804700,7980038777876228,445,6620242,914507,9146,905361
5590,Elayis Tavşan,54,1361100,8042279078325772,261,2860660,2426429,0,2426429
5591,Jack Taylor,60,977600,5876702963168600,320,2910145,1201560,1202,1200358
5592,Robert Taylor,48,2023800,6462421294131220,319,4021764,2163967,2163967,0
5593,Malik Tchokounté,68,2448400,6418241704592568,479,5450885,5064464,0,5064464
5594,Hidde ter Avest,49,2291800,7408630364608113,337,4136119,307399,0,307399
5595,Filippo Terracciano,26,1928200,9508552015404239,164,2639123,2326257,0,2326257
5596,Norman Theuerkauf,39,1462400,8593299254435779,231,2581490,35227,35227,0
5597,Denis Thomalla,59,664500,7616111582705281,256,2089940,233299,0,233299
5598,Lawrence Thomas,67,3282800,7290514821595329,540,7068490,5046365,505,5045860
5599,Ryan Thomas,36,2800500,3643763252472876,287,4093064,2163484,216349,1947135
5600,Steffen Tigges,59,2263000,7328855638128283,380,4465504,1518977,1519,1517458
5601,Mohamed Tijani,28,4765400,7801391127677472,440,7484737,7056809,7057,7049752
5602,Muhamed Tijani,69,4510300,8170660949632441,607,7831355,7065095,0,7065095
5603,Javier Toledo,66,4733600,7768545883740055,641,8798275,7876978,788,7876190
5604,Santiago Toloza,64,563500,3722628746980950,289,2457783,2190882,2191,2188691
5605,Michal Tomič,61,1732700,6821348152681141,386,4397618,637499,0,637499
5606,Torrente,62,1749600,3251040505268365,362,3712195,2599453,0,2599453
5607,Iván Torres,59,4646600,4016888209622638,658,8541678,6622087,0,6622087
5608,Wil Trapp,54,957900,4555901177916096,275,2837651,2789082,0,2789082
5609,Arnór Ingvi Traustason,43,1502300,7121606923660575,239,2804652,267159,268,266891
5610,Alfonso Trezza,37,502900,7110805072919508,116,1023882,438344,4384,433960
5611,Frank Tsadjout,51,2672900,4817758354117781,379,4636925,4502823,45029,4457794
5612,Kevin Tshiembe,53,2711900,7048523033604204,412,5366603,977117,0,977117
5613,Theocharis Tsingaras,53,2154300,3080780304709773,392,4811949,4435764,4435764,0
5614,Jeppe Tverskov,34,4066700,4839311841263965,399,6203080,1007266,0,1007266
5615,Undabarrena,40,4026700,6532739907414987,441,6754738,2802692,2802692,0
5616,Luis Urruti,69,3605100,3421549098108580,605,6833412,8236,8236,0
5617,Leo Väisänen,44,2264700,8461175317412408,329,4258677,613481,6135,607346
5618,Nicola Valente,53,447200,6891941273953365,197,1632497,1119628,0,1119628
5619,Lautaro Valenti,53,3939900,8320892263390014,511,6491532,2804485,0,2804485
5620,Milton Valenzuela,25,615700,4560662451616109,49,610382,115126,1152,113974
5621,Myron van Brederode,32,3087800,8145370646457081,294,4894066,4692951,4692951,0
5622,Mark van der Maarel,61,1083300,8129391226588621,297,2898910,1844976,18450,1826526
5623,Richard van der Venne,28,4083700,7460212600533361,351,6483119,3328893,0,3328893
5624,Vladyslav Vanat,56,4313200,5997817660856611,581,8382591,1412297,1412297,0
5625,Hugo Vandermersch,51,4745800,7496394595618149,539,7743898,1976415,1977,1974438
5626,Brenner,57,1220700,6128071916031156,309,3130957,238180,0,238180
5627,Cristian Vargas,27,1767600,6715842585475387,158,2421141,2869,0,2869
5628,Jersson Vásquez,53,433700,8444830678946165,212,1760264,1562815,1563,1561252
5629,Will Vaulks,66,4593000,8515803039697400,598,8325216,4430434,44305,4386129
5630,Stiven Vega,60,3852100,8496762378921642,513,7258044,4977584,49776,4927808
5631,Kristoffer Velde,65,4918700,3080930211058662,605,8554058,4440647,4441,4436206
5632,Federico Vera,60,2556300,8259841677656924,442,5200745,5101679,51017,5050662
5633,Matías Vera,56,465100,7672677245472306,242,2093117,972506,973,971533
5634,Hobie Verhulst,48,1958300,9229576662055746,266,3243370,2682082,269,2681813
5635,Ranko Veselinović,52,4255700,7859066824917838,542,7461997,4185331,4185331,0
5636,Fabián Viáfara,52,4250000,5003700784741085,443,6794688,4026005,403,4025602
5637,Clément Vidal,25,4680800,4157723336275881,392,6557098,3640247,365,3639882
5638,Vieirinha,39,2247400,7899175873871360,328,4103761,3978392,3978392,0
5639,Fran Villalba,58,1110100,8003788560672494,356,3529813,788681,78869,709812
5640,Sam Vines,42,451000,6634410534255301,176,1508754,439628,43963,395665
5641,Guillermo Viscarra,51,2223600,7607074794586046,351,4306260,1712285,0,1712285
5642,Tomáš Vlček,66,3858500,8879833354332546,528,7274035,5188401,5188401,0
5643,Idriz Voca,69,532800,6562919635020064,283,2240591,17108,17108,0
5644,Vojtěch Vorel,60,3677100,8214531724490921,482,6706231,1581332,159,1581173
5645,Aleksandar Vukotić,30,2700600,9102423096273426,260,4088464,2071653,208,2071445
5646,Güray Vural,41,1596200,3526746690463480,270,3187599,89873,899,88974
5647,Linus Egnell Wahlqvist,38,3743300,8542253207158307,364,5572681,3026374,30264,2996110
5648,Mubarak Wakaso,41,3452800,6269569198069497,386,5814935,295263,2953,292310
5649,Sandy Walsh,59,515700,6222401656912207,251,2091183,1609586,1609586,0
5650,Franco Watson,68,2323900,4954293372803495,494,5784212,2913086,292,2912794
5651,Wei Shihao,25,4244800,5915886560926117,360,5876807,328203,0,328203
5652,Noah Weißhaupt,61,1719100,7543283375776354,340,3794903,2027232,2028,2025204
5653,Nahki Wells,69,3972900,9336144724010321,612,8375678,307632,0,307632
5654,Jack Whatmough,57,3007500,7266646702801015,445,5454618,317030,0,317030
5655,Brian White,35,3870600,8141449394847824,429,6171128,3576728,358,3576370
5656,Jetro Willems,57,999100,8572838672493233,252,2624445,2291311,0,2291311
5657,Eryk Williamson,23,3418600,3788039170679385,303,4663663,2378935,23790,2355145
5658,Ben Wilson,39,2863400,5960734833968543,309,4499203,703957,703957,0
5659,Nicolas Wimmer,26,1431800,5298499134405648,168,2256663,1836937,0,1836937
5660,Lewis Wing,48,585500,6746786891144808,211,1899632,157135,157135,0
5661,Ryan Wintle,43,1219100,7257018713366406,252,2924248,442733,0,442733
5662,Cauley Woodrow,34,2348400,9236612462857881,254,3810177,3769512,376952,3392560
5663,Luke Woolfenden,30,704600,6855229249665815,89,977946,329875,330,329545
5664,Wu Xi,33,3847200,9239172719676969,364,5680073,3549529,3550,3545979
5665,Taulant Xhaka,22,4912100,5678228517105382,419,7713961,3496176,0,3496176
5666,Xie Pengfei,31,3776700,3732022465060062,347,5601050,2544615,254462,2290153
5667,Kevin Yakob,52,1084000,6647976173866612,270,2675466,433727,0,433727
5668,William Yarbrough,41,4509500,9562775984817549,442,6852821,2729873,2729873,0
5669,John Yeboah,31,2639200,6394881481389532,304,3945267,3056676,0,3056676
5670,Andy Yiadom,62,3647600,7810279747825543,531,6669586,4136616,41367,4095249
5671,Yu Sang Hun,24,388500,8087506918790474,63,501073,105493,10550,94943
5672,Jackson Yueill,47,4043900,8346942416675777,420,5980147,5825163,583,5824580
5673,Óscar Zambrano,65,3245400,5797052881079912,494,5937077,3887431,38875,3848556
5674,Alexis Zapata,41,2064300,5821847781755615,281,3679978,785743,786,784957
5675,Andi Zeqiri,33,4105400,5940869697023049,360,5692813,1678609,0,1678609
5676,Jacob Widell Zetterström,39,3444600,7119346943391392,376,5827020,3008419,0,3008419
5677,Zhang Linpeng,23,2664200,3684095891955556,225,3729976,566343,56635,509708
5678,Leopold Zingerle,34,4960700,9436737945745432,522,7802557,6998627,0,6998627
5679,Živko Živković,45,2844000,6860948242364818,373,5242729,2596059,0,2596059
5680,Elady,49,746800,7991531117884128,186,1661514,644041,645,643396
5681,Ishaq Abdulrazak,53,762500,7781864785801850,233,2139504,825002,0,825002
5682,Dirk Abels,62,2127000,7748641013988860,443,4963449,1679256,0,1679256
5683,Myenty Abena,37,1978400,4061634583237995,277,3466822,65910,6591,59319
5684,Akor Jerome Adams,25,2022800,5526281649266131,169,2922245,701563,702,700861
5685,Shawn Adewoye,46,3209200,9994800093491382,378,5598004,5417039,5418,5411621
5686,Braian Aguirre,31,1496100,4756446071861382,161,2178635,1057917,106,1057811
5687,Matías Aguirregaray,64,2425100,3030566750360433,434,5357818,4164993,0,4164993
5688,Anouar Ait El Hadj,57,2457500,8825994021204988,404,4894173,1621916,16220,1605696
5689,Bashkim Ajdini,63,2370500,5641063184975654,513,5876902,2925033,2926,2922107
5690,Maghnes Akliouche,68,4116600,9216133089959646,623,8378932,2242450,225,2242225
5691,Fatih Aksoy,50,1575600,9431663911772311,247,2883631,2454215,246,2453969
5692,Mohammed Al Buraik,28,2213200,6398826436606676,199,2918865,1397283,140,1397143
5693,Muteb Al Harbi,39,2343600,8915598432165877,286,3918757,253196,254,252942
5694,Abdullah Al Khaibari,49,2092200,7549814244073075,315,3651863,2542878,254288,2288590
5695,Abdulelah Al Malki,66,1600300,5753655172002974,345,3938625,3267500,327,3267173
5696,Sami Al Najai,45,1739500,4379483651863337,295,3550701,1364132,137,1363995
5697,Hussain Al Qahtani,61,3591900,6459884741647843,562,7111023,6244074,6245,6237829
5698,Muhannad Al Shanqeeti,53,4410200,8493487682703590,569,7649960,4864084,4864084,0
5699,Saleh Al Shehri,38,1784000,6867707169035693,238,3028118,408890,0,408890
5700,Andreas Albers,53,4970200,6489654599996374,526,8031434,3453773,346,3453427
5701,Omar Albornoz,53,4079600,7907873717752246,514,7368883,3705564,0,3705564
5702,Dragoș Albu,41,4434100,6625641721970788,480,7053172,4293046,0,4293046
5703,João Victor,34,3611100,3445152867438517,340,5594760,617089,0,617089
5704,Algobia,66,1857300,7405560036321182,418,4680478,3388562,0,3388562
5705,Taha Abdi Ali,68,3495700,3927824347410806,557,6639647,3943390,394339,3549051
5706,Ali Alipour,32,1013600,6650232945357936,158,1712345,24438,24438,0
5707,Jamie Allen,31,2079900,3994720603001648,211,3040008,1914113,1914113,0
5708,Rasmus Alm,63,2349500,7602685631361044,400,4574343,1793433,180,1793253
5709,Pontus Almqvist,37,1459300,6696441237884364,196,2553789,1658252,16583,1641669
5710,Julio Alonso,30,4468500,7956826967053243,441,6734130,2383974,238398,2145576
5711,Altimira,54,1593500,5837160190299644,331,3780755,2722546,2723,2719823
5712,Tiago Araújo,68,3447000,9027933771687947,587,7887446,7820197,0,7820197
5713,Pedro Henrique,47,2667700,7290841155379006,384,5343736,1522482,152249,1370233
5714,Ibrahim Amadou,63,1895800,5461094019062618,404,4489622,3584180,359,3583821
5715,Frankie Amaya,39,3921700,9861271178845601,445,6138859,1626265,162627,1463638
5716,Stephan Ambrosius,53,769200,4429424675724248,238,2186280,696194,696194,0
5717,Mohamed Amoura,46,852400,7332926121364916,204,2012960,1112078,11121,1100957
5718,Magnus Kofod Andersen,24,4907800,9833938403242085,367,7164294,3286525,3286525,0
5719,Keshi Anderson,50,2331500,9815703776751906,356,4580126,3353014,3354,3349660
5720,Florin Andone,47,2286000,8819407685867898,307,4186020,3117626,0,3117626
5721,Juan Andrada,39,2992900,6402099537585850,356,5396400,4720724,47208,4673516
5722,Andrés Andrade,66,2390500,3550107414067332,454,5171447,709109,709109,0
5723,Stelios Andreou,64,3064500,7126481287574732,530,6764895,2938735,293874,2644861
5724,Oleksandr Andrievskyi,70,4658900,4036856323604815,608,8695980,1270312,1270312,0
5725,Wilker Ángel,46,631000,5363193572861425,179,1584775,1035098,0,1035098
5726,Tomás Ángel,29,4782500,7409785080131094,463,7433365,4416795,0,4416795
5727,Jeison Angulo,45,2147900,7968321105135683,343,4488543,4179386,0,4179386
5728,Anderson Angulo,33,2187300,9531047604644995,250,3613231,2589436,2589436,0
5729,Estéfano Arango,39,4257400,5463390717307964,429,6853115,1768417,176842,1591575
5730,Tomás Aránguiz,57,597400,8473836148416208,224,1963688,402059,40206,361853
5731,Alejandro Araque,26,1628700,9655396720537786,150,2123493,322570,32257,290313
5732,Carlos Arce,28,4926700,9362615484129504,437,7540388,1296652,1296652,0
5733,Areso,31,504300,4909580119021052,106,871912,268208,268208,0
5734,Jaime Arrascaita,24,1622600,4407347100448237,126,2213435,1723207,1723207,0
5735,Xavier Arreaga,56,1572200,8265507147304832,322,3390582,1177434,118,1177316
5736,Tommaso Arrigoni,46,325600,6598824547695382,180,1383968,149079,1491,147588
5737,Jasir Asani,56,1798800,3123767143386607,340,3808121,2077523,208,2077315
5738,Simon Asta,36,3902900,4512735018631422,381,5850751,332268,33227,299041
5739,Luciano Aued,46,2990800,8307135628647184,393,5254899,2407639,2408,2405231
5740,Kouame Autonne,64,3259700,7794207197347162,530,6857644,6726630,0,6726630
5741,Felipe Avenatti,49,2425800,7139967496508985,387,4793640,4502924,0,4502924
5742,Tomás Avilés,53,2782400,4165023899153541,449,5372071,4391539,440,4391099
5743,Soner Aydoğdu,48,1294000,3275012276810134,256,2595024,2048712,204872,1843840
5744,Marouan Azarkan,51,2725900,5309300371299624,359,4863773,3661452,3661452,0
5745,Keanu Baccus,32,2435900,7921484755465558,240,3529242,1890744,1890744,0
5746,Yassine Bahassa,65,4920800,4149264352298847,600,8813917,4757019,47571,4709448
5747,Riad Bajić,28,1487200,7620054941517856,164,2203127,1940966,0,1940966
5748,Mushaga Bakenga,41,3355800,3399224237612613,411,5367127,3805114,3805114,0
5749,Bünyamin Balcı,63,1890500,7203351207882553,384,4233802,1022936,1022936,0
5750,Aliou Baldé,31,2767100,7126405253188751,253,3877938,3104267,311,3103956
5751,Gonçalo Franco,57,1824400,3205579802867645,357,4146411,2943343,0,2943343
5752,Barbu,31,3783900,7742953972303781,315,5444587,1314650,0,1314650
5753,Antonio Barreca,70,4041100,8941881758624389,598,7908473,530918,530918,0
5754,Michaël Barreto,48,1270800,9834169254300588,269,2802646,1680284,169,1680115
5755,Lucas Bartlett,44,3457600,8448739010838538,397,5475905,5167744,0,5167744
5756,Enzo Basilio,44,742200,8340824513840123,173,1756662,1268650,1268650,0
5757,Emrah Başsan,39,4346600,4378038174960409,462,7391108,2593209,0,2593209
5758,Amine Bassi,38,2386600,6325554060163950,262,3878789,1538212,1538212,0
5759,Patrick Bauer,39,3975200,3231547502247235,419,6454710,5166730,0,5166730
5760,Bilal Bayazıt,65,4083300,7214201037629902,612,8215423,4952807,0,4952807
5761,Adrian Beck,67,1299700,7712613804453799,381,3754639,3339285,3339285,0
5762,Filip Bednarek,69,715600,9111782229485919,318,2619500,823302,8234,815068
5763,Timo Beermann,67,454200,7250800097190604,342,2912526,480532,480532,0
5764,Mark Beevers,41,450700,9855620327403379,123,986165,800339,800339,0
5765,Yanis Begraoui,40,1182400,7933140966630017,205,2459763,1503199,150320,1352879
5766,Brian Behrendt,44,4887000,3945833004533836,509,8052891,1739638,174,1739464
5767,Leon Bell Bell,54,357900,8710748941044890,217,1798667,1640804,1641,1639163
5768,Nicola Bellomo,44,4886700,4808710828173635,487,7653159,4043405,0,4043405
5769,Cristian Benavente,57,333900,5650985642072053,234,1857307,289562,28957,260605
5770,Mason Bennett,64,3865600,8819334598898608,580,7253415,3387919,3387919,0
5771,Di'Shon Bernard,23,719200,7753991502066110,47,663663,623456,0,623456
5772,Antoine Bernier,27,3528100,3640716040781428,301,5007265,1230864,123087,1107777
5773,Luke Berry,55,2065800,6124413233360248,366,4534941,605014,60502,544512
5774,Bartosz Białek,27,3891400,3393165235669961,332,5905275,3733580,374,3733206
5775,Bartosz Białkowski,22,1576400,9453240833594953,156,2302761,20286,203,20083
5776,Filip Bilbija,37,4759400,9579042904279905,412,7095184,5244484,5245,5239239
5777,Tayfur Bingöl,31,3631700,5920671039677129,363,5753385,1439008,1439008,0
5778,Max Bird,58,3930100,5601736302054610,530,6994917,94847,94847,0
5779,Steve Birnbaum,31,4411700,5891718967576365,465,6638786,4615239,46153,4569086
5780,El Chadaille Bitshiabu,36,3831400,5515833405367461,385,5795316,3871837,388,3871449
5781,Odin Luraas Bjørtuft,65,3948800,7393315245171382,570,7281777,580932,0,580932
5782,Tristan Blackmon,51,1477700,3331099689680326,290,3296378,2188600,218860,1969740
5783,Njabulo Blom,41,2954800,5651090951894088,326,5072202,1936899,194,1936705
5784,Antonin Bobichon,37,1569500,5221280469354563,192,2553993,2013731,2013731,0
5785,Johan Bocanegra,22,4613700,4251700704340595,389,6293713,5315705,0,5315705
5786,Marc Bola,41,2378700,9793185718275416,292,4069598,94092,0,94092
5787,Boli Bolingoli,45,1804000,3523508779902452,293,3747772,2318234,0,2318234
5788,Jovanny Bolívar,61,2255100,4367465850498688,372,4543863,2938712,29388,2909324
5789,José Bolívar,26,930600,5881441432702560,105,1210826,388446,38845,349601
5790,Jonathan Bond,56,1282600,6489989725574354,328,3204457,2692225,2693,2689532
5791,Jakob Bonde,27,978300,3937849871617773,110,1265136,1253050,0,1253050
5792,Ugo Bonnet,28,2166700,8878860573690374,201,3064274,1875752,188,1875564
5793,Gui Guedes,65,4635500,3723596175925902,684,9020134,596882,596882,0
5794,Robin Bormuth,25,4206800,4393143799681590,415,6440474,363321,36333,326988
5795,Torgeir Børven,56,2614200,3325417119854952,432,5270938,4915450,4915450,0
5796,Sebastián Boselli,31,969300,5426546021075659,118,1490579,527147,0,527147
5797,Juan Boselli,55,1036600,8000065988896340,279,2629469,2343227,0,2343227
5798,Erik Botheim,43,4180000,8096777104109517,480,6688868,3689996,369,3689627
5799,Ismaël Boura,27,3203900,7729161303878332,293,4985111,917394,918,916476
5800,Othmane Boussaid,32,1977100,7876880987289836,244,3394692,2735853,27359,2708494
5801,Joseph Boyamba,29,3654800,8050873274864688,348,5336073,3787962,3787962,0
5802,Can Bozdoğan,27,2399900,4627221837199390,210,3123293,325224,0,325224
5803,Róbert Boženík,43,620100,5644403705297095,172,1468175,532688,5327,527361
5804,Michael Bradley,47,1316100,4059139784966225,248,2802322,1698898,16989,1681909
5805,Simone Branca,63,1865500,9498015555510784,388,4023603,2639678,0,2639678
5806,Per Kristian Bråtveit,51,4453100,3305995170065576,555,8087125,6579087,6579087,0
5807,Emil Breivik,63,3903200,8074329219508348,613,8549863,5939398,5940,5933458
5808,Rhian Brewster,40,388900,9412177287711305,166,1293585,367172,36718,330454
5809,Bruno Brígido,39,4722200,4471109616017263,451,7129496,3105577,31056,3074521
5810,Andrew Brody,32,3392800,5155843359377525,340,5433026,2737128,274,2736854
5811,Michael Brouwer,36,3668900,4768059569902145,356,5651596,3783771,3784,3779987
5812,Luuk Brouwers,60,2300300,7511340878722539,424,4743860,1715920,172,1715748
5813,Santiago Brunelli,57,457700,8891410840083504,258,2023713,1902924,191,1902733
5814,Andreas Bruus,64,4644900,3916514722817942,628,8865325,6840820,6840820,0
5815,Lee Buchanan,62,1078200,9557280595032515,312,2871764,392008,392008,0
5816,Constantin Budescu,65,1980000,9638860342382786,411,4656531,1424252,142426,1281826
5817,Marko Bulat,31,3451100,5231634938207638,304,5214086,4734218,4734218,0
5818,Aitor Buñuel,43,4117200,9579407681415283,464,6930209,721077,722,720355
5819,Marco Burch,53,4157900,7486462469213604,560,7251333,144658,14466,130192
5820,Sascha Burchert,29,1411200,7166994011639998,166,2252666,703543,7036,696507
5821,Nicolas Bürgy,64,1654900,6109845916842527,357,4148919,3468501,34686,3433815
5822,Dženis Burnić,39,1194000,5076476668503205,199,2266012,613191,61320,551871
5823,Josef Bursik,46,4479500,9299794266925908,479,7156769,6186194,0,6186194
5824,Rafael Bustamante,56,4168000,9794457163083100,514,7989827,5923655,5924,5917731
5825,Ludovic Butelle,49,2525000,8990425403077769,361,4670443,2931032,0,2931032
5826,Butzke,58,4857100,9892431177813512,604,8152692,6544341,655,6543686
5827,George Byers,52,1604100,6466217730152563,294,3371813,2473389,248,2473141
5828,Hernesto Caballero,57,1737000,9814165245555317,343,4086789,2950356,296,2950060
5829,Elías Cabrera,24,3787500,9395372954139951,318,4915815,281560,0,281560
5830,Darío Cáceres,65,3069900,9020109977011780,520,6527976,3185781,318579,2867202
5831,Abdu Conté,60,2101400,7394745665545525,401,4614109,1760515,176052,1584463
5832,Romario Caicedo,57,2599700,6308116752221917,421,5125170,2302844,230285,2072559
5833,Marc-Aurèle Caillard,46,3745700,8552959273597635,500,7031354,4296258,42963,4253295
5834,Brian Calderara,68,1148100,6495877611106314,355,3275447,2522896,2522896,0
5835,Kaan Caliskaner,37,2319400,5524007405187743,293,3988113,191421,191421,0
5836,Giacomo Calò,42,730100,4848945912858814,205,1908713,255753,2558,253195
5837,Leonardo Campana,67,1107500,7725943102711372,401,4076737,790344,791,789553
5838,Gaspar Campos,65,3440300,6847268059762486,544,6825725,6582250,0,6582250
5839,Richard,34,1013800,5058117057452877,162,1909022,1205365,1206,1204159
5840,Ezequiel Cañete,52,531600,6305059836072620,185,1522934,463837,464,463373
5841,Rafael Caroca,64,3819400,6369733895280706,492,6707584,5332678,53327,5279351
5842,Carreira,23,4218600,6560883588299494,363,5682362,2992779,2992779,0
5843,Jofre Carreras,27,1480000,8340471426970467,129,1867145,436617,437,436180
5844,Andy Carroll,24,2788400,3712774097028097,233,3632969,3506005,3507,3502498
5845,Julio Cascante,37,4153000,8307463263125535,476,7304337,1095581,1096,1094485
5846,Eryc Castillo,48,1074500,3781669961750591,271,2734838,1010225,1010225,0
5847,Rubilio Castillo,56,2712100,8290973706429889,439,5043217,2431458,244,2431214
5848,Nilson Castrillón,66,4233000,5149674392632411,622,8410111,4119067,411907,3707160
5849,Bryan Castrillón,49,3385700,9832645051979135,445,6525751,1967450,0,1967450
5850,Agustín Cayetano,36,3639900,7403463465365514,330,5224734,2595111,2595111,0
5851,Roman Celentano,68,4591000,7815685674281731,604,8055309,4086711,408672,3678039
5852,Richard Celis,49,4170100,8735976353477147,482,7327588,7214765,72148,7142617
5853,Roberto Cereceda,66,1935600,5288911502449222,418,4960218,2968993,29690,2939303
5854,José Cevallos,37,495500,7204219417143147,122,1084463,134888,0,134888
5855,Dylan Chambost,32,570400,6167920636803157,100,946004,416437,416437,0
5856,Chapela,48,2019700,6063386499230265,307,3777549,3673903,368,3673535
5857,Dion Charles,64,4569100,8437780556398331,636,8941067,1843021,184303,1658718
5858,Regan Charles-Cook,51,3503000,3388458416154807,421,5733539,3934937,0,3934937
5859,Gianfranco Chávez,32,2154100,6810320938894450,193,3072190,2171642,0,2171642
5860,Issam Chebake,43,4445200,5894269890501652,542,7326384,6960743,0,6960743
5861,Cho Yu Min,70,3160500,9275370215692009,538,6988060,4645955,0,4645955
5862,Mathieu Choinière,25,3620800,6901563716354503,303,4868301,1997256,200,1997056
5863,Mads Christiansen,45,4878300,9220057367320175,541,7706876,4314253,432,4313821
5864,Uğur Çiftçi,28,4400000,7427646236546742,394,6823411,2378231,237824,2140407
5865,Luca Cigarini,31,1319300,9245199229047636,167,2126512,602824,6029,596795
5866,Geny Catamo,25,3539700,5703198697694427,313,5190051,4255286,425529,3829757
5867,Dennis Cirkin,64,304700,9461521748892034,298,2301484,1845405,1846,1843559
5868,Ibrahim Cissoko,60,1755500,5051788969033924,402,4531773,528472,52848,475624
5869,Harry Clarke,44,4197500,4717982126855733,438,6353839,4278764,4279,4274485
5870,André Pereira,36,917800,8558587708962308,170,1860169,980486,9805,970681
5871,Yimmy Congo,30,2841900,3907605936175004,312,4581114,2044149,2044149,0
5872,Sirlord Conteh,22,4848300,5444327775186608,428,6564694,2523764,0,2523764
5873,Andrea Conti,57,3648800,6511445173635820,508,6431659,4680442,0,4680442
5874,Andrei Cordea,47,2560200,3381788882319533,354,4577883,4044819,0,4044819
5875,Derek Cornelius,59,4680200,4236277076581420,647,8997729,4701644,470165,4231479
5876,Emanuel Coronel,36,3305900,9810391496014994,366,5602277,922412,0,922412
5877,Óscar Cortés,25,1673500,4395485303695965,148,2135281,761880,76188,685692
5878,Maurice Cova,64,1359200,3192382390431504,325,3586917,2200019,221,2199798
5879,Alexandru Crețu,48,1900000,8373695243211755,319,3870620,2376828,0,2376828
5880,Iulian Cristea,53,794600,4649654957832212,273,2599245,150577,15058,135519
5881,Ramiro Cristóbal,48,4486500,8170241192574952,494,6984204,4899486,0,4899486
5882,Carlos Cuero,56,2933700,7618219726027665,475,5755802,4601841,46019,4555822
5883,Cristian Cuevas,55,4318000,7026179012828689,596,8157677,3772757,3772757,0
5884,Greg Cunningham,52,4327000,5694253569313616,515,6818875,937831,0,937831
5885,Nenad Cvetkovic,48,2131900,6552479310241150,325,4366862,1299740,12998,1286742
5886,Jakub Czerwiński,60,342400,7199954807427513,258,2007475,1835815,18359,1817456
5887,Lennart Czyborra,30,798900,3720250243153950,101,1095967,93616,93616,0
5888,Nick D'Agostino,46,2131100,9993338815757340,325,4098028,3472974,3473,3469501
5889,Jhamir D'Arrigo,34,2527000,9911870105003486,256,3776063,1543838,1543838,0
5890,Alessio Da Cruz,37,2255100,7526640104962472,283,4103196,1551954,1551954,0
5891,Charles,52,4662600,8650559441958082,606,9000004,7397217,73973,7323244
5892,Kouadio-Yves Dabila,44,1955100,5115211344812612,276,3612800,1318127,1318127,0
5893,Cristian Dájome,38,3832100,9710620171767445,360,5386859,582354,58236,524118
5894,Ebrima Darboe,63,2436400,3473560226614069,444,5306610,4755554,475556,4279998
5895,Brahim Darri,44,3058800,8486307954315153,369,4973783,2584847,258485,2326362
5896,Fabian de Keijzer,30,3199600,7060015583950842,275,4580453,2117601,2117601,0
5897,Alexis De Sart,56,4959100,6168165532270820,643,9016755,946080,9461,936619
5898,Ortwin De Wolf,48,1357900,8253295037812494,272,3142285,664221,6643,657578
5899,Théo Defourny,58,2776100,3196546943084316,451,5321461,3587234,358724,3228510
5900,Jannik Dehm,63,4567900,5911501394403212,666,9180796,7328422,0,7328422
5901,Juan Delgado,51,876200,5568289276044993,246,2517664,2471499,2472,2469027
5902,Siriki Dembélé,40,4007200,6143143793934769,438,6194495,3826129,383,3825746
5903,Gilles Dewaele,25,4784400,3948330883450231,456,6727120,1319032,0,1319032
5904,Matías Di Benedetto,30,1201400,5423027706462890,130,1810228,1003170,0,1003170
5905,Marco Di Cesare,37,1677500,9648207634198711,266,3103084,2204811,2205,2202606
5906,Franco Di Santo,41,2471400,4656131717053301,322,4408688,63608,63608,0
5907,Mohamed Diaby,38,2525600,9627067320863960,277,4031013,4030039,404,4029635
5908,Dimitris Diamantakos,43,1270000,7498226302556963,228,2645452,1321286,1322,1319964
5909,Mamadou Diarra,25,4907000,6627861330436289,430,7384852,1880068,1880068,0
5910,Habib Diarra,38,563200,8113290847131874,127,1206834,74314,74314,0
5911,Ismael Diawara,69,2393600,8832296079288879,521,5999332,5825202,583,5824619
5912,Luis Díaz,33,3524900,5484889757574794,388,6055897,4303517,0,4303517
5913,Franco Díaz,63,3570600,9076032871338325,580,7144812,4077824,0,4077824
5914,Soner Dikmen,31,2740900,7531091272118796,266,3925762,955467,9555,945912
5915,Joren Dom,52,392700,3492063446603326,192,1420073,710886,0,710886
5916,Anastasios Donis,67,566200,9878905899552913,353,2755739,2689720,2689720,0
5917,Anton Donkor,51,4808900,8110619290925923,577,8179895,5162862,51629,5111233
5918,Doo Hyun Seok,46,3175500,9274105737066846,384,4965282,2433921,2433921,0
5919,Kenny Dougall,68,1401900,5970338175927838,364,3713824,1431163,143117,1288046
5920,David Douline,53,1790900,8946440597144131,354,3786063,497485,498,496987
5921,Dennis Dressel,37,4168400,3655217926171249,398,6424799,140179,0,140179
5922,Deroy Duarte,47,920400,6003191701777565,201,2113956,949648,9497,940151
5923,Tom Ducrocq,28,1443000,3581970519640118,149,1943433,559697,55970,503727
5924,Matías Dufour,41,3026700,7067342354359828,314,4784559,355283,356,354927
5925,Taylan Duman,40,1589000,9508507242318421,238,2909303,2540720,2540720,0
5926,Kyle Duncan,68,1604700,5748339545907921,359,3756274,2522317,0,2522317
5927,Lasha Dvali,50,2568300,3395100168830256,396,5060978,1522731,15228,1507503
5928,Nikolas Dyhr,67,4668800,7075656140352425,570,8133521,7252974,0,7252974
5929,Festy Ebosele,35,4229200,6793905488816306,426,6948407,409722,410,409312
5930,Joe Edwards,65,1096500,7148199644306809,349,3548668,1442160,1443,1440717
5931,Tom Edwards,26,979100,7955206960481497,98,1232384,338270,339,337931
5932,Ronnie Edwards,34,2762800,9047053711172233,257,3949024,2999354,29994,2969360
5933,Johannes Eggestein,36,3997300,9017841237490194,355,5663830,5192742,0,5192742
5934,Souffian El Karouani,63,3288200,5502267130911976,478,6291490,3583604,35837,3547767
5935,Fernando Elizari,51,3742100,5908022188145201,449,6641398,1805323,1806,1803517
5936,Jan Elvedi,69,2733600,6841433424075895,460,5310338,2763050,277,2762773
5937,Úmaro Embaló,32,1728500,8278615326119889,243,3311253,2300712,23008,2277704
5938,Emanuel Emegha,27,3134800,4377816587708145,261,4335767,802615,803,801812
5939,Lukas Engel,32,1155900,4940705102700754,138,1702698,872551,0,872551
5940,Gustav Engvall,47,1258900,3890348156626696,249,2860776,2399232,23993,2375239
5941,Guillermo Enrique,41,1824900,9218857609190697,240,3224041,3061753,0,3061753
5942,Sebastian Ernst,69,4977100,6907490870917157,664,9397703,3952324,396,3951928
5943,Franco Escobar,62,1259600,9708085966611319,281,2915622,2310227,0,2310227
5944,Matías Espinoza,27,3922000,8782050032733062,338,5294135,1591321,160,1591161
5945,Salvatore Esposito,51,3960900,3143750072678911,527,7326343,3432455,344,3432111
5946,Matías Esquivel,67,3639000,3859628833262611,585,7581996,126305,126305,0
5947,Juan Cruz Esquivel,25,4817600,3308340552097122,403,6280084,1438345,144,1438201
5948,Derrick Etienne Jr.,66,4022800,5988359079225135,582,7537235,918752,0,918752
5949,Lee Evans,31,3857400,5878995604347363,375,5693754,2562382,256239,2306143
5950,Ezkieta,51,1732300,8240691900754858,302,3602226,1743620,17437,1726183
5951,Alieu Fadera,59,4716100,3048557625564623,631,8902430,2690286,269029,2421257
5952,Nicola Falasco,62,667600,7894780677876875,309,2595280,1366975,0,1366975
5953,Diego Falcinelli,45,3577600,3484131915680700,431,6157150,1584843,1584843,0
5954,Agustín Farías,28,4501600,3398701161032986,398,6368442,4965647,4965647,0
5955,Brian Farioli,42,2976500,3961141198181025,326,4848359,1401007,140101,1260906
5956,Julien Faussurier,53,1315400,8355504832811749,281,2782471,2088034,20881,2067153
5957,Manuel Feil,69,588000,3807454041064150,291,2388009,295521,296,295225
5958,Julián Fernández,35,4369200,6061793523003306,381,6504270,4232874,4233,4228641
5959,Welinton Júnior,53,1102000,9995283374380390,308,3212602,1275655,12757,1262898
5960,Héctor Fertoli,53,4292500,5420453276738862,465,7051377,2648848,2649,2646199
5961,Sondre Fet,26,1566200,4014989005141858,135,2027200,1190443,1190443,0
5962,Hernán Figueredo,61,4166600,7299779450285691,589,8152786,3604047,0,3604047
5963,Bård Finne,48,3403100,3480249328207911,403,5623277,4919450,491945,4427505
5964,Vincenzo Fiorillo,42,3848600,3187088827402621,406,6366056,2242674,2243,2240431
5965,Manfred Fischer,27,1443900,5362373414838617,161,2153840,1493076,150,1492926
5966,Will Fish,49,4670000,3716366587373101,593,8321534,2204904,2205,2202699
5967,Andy Fisher,30,4733700,4114892166897634,411,6712780,4333641,433365,3900276
5968,Leon Flach,60,3009600,9084920688825534,459,6143245,2701427,2701427,0
5969,Aden Flint,68,4078600,9714586776397226,594,7456121,4358587,0,4358587
5970,Sherel Floranus,53,4110700,9970185777021557,494,7070952,1172773,1172773,0
5971,Leonardo Flores,67,3678900,3033110031118436,564,7395923,5876068,58761,5817307
5972,David Datro Fofana,68,2961900,8732739210627856,532,5967793,3538765,0,3538765
5973,João Ferreira,54,1827600,3833725486023641,371,4108283,1078395,1079,1077316
5974,Bruno Fornaroli,40,3677200,6988235326590829,406,6480300,5563246,5564,5557682
5975,Jímer Fory,69,3659800,5825909975771422,597,7319846,4748275,474828,4273447
5976,Marlon Fossey,58,4050600,7737370295626738,559,7801655,3304455,3304455,0
5977,Gianluca Frabotta,41,2658500,3170657611639888,292,4163788,2012836,201284,1811552
5978,Raphael Framberger,37,2095500,4038510479994618,247,3417913,1789801,179,1789622
5979,Domenico Frare,51,2089300,5411645241535611,367,4391163,1687337,1687337,0
5980,Damián Frascarelli,39,712700,3299165420991465,195,1872307,1606601,16067,1590534
5981,Scott Fraser,34,4429200,9393960607833632,412,6895847,1273164,128,1273036
5982,Lukas Fridrikas,63,508800,7373315179241194,272,2415219,233023,23303,209720
5983,Christian Früchtl,59,3951500,5774580183608472,468,6721421,5408290,5408290,0
5984,Riccardo Gagno,50,522800,9501078181949342,192,1673478,755760,75576,680184
5985,Thomas Galdames,49,4690100,5466362587830149,535,8024428,5421248,0,5421248
5986,Nino Galović,28,4941900,8075446639636437,500,7811211,617211,0,617211
5987,Lucas Galvão,22,4458100,6650360484639764,387,6883622,1102164,1103,1101061
5988,Nicolás Garayalde,63,896900,7638846048317441,294,2722355,1906242,190625,1715617
5989,Renzo Garcés,69,807200,5662998584717983,409,3846463,3842216,3843,3838373
5990,Mender García,63,3575400,4799252484742122,493,6427525,575995,0,575995
5991,Manuel García,24,1102500,8726712419582428,100,1486077,1399965,14000,1385965
5992,Cristian García,29,3314000,8385348331291070,295,5167905,999110,100,999010
5993,Carlo Adriano,59,4671100,5454127999813501,629,8576580,6848883,0,6848883
5994,Taylor Gardner-Hickman,63,988200,3315191193346915,333,3056919,2426213,0,2426213
5995,Linus Gechter,36,4453700,6733550510810190,387,6655000,2114505,2114505,0
5996,Ion Gheorghe,67,1877500,9404099626651959,402,4404773,2501522,25016,2476506
5997,Nacho Gil,62,2363200,8890378809447263,476,5308530,3959099,39591,3919508
5998,Gastón Gil Romero,24,2407000,8859539696799033,220,3481770,2510809,25109,2485700
5999,Enzo Giménez,64,1452500,3718600542128981,339,3568274,425998,0,425998
6000,Francisco Ginella,41,3172400,9808469324637169,319,4692382,1004069,1004069,0
6001,Silas Gnaka,27,1359400,5132886495538779,109,1740015,389874,389874,0
6002,Caio Secco,65,1215300,6224751445012615,374,3776695,2486558,0,2486558
6003,Bruno Godeau,62,1214300,4085240848180798,373,3523753,1153554,1154,1152400
6004,Matías Godoy,69,346000,8472192828178035,310,2617138,657652,658,656994
6005,Erik Godoy,59,4954200,6410797506539555,686,8890206,8463286,8463286,0
6006,Benjamin Goller,42,2839900,7676667323309040,377,5030334,162739,163,162576
6007,Claudio Gomes,70,1091900,8456918791960410,345,3340462,3094048,3094048,0
6008,Rodrigo Gomes,47,387900,9247258983106347,206,1578257,1019406,102,1019304
6009,Dálcio,35,4597700,3448683105210901,417,6476937,967091,96710,870381
6010,Yulián Gómez,61,1581800,5585801474826985,355,3686302,2759949,0,2759949
6011,Valentín Gómez,64,2236700,5284729096537573,397,4745565,2722617,273,2722344
6012,Luciano Gómez,51,3265400,6317020544668124,447,5759060,2287557,2287557,0
6013,Anthony Gonçalves,50,4494200,5885134412900046,535,7622241,6182113,0,6182113
6014,Cedric Diomandè Gondo,41,457000,7944802663539469,186,1468227,291311,0,291311
6015,Gonzalo Goñi,55,4246800,7157250994014973,539,7410778,6088752,608876,5479876
6016,Francisco González,39,3986100,7133749333191400,442,6590314,3988250,0,3988250
6017,Walter González,54,4912100,8221205003496642,604,9430834,4943367,0,4943367
6018,Sergio González,24,4209800,4324525460943534,400,6462142,1458734,145874,1312860
6019,Sergio,65,4617400,6910364978068800,669,8774743,4663663,46637,4617026
6020,Alimami Gory,60,1178000,6088070517596026,298,2977774,86832,8684,78148
6021,Dimitrios Goutas,42,2569700,5647180029880145,324,4471726,1119370,1119370,0
6022,Gheorghe Grozav,56,1490200,6192794052617246,330,3636747,2005396,201,2005195
6023,Marcel Guaramato,46,1113900,3773905575261335,207,2102871,1294930,12950,1281980
6024,Hakim Guenouche,37,1737200,6031273677819960,215,2795708,2794440,280,2794160
6025,John Guidetti,58,2773200,3158353673310791,397,5057987,672624,673,671951
6026,Dominique Guidi,35,2905300,5407294122966066,298,4767609,4728816,47289,4681527
6027,Semih Güler,61,809200,4703298324585723,331,2829550,2766590,277,2766313
6028,Umut Güneş,42,4441500,6104747664376732,449,7112953,1323960,1324,1322636
6029,Patrik Gunnarsson,62,2663600,6623556014905542,514,5680600,3973463,39735,3933728
6030,Vladislavs Gutkovskis,34,3219700,7420417152377254,339,4914997,1275328,1275328,0
6031,Andrew Gutman,46,1221900,9657206499794411,241,2770025,1580275,159,1580116
6032,Lautaro Guzmán,36,4729700,3360446831255618,473,7276280,2793426,2794,2790632
6033,Jan Gyamerah,52,3408400,8552823029326497,469,6345637,2813926,2813926,0
6034,Nick Hagglund,41,3611900,3554719565686720,366,5510658,2321636,23217,2298419
6035,Geoffry Hairemans,38,3609900,4432369992320129,344,5386293,2547626,0,2547626
6036,Alen Halilović,35,347200,6733580368224935,94,666028,182762,183,182579
6037,Johan Hammar,30,4887000,5853611293386935,425,7433781,4354185,4354185,0
6038,Paul Hanlon,66,1764500,7856227922472960,430,4703041,1737867,1738,1736129
6039,Martin Hansen,52,4732100,4003989417032154,601,8513022,2219283,0,2219283
6040,Jorrel Hato,26,3216400,7255010276308230,247,4232674,1550324,15504,1534820
6041,Guillermo Hauche,62,558100,5819340153086714,284,2296535,1655611,166,1655445
6042,Kjetil Haug,43,1531600,3141400673091900,247,2780201,991441,100,991341
6043,Eirik Haugan,36,1187800,3215313240413091,190,2107669,398605,398605,0
6044,Daichi Hayashi,68,1271000,9990869975021564,357,3382946,1164322,117,1164205
6045,Daniel Heber,41,310700,7819471944199806,170,1194146,460061,46007,414054
6046,Vegar Eggen Hedenstad,64,3687200,7896051954722448,526,6939428,5342108,0,5342108
6047,Jeff Hendrick,41,3550500,5463238531825780,393,5642382,4279161,427917,3851244
6048,Philipp Hercher,61,1238200,4201731032095111,288,2891641,2746073,2746073,0
6049,Hjörtur Hermannsson,43,3973500,4279559523657655,451,7128535,2954339,2955,2951384
6050,Luifer Hernández,28,396900,3478046506852058,54,437176,185966,185966,0
6051,Mario Hernández,51,1477500,4671271045797359,298,3198987,2978003,29781,2948222
6052,Javi Hernández,67,1903000,4198294769167636,432,4332575,3331943,33320,3298623
6053,Héctor,41,2245100,5677770824617741,292,3814466,2340096,2341,2337755
6054,Aaron Herrera,24,2125100,4494599962292400,191,3105287,1974367,1974367,0
6055,Emanuel Herrera,45,4884700,8861772993059468,510,8326211,264614,2647,261967
6056,Cristian Herrera,63,1893200,8557314841786490,361,3920816,603269,60327,542942
6057,Eirik Hestad,31,508800,5534663850806926,97,849445,81031,0,81031
6058,Daan Heymans,31,2831100,6923995060077372,290,4126870,3660731,3660731,0
6059,Stefan Hierländer,60,3098000,4650203724319721,490,6190154,5244550,0,5244550
6060,Marco Hiller,53,340500,9331431540621095,232,1921100,859523,859523,0
6061,Mees Hoedemakers,42,2849800,6251125736527846,352,4721259,4003698,4003698,0
6062,Daniel Høegh,67,1335100,3637237513199619,378,3686797,2788354,2789,2785565
6063,Vebjørn Hoff,53,3792700,6267218078505757,464,6213154,3584329,0,3584329
6064,Ron-Thorben Hoffmann,63,726500,3489660085085958,313,2569416,414287,414287,0
6065,Maximilian Hofmann,54,303400,9348260403957781,229,1642150,1484617,1484617,0
6066,Duane Holmes,50,319300,3907803444939157,204,1474411,1093833,1094,1092739
6067,Raphael Holzhauser,65,469100,6193471297402418,313,2508929,1275334,1276,1274058
6068,Petko Hristov,68,1761200,6758061926723309,370,4123688,1502581,15026,1487555
6069,Jordan Hugill,57,3841100,5728973629912915,560,7504190,3991764,0,3991764
6070,Jean Hugonet,22,2653000,4367092393574841,178,3499163,3376456,3377,3373079
6071,Trai Hume,32,1025600,9492517452251730,160,1757938,142333,142333,0
6072,Cameron Humphreys-Grant,57,2232000,6252396959936485,349,4701339,2671029,0,2671029
6073,Stephen Humphrys,26,4326700,3170998115947519,380,6808836,5803373,5803373,0
6074,Oliver Hüsing,30,3952300,3201908762775139,352,5712572,2657105,265711,2391394
6075,Rober Ibáñez,23,609900,3174877746473505,46,539527,32631,3264,29367
6076,Ylldren Ibrahimaj,58,3710200,3613659003703242,492,6816817,3629657,0,3629657
6077,Jonathan Iglesias,27,2696700,8694203894388834,287,4176196,4174184,0,4174184
6078,Svante Ingelsson,44,4574400,9074653372160883,500,7806555,2295710,22958,2272752
6079,Matt Ingram,67,2393000,8594475944719942,423,4970269,4635374,4636,4630738
6080,Nicolas Isimat-Mirin,29,2029500,9943786667778967,196,2800478,389984,3900,386084
6081,Abass Issah,48,3780400,9027516210408015,488,7139069,650151,650151,0
6082,Tatsuya Itō,51,4112600,6396141500179810,528,7137966,3208757,320876,2887881
6083,Luca Itter,50,3949400,7489431793030379,466,6863334,1781947,0,1781947
6084,Frederik Jäkel,23,2423500,9592863298559953,229,3471697,2283855,229,2283626
6085,Adam Jakubech,64,2478100,4995167083698348,456,5612300,1573916,0,1573916
6086,Reece James,70,2116300,6727396213578919,444,5045627,2954320,295432,2658888
6087,Franco Jara,36,1772900,5648753053869004,246,3218060,643531,643531,0
6088,Danley Jean-Jacques,68,3047800,6625186370683570,479,5576524,1405149,140515,1264634
6089,David Jensen,43,4412400,6047427706163176,461,6596770,2233653,0,2233653
6090,Leon Jensen,45,3672700,9934457015318931,462,6245190,105962,105962,0
6091,Jeong Woo Jae,47,1421300,5856420797535166,290,3308550,2969944,2969944,0
6092,Jeong Woon,26,4330800,5458220106094556,346,5875168,5425848,0,5425848
6093,Jiang Shenglong,34,4782200,5169999115071727,440,7536627,3771905,0,3771905
6094,Piotr Johansson,24,1105500,8811704056632882,103,1461544,10742,108,10634
6095,Alfie Jones,47,4413500,6423047559583577,510,7361825,6337555,63376,6274179
6096,Branko Jovičić,69,2203500,3796528664147551,470,5380067,1872087,188,1871899
6097,Aleksandar Jukic,35,1025500,5269821621758122,160,1842831,938384,0,938384
6098,Anderson Julio,53,3259400,4958537116256646,451,6189963,4915458,0,4915458
6099,Stanko Jurić,56,2635500,7888511934827985,385,5025726,2949771,0,2949771
6100,Adrián Jusino,23,4484200,9831504889177057,414,6643323,1700020,0,1700020
6101,Mohamed Kaba,49,4932300,5849952127989633,542,8435070,1393033,139304,1253729
6102,Bashkim Kadrii,34,3810800,5127418198029764,406,6409238,194964,194964,0
6103,Enzo Kalinski,50,2796500,8153464745345747,374,4987927,1545647,1545647,0
6104,Mikkel Kallesøe,22,4242400,6310502126284191,372,6259691,2557189,2558,2554631
6105,Brian Kaltak,39,3091900,7556156202864513,388,5379754,3719301,371931,3347370
6106,Warren Kamanzi,49,3372800,9676205684153114,447,6056848,3818276,3819,3814457
6107,Herbie Kane,69,4953800,7321191624822522,616,8848393,6986681,69867,6916814
6108,Kazımcan Karataş,54,4077500,8639550993004557,500,7311337,1676778,0,1676778
6109,Emir Karic,52,2910100,4005534676570613,399,5472849,5058850,505885,4552965
6110,Jacob Karlstrøm,26,2923000,6080913223573429,271,4251126,3453305,34534,3418771
6111,Yassine Kechta,32,3234900,6633287391739387,310,5313954,82654,8266,74388
6112,Habib Keïta,27,540000,6930006012793363,68,611493,380060,0,380060
6113,Scott Kennedy,56,1860900,4381052326331491,330,4019507,11383,0,11383
6114,Kim Ju Sung,53,3173200,9039015478422914,418,5819142,4726514,0,4726514
6115,Kim Seon Min,65,4526800,5966866890417982,590,8733794,1054095,105410,948685
6116,Mikkel Kirkeskov,38,1131900,5437365381669717,174,2089983,121911,121911,0
6117,Stelios Kitsiou,24,1991200,4876347539828717,198,3018060,1451249,1451249,0
6118,Fabian Klos,36,2144100,7237544413257491,242,3518393,1711335,171134,1540201
6119,Stefan Knežević,53,4898500,3703651679173792,538,7554509,4842462,48425,4794037
6120,Tim Knipping,30,4846100,9303268203907231,390,7029421,6472915,647292,5825623
6121,Okan Kocuk,39,851700,9002975898060345,165,1816488,278625,27863,250762
6122,Koba Leïn Koindredi,40,3856700,4371485349098895,404,5860903,5649097,5649097,0
6123,Denis Kolinger,41,898000,3358832762703200,203,1910349,218581,0,218581
6124,Elvir Koljić,36,419400,9213646693315814,113,938029,629839,629839,0
6125,Marco Komenda,61,1322900,5061005844249481,369,3556124,76870,769,76101
6126,Mory Konaté,48,1307800,9909085671382867,290,3075118,1740523,175,1740348
6127,Yukhym Konoplia,65,4648100,8987582154929692,596,7693669,5281566,0,5281566
6128,Nils Körber,45,4137700,5929426729616368,514,7085575,985227,98523,886704
6129,Josh Koroma,67,1501000,4671588048600514,377,4129660,2314284,231429,2082855
6130,Xavier Kouassi,52,1367700,4119964399947493,291,3174400,270808,0,270808
6131,Jacobo Kouffati,69,532000,9012642637920020,344,2774739,1092541,110,1092431
6132,Konstantinos Koulierakis,60,4640400,4280630754318087,672,9383733,405257,406,404851
6133,Sebastian Kowalczyk,68,833800,8185425745366856,313,3010045,2581565,2582,2578983
6134,Bozhidar Kraev,54,4881900,8308616281345763,599,8146308,2608740,0,2608740
6135,Ermal Krasniqi,70,978900,5957340487648329,351,3140495,2957434,29575,2927859
6136,Robin Krauße,24,4568900,4742785998827717,345,5911325,1644044,0,1644044
6137,Roy Krishna,49,3235300,7513749679608355,467,6200880,2121861,212187,1909674
6138,Thomas Thiesson Kristensen,61,632100,5714120225977266,257,2292050,200888,201,200687
6139,Jarosław Kubicki,35,3942900,3437008333093828,445,6149763,3016045,301605,2714440
6140,Philipp Kühn,27,4285400,7447878951698300,413,6365900,2080331,2080331,0
6141,Kasper Kusk,55,2594600,6005462232562414,416,4893693,3863749,3863749,0
6142,Mathias Kvistgaarden,66,398000,8128109360897879,356,2914467,2418796,2418796,0
6143,Godson Kyeremeh,63,387000,6203951267366615,276,2009391,34043,341,33702
6144,Matías Lacava,32,2470700,7402804201357132,278,3934195,3934040,3934040,0
6145,Tom Lacoux,28,3155700,4955414910394270,341,5043409,2358753,23588,2335165
6146,Freddie Ladapo,31,2525500,8553402445784422,267,3562637,2249551,22496,2227055
6147,Boris Lambert,38,3335300,6776276640050066,386,5321007,919348,9194,910154
6148,Lazaros Lamprou,68,4094300,5333894456207175,641,8352644,8098405,0,8098405
6149,Konstantinos Lamprou,23,2489600,9439411447460367,188,3179589,3066895,307,3066588
6150,Callum Lang,35,4838400,6777686443328941,432,7832499,282014,0,282014
6151,Michael Lang,35,4977600,3078413864351104,412,7155184,1387873,13879,1373994
6152,Ionuț Larie,37,1452700,9781669601329258,223,2733962,2034365,2035,2032330
6153,Christian Larotonda,28,1324400,3193624561237741,171,2267097,300341,301,300040
6154,Larrazabal,46,512900,7098670634376869,183,1543477,890153,89016,801137
6155,Joel Latibeaudiere,33,3848500,5405668272443052,326,5591981,2672119,267212,2404907
6156,Gaëtan Laura,36,3495600,7445642725873209,333,5154642,3609175,361,3608814
6157,Jacob Barrett Laursen,69,2968800,7805328471962329,471,5679252,2609108,2610,2606498
6158,Yusuf Lawal,49,3323700,7794850374030896,411,5668297,3120005,31201,3088804
6159,Adam Le Fondre,26,3117100,5209411149128647,281,4635438,413326,4134,409192
6160,Luke Leahy,45,4235900,9679781315826305,507,7336172,6659818,0,6659818
6161,Quentin Lecoeuche,36,2724400,3771081784510151,332,4469735,4261060,426106,3834954
6162,Ben Lederman,52,4864600,6453425422804559,548,8903096,366216,366216,0
6163,Ryan Ledson,36,2417500,7827898632965503,271,4101556,2513202,25133,2488069
6164,Lee Gyu Seong,26,1572700,4177250472492917,138,2075350,1086168,0,1086168
6165,Iván Leguizamón,48,2524500,9160074811563513,318,4232977,1959014,195902,1763112
6166,Juan Leiva,55,3255800,3620198595230538,470,6541102,365463,3655,361808
6167,Brooks Lennon,46,2970700,8097769503465842,380,5601459,2916005,0,2916005
6168,José León,69,3719000,9917855813205045,575,7187864,7065946,707,7065239
6169,Léo Leroy,65,1426100,5643782286719517,386,3913766,2107274,2108,2105166
6170,Marko Lešković,22,971300,9656125504793727,53,871925,866804,86681,780123
6171,Alexandre Letellier,66,338900,7417141457389965,274,2001965,723129,72313,650816
6172,Lim Sang Hyub,28,1490600,8236470035993430,165,2371425,1774859,1774859,0
6173,Nicolás Linares,36,2837200,5220852287433842,356,4850686,1277173,1278,1275895
6174,David Loaiza,46,3203200,9087494021259474,377,5605887,970435,97044,873391
6175,Kevin Lomónaco,44,534700,3076720067389650,194,1709732,621998,0,621998
6176,Justin Lonwijk,26,784200,7085435196398166,73,856300,760034,7601,752433
6177,Javi López,49,408600,9309790603633038,236,1854792,1043453,10435,1033018
6178,Sergio López,35,1542400,8270539825691978,213,2634082,769599,0,769599
6179,Álex López,28,1896200,9795574526642986,208,2872210,1263520,127,1263393
6180,Simon Lorenz,51,4242200,9659190390872232,502,7185583,17598,176,17422
6181,Marcel Lotka,44,3126000,9672679233385037,428,6105162,2346307,235,2346072
6182,Dylan Louiserre,57,1051000,4061647726898605,351,3384283,1443146,0,1443146
6183,Mamadou Loum,66,2154200,6563947405225220,459,4986439,2922127,293,2921834
6184,Damion Lowe,54,2874300,9690166181247275,436,5450761,2178715,2179,2176536
6185,Adrián Luna,51,3340500,4990859814181856,396,5469573,1277524,1278,1276246
6186,Massimo Luongo,39,2164900,5869427345323053,300,3552317,790884,791,790093
6187,Salem M'Bakata,64,2867800,9020514411642039,518,6409042,2559530,25596,2533934
6188,Louis Mafouta,69,1071500,3110282033998824,382,3809646,3606692,3606692,0
6189,Connor Mahoney,39,394700,4208924655658242,152,1167522,993378,100,993278
6190,Sebastian Mailat,58,3979900,7929879264882954,518,7568181,7369037,7370,7361667
6191,Guido Mainero,43,3641100,4774368331295973,411,6097010,3839379,384,3838995
6192,Mattia Maita,36,3841300,3150517438333005,358,6016149,1350343,1351,1348992
6193,Alexis Maldonado,59,2506500,5912146363518646,425,5457134,591588,0,591588
6194,Darian Males,61,4429200,8450756778498266,513,7406317,6471008,648,6470360
6195,Camora,52,2846400,9970293027669888,393,5388381,3980541,0,3980541
6196,Ryan Malone,65,3052800,3182737832423465,488,5967329,3350108,3350108,0
6197,Sivert Heggheim Mannsverk,58,2923600,6738227632200071,417,4973642,63465,0,63465
6198,Facundo Mansilla,45,3492400,7440354398499932,469,6132710,695571,696,694875
6199,Kevin Mantilla,59,2462900,3644503287884444,441,5469522,4067191,40672,4026519
6200,Valerio Mantovani,37,3169900,9675078714777317,344,5288998,4023556,4023556,0
6201,Riccardo Marchizza,37,4667400,6022159867043743,456,7945769,173316,0,173316
6202,Damien Marcq,48,470000,7153558697356802,191,1646591,404679,405,404274
6203,David Marshall,30,2132300,6902505222396911,226,3220645,1386238,0,1386238
6204,Bruno Martella,43,1801000,8457132357357787,282,3342318,11702,118,11584
6205,Dani Martín,27,1257100,7802559598337365,130,1829046,1190932,119094,1071838
6206,Álex Martín,42,2724300,4772029172417823,332,4876212,2312655,0,2312655
6207,Braian Martínez,62,3547400,7608005411353491,546,7032123,204809,204809,0
6208,Martínez,35,1992100,3699514808941643,222,3131190,2568399,2568399,0
6209,Jonathan Marulanda,23,2955500,7802357225326783,214,4207755,3156920,3156920,0
6210,Erik Marxen,53,1529700,6570829869357834,340,3989230,3771320,0,3771320
6211,Roberto Massimo,32,3455600,6592260021931722,339,4982084,2318328,0,2318328
6212,Ifeanyi Mathew,58,748900,6120972897087662,264,2268743,1092146,1092146,0
6213,Guillermo May,43,3225700,3400051940331525,374,5212233,1963188,1963188,0
6214,Alfie May,49,1570900,8489571846576598,284,3035587,1742656,174266,1568390
6215,Olivier Mbaizo,52,2054300,5912157638130990,301,3776823,1234591,1235,1233356
6216,Hianga'a Mbock,34,2919900,4140420865213236,283,3999743,2957494,0,2957494
6217,Jean-Manuel Mbom,27,1250800,4359482548617809,143,1785959,668696,668696,0
6218,Garath McCleary,26,341200,6934416221821874,34,203633,148297,1483,146814
6219,Jack McGlynn,42,538400,6919068028134953,172,1407794,489921,4900,485021
6220,Mark McGuinness,32,2846600,7260389420553003,288,4404481,38547,0,38547
6221,Sean McLoughlin,47,2081900,9721013224434373,284,3558235,3091426,0,3091426
6222,Hannibal Mejbri,60,4420600,7051477248331906,673,8887468,4156771,416,4156355
6223,Andrés Meli,36,897100,3927990285658099,156,1703243,1141802,114181,1027621
6224,Luka Menalo,33,4960000,5042354200796538,473,7628256,3099128,0,3099128
6225,Joe Mendes,69,2216700,5576806653551720,427,4676433,1828540,183,1828357
6226,Alex Méndez,50,4592200,5618606786597753,527,7941019,76355,0,76355
6227,Nathaniel Méndez-Laing,59,4863100,3538360844207020,621,8353910,2818311,2819,2815492
6228,William Mendieta,68,1073200,8065121973593406,367,3277513,852513,0,852513
6229,Arial Mendy,33,4631600,6127397186808558,473,7406649,5876700,0,5876700
6230,Formose Mendy,22,3535900,6830489073125435,264,4984886,2062961,2062961,0
6231,Antoine Mendy,49,681800,5415800785162375,235,2150277,97994,9800,88194
6232,Justin Meram,26,2192900,7207663745618327,205,3226597,2940994,0,2940994
6233,Sabin Merino,35,1053500,7704653789803496,146,1599389,686761,0,686761
6234,Damian Michalski,62,1561300,4377202993245469,415,4477393,1731337,174,1731163
6235,Pablo Míguez,60,4823400,4694414096736876,644,9421420,4956917,4957,4951960
6236,Dino Mikanović,29,1460100,3209191111882315,165,2287490,1810392,1811,1808581
6237,Beka Mikeltadze,50,2036700,3033394524319936,328,4133267,3804065,3804065,0
6238,August Mikkelsen,41,710100,8880932130310031,159,1625834,439661,439661,0
6239,Liam Millar,62,4148300,9536138541217046,545,7590952,6090035,610,6089425
6240,Bogdan Milovanov,62,2959100,3772560777007447,468,6071894,4326088,0,4326088
6241,Marko Milovanović,44,4587700,6151631523117795,462,7554015,6041183,0,6041183
6242,Richard Mina,63,4291900,4983141520043099,536,7604908,7585530,758553,6826977
6243,Sascha Mockenhaupt,66,4700800,4401702036729845,624,8601005,4748911,4748911,0
6244,Nixon Molina,69,3120500,6958344581473449,502,5950143,421757,421757,0
6245,Sergio Molina,57,2790000,6912847156826297,466,5855275,3715507,37156,3678351
6246,Montero,45,4913800,5770142312307333,527,7765039,12032,1204,10828
6247,Marcos Montiel,68,3750800,5328044642676617,548,7046065,756615,0,756615
6248,Santiago Montiel,56,342600,7457409985143895,255,2075532,184866,184866,0
6249,Júnior Morais,31,2017900,7356594592162714,186,3071578,684961,6850,678111
6250,Eber Moreno,59,2157900,5985506188606658,456,5012709,3951951,39520,3912431
6251,Marlos Moreno,40,2371500,4522772495172245,274,3496631,56950,570,56380
6252,Tyler Morton,61,641400,7398447715378650,304,2462160,368853,0,368853
6253,Leonel Mosevich,56,4122300,7130588432317331,564,7970561,6524179,0,6524179
6254,Yerson Mosquera,50,3742000,6035709439082429,468,6172705,4578953,457896,4121057
6255,Cristhian Mosquera,31,3943300,8307071340607143,368,5759312,2613149,2614,2610535
6256,Marius Mouandilmadji,38,4578100,6421203616149613,475,7667083,1425843,142585,1283258
6257,Santiago Mouriño,39,2147600,6442525124175683,256,3456625,1821735,183,1821552
6258,Lys Mousset,55,3327000,3967237547041621,508,7096200,5213032,0,5213032
6259,Sebas Moyano,53,1764400,3954420444831302,302,3603162,1311247,13113,1298134
6260,Chris Mueller,69,1835600,5927611895294848,411,4532755,1928791,1929,1926862
6261,Karlo Muhar,32,1341300,6403148980151301,184,2244187,570515,0,570515
6262,Nihad Mujakić,36,3661700,6781764709727249,344,5670625,1980287,198029,1782258
6263,Agustín Mulet,36,4186300,4477816354774489,392,6222142,523263,523263,0
6264,Valentino Müller,54,307200,4580662768631995,268,2053138,1924490,193,1924297
6265,Paul Mullin,69,4991300,3676962890609734,725,9677921,7531584,7531584,0
6266,Joaquín,65,3075800,6960148841920020,495,6180529,1271619,127162,1144457
6267,Carlos Isaac,68,4785800,6787976659095641,666,8660524,7197813,7197813,0
6268,Louis Munteanu,26,2204000,7733013904775407,223,3329941,3086829,0,3086829
6269,Viljar Myhra,59,1087500,6826343794265196,307,3258834,2041435,204144,1837291
6270,Konan N'Dri,44,1453900,5099719298132498,235,2764852,2268680,22687,2245993
6271,Yahia Nader,43,4647300,6503805174880479,534,8186730,2128435,21285,2107150
6272,Younes Namli,23,3622600,4431897282209309,286,4843393,3051167,3052,3048115
6273,Sebastian Nanasi,23,439800,7700750471520373,48,395900,267862,2679,265183
6274,Juan José Narváez,48,3693700,8029236215648753,449,6268902,1990755,200,1990555
6275,Edanyilber Navas,41,2049800,4861360650243862,297,3848337,887178,888,886290
6276,Maik Nawrocki,54,4991200,9929477500758927,601,8599953,3267044,3267044,0
6277,Cher Ndour,60,3944400,8686039431452739,523,7338383,6132914,613292,5519622
6278,Abdallah Ndour,64,1032900,9818061030633456,332,3059137,2440082,0,2440082
6279,Nico Neidhart,48,3171100,6378337635123451,384,5509113,3661077,367,3660710
6280,David Nemeth,55,4114000,4101771055935211,553,7040411,6494275,0,6494275
6281,Richard Neudecker,48,1455400,6746172754574744,256,2799497,1292940,130,1292810
6282,Serge-Junior M. Ngouali,58,2809900,6454106880601401,398,5285874,2744629,2745,2741884
6283,Julian Niehues,57,3422300,3005080364001831,507,6840758,4640632,464064,4176568
6284,Carlos Nieto,24,846100,7708618860113234,75,932911,627310,0,627310
6285,Calem Nieuwenhof,28,1927100,3803400309817475,175,2762981,1405531,140554,1264977
6286,Sivert Heltne Nilsen,43,1378800,6309047430475550,251,2705054,2264254,2265,2261989
6287,Ken Nkuba,34,2724300,4443211051917071,286,3852857,3814468,38145,3776323
6288,Jean Felipe,35,1088700,5289212624448129,139,1628593,252152,0,252152
6289,Noguera,26,927200,6032397891759358,126,1564796,370180,370180,0
6290,Atdhe Nuhiu,23,1512300,3746556885367814,123,1967227,528231,0,528231
6291,Santiago Núñez,30,1263800,7656315041934871,125,1719338,576131,576131,0
6292,Thiago Nuss,26,1795900,8759486102927715,154,2569176,2070887,2071,2068816
6293,Samuel Obeng,24,2533000,9339030715760987,231,3391085,856832,0,856832
6294,Adam Obert,60,3990900,7260992394977174,525,6978940,5947287,0,5947287
6295,Jáder Obrian,23,916200,4454689236975186,53,800977,689932,68994,620938
6296,Stephen Odey,69,4886700,9968792927003772,763,9590316,5282534,5283,5277251
6297,Wilson Odobert,42,4521300,6631486389096562,494,7042897,3575453,0,3575453
6298,Raphael Odogwu,28,693400,8748583518632740,79,863467,42531,0,42531
6299,Oh Ban Suk,65,3344500,3387028955409468,492,6083593,3773663,0,3773663
6300,Jeppe Okkels,62,538200,5414971289874406,260,2137719,346302,346302,0
6301,Andrigo,60,3045400,3829998783432649,404,5614518,2412882,2412882,0
6302,Lucas Rosa,47,1798000,3739484395835419,294,3443628,235368,0,235368
6303,Cleiton Silva,48,2962100,9857891704972396,423,5748413,3339767,333977,3005790
6304,Cristian Olivera,52,613100,6469867920538445,274,2473308,239340,0,239340
6305,Jan Olschowsky,23,4558600,8302228476356713,409,6751185,79216,0,79216
6306,Simon Olsson,38,4208200,5204828919184937,462,6628858,2863655,287,2863368
6307,Bećir Omeragić,24,4265100,8971761087446144,395,6634467,1632340,16324,1616016
6308,Odei,59,2701500,9867009766551637,455,5785305,4614329,46144,4568185
6309,Ontiveros,29,4210600,6499190787646949,328,6309315,3739861,0,3739861
6310,Kwadwo Opoku,38,3621900,4655028136032799,361,5384592,3605132,361,3604771
6311,Aaron Opoku,41,2068900,3853574008598449,279,3757297,1379141,13792,1365349
6312,Iván Ortigoza,39,2893300,7063067290826261,299,4739910,839060,83906,755154
6313,Ortuño,56,3198100,7375437213117722,429,5983975,1175393,118,1175275
6314,Erick Otieno,60,4944500,7006422487270768,612,8772441,974636,975,973661
6315,Prince Osei Owusu,45,4207400,5315547009318908,474,7086988,1355961,135597,1220364
6316,Marko Pajač,23,2894700,5682976697583176,199,3676527,1871885,188,1871697
6317,Brandon Palacios,43,4502800,8614100193459774,460,7433688,920644,921,919723
6318,Ante Palaversa,39,3729300,4161734264400076,383,5492864,464157,465,463692
6319,Daniel Paraschiv,40,3673600,7880750435389698,397,6349166,2583220,25833,2557387
6320,Cristhian Paredes,51,1987300,4731153020478198,304,3701458,3136497,0,3136497
6321,Miquel Parera,38,2971300,3141343738550880,383,5130069,2764381,2764381,0
6322,Ezequiel Parnisari,37,970500,7368351853983007,145,1651452,1397528,1398,1396130
6323,Alfonso Parot,43,3171400,6337420144018797,398,5515983,1220953,1221,1219732
6324,Martín,41,3008000,4522990203984329,360,5287080,3259961,0,3259961
6325,Charlie Patino,70,609700,6375295673824705,395,3494007,1010607,1011,1009596
6326,Nicolae Păun,36,1345000,3653003380494345,184,2246141,616786,6168,610618
6327,Milan Pavkov,25,2990700,9692272086221544,251,4033835,161041,161041,0
6328,Pietro Pellegri,37,4766600,4469040632611913,469,6980453,952913,95292,857621
6329,Nicolás Peranic,67,920000,4121957930338916,413,3841754,1735269,173527,1561742
6330,Edwin Peraza,36,2189800,4657281831934848,243,3461046,3452469,3453,3449016
6331,Juan José Perea,31,1903400,5647198638860978,218,2973030,1913972,192,1913780
6332,Gustavo Peredo,32,4460000,8210232823055600,459,7228701,2939982,2939982,0
6333,Pablo Felipe,43,2005600,7399425302727397,248,3219167,745978,745978,0
6334,Pedro Tiba,43,1595200,4801117105169211,271,3320865,2884999,0,2884999
6335,Jorge Pereyra Díaz,53,3803400,4731634507296804,446,6385297,4942561,495,4942066
6336,Juan Pérez,63,846400,4137974257536611,320,2999243,462692,0,462692
6337,Antonio Pergreffi,54,3015900,7272024967643071,442,5387344,1562702,1563,1561139
6338,Stipe Perica,56,3054400,3799739508524532,503,6291165,4594091,460,4593631
6339,Kamil Pestka,42,434500,6579514088895175,164,1336990,162427,0,162427
6340,Lukas Petkov,65,4766200,9247875820271855,722,9670772,7814430,7814430,0
6341,Tomáš Petrášek,53,3440000,5247158327104792,477,6882811,4958157,0,4958157
6342,Dimitri Petratos,69,1364200,8753722575212454,387,3816821,1469193,1469193,0
6343,Raoul Petretta,53,2743400,5323471649336034,397,5072773,2591684,25917,2565767
6344,Radosav Petrović,38,1664400,4148970786041030,243,3144443,2834164,0,2834164
6345,Isak Pettersson,41,4955400,4930000405689656,548,8497459,5464518,547,5463971
6346,Tom Pettersson,28,2635200,5519414239549343,261,4007214,1210170,1211,1208959
6347,Luca Pfeiffer,67,1203000,9202982289962768,382,3959139,3819711,0,3819711
6348,Leonel Picco,55,576400,4338944114527227,247,1991485,1582476,158248,1424228
6349,Benedikt Pichler,45,3827500,9416916005331258,411,5997207,4704124,47042,4657082
6350,Simon Piesinger,61,4061500,4707395194399590,580,7370561,808247,809,807438
6351,Donovan Pines,33,4043600,6026326566333037,347,6431572,2027480,2027480,0
6352,Guilherme Ramos,44,2330600,4438621751486163,294,4283834,678901,0,678901
6353,Reno Piscopo,54,1171800,9046353538192848,313,2964662,559772,0,559772
6354,Vicente Pizarro,49,3826100,3490534347818881,426,6002381,2810807,2811,2807996
6355,Ewoud Pletinckx,62,3315800,4527653491070176,473,6086993,3441142,345,3440797
6356,Kwame Poku,38,4289800,7621257734690637,420,6916909,5450316,0,5450316
6357,Jorge Pombo,70,2401700,5866973438513968,483,5739956,920185,920185,0
6358,Bruno Lourenço,56,1878100,7907114428749449,378,4110748,3150553,316,3150237
6359,Regan Poole,68,3885800,4556011631344496,530,7455896,2069929,2070,2067859
6360,Mihai Popa,47,2581600,4131122759764308,391,4990421,888166,888166,0
6361,Finn Porath,53,2353700,6494320747793295,389,4622291,3498177,350,3497827
6362,Łukasz Poręba,59,460500,7099950422103913,244,1871378,1705816,170582,1535234
6363,Dan Potts,49,3273200,3333736984502132,417,5787962,3549828,354983,3194845
6364,Nicolai Poulsen,37,3145200,6372531808562727,350,5092809,4327797,4328,4323469
6365,Gaëtan Poussin,48,747900,7960129916062455,199,1893821,331282,3313,327969
6366,Ian Poveda,39,4052700,8554446214024782,419,6292072,6115905,611591,5504314
6367,Darío Poveda,23,3937700,3543917309145695,315,5303807,1915606,19157,1896449
6368,Jesús Pretell,33,1249200,8536206074486335,144,1919660,1749866,174987,1574879
6369,Sebastián Prieto,63,3706800,9739258876239068,603,7463868,1757223,1758,1755465
6370,Aleksandar Prijović,53,1041900,9666840213315213,275,2584989,1862780,186278,1676502
6371,Ivan Prtajin,67,2216300,9881958910772790,459,5459415,2219712,222,2219490
6372,Kacper Przybyłko,26,4637800,4280796897438621,422,6667424,834035,0,834035
6373,Rokas Pukstas,25,4545500,7417514523173441,356,6318931,2750469,276,2750193
6374,George Pușcaș,42,3062300,3111583747220782,413,5568664,1548246,1548246,0
6375,Rubert Quijada,43,3711000,6511254648992676,465,6777518,569010,569010,0
6376,Mauro Quiroga,39,3589100,3141298841855467,373,5756659,3059569,306,3059263
6377,Matheo Raab,34,4714900,8168793085352389,507,8022529,3807823,380783,3427040
6378,Uroš Radaković,63,1950700,7819553513761081,431,4474056,2944015,0,2944015
6379,Aleksandar Radovanović,49,1153900,8964393798446560,279,2686255,1270045,12701,1257344
6380,Joe Rafferty,70,4434100,3667052910785457,605,8418692,7631287,76313,7554974
6381,Erdal Rakip,58,2630800,3388601899159383,433,5146797,51808,519,51289
6382,Christian Ramirez,39,3297100,5139752613379624,351,5383360,2147193,0,2147193
6383,Matías Ramírez,46,1514000,6131663666137046,228,2625982,938248,939,937309
6384,Reinhold Ranftl,44,3111600,4009416298794662,347,4921999,3288156,0,3288156
6385,Tobias Raschl,62,2191100,7878158003602855,485,5406071,173638,0,173638
6386,Osama Rashid,23,4512000,6767919118474791,353,6204613,813833,81384,732449
6387,Oliver Rathbone,48,2630500,5939170631054692,370,4468313,1957425,0,1957425
6388,Adam Reach,32,1320100,4575932275376222,148,1876721,1710154,171016,1539138
6389,Alejandro Rébola,46,3577700,8521248351090556,413,5671395,1790626,179063,1611563
6390,Kenny Prince Redondo,45,2719200,7324039823967679,333,4631075,1264971,1264971,0
6391,Dominik Reimann,61,4929700,6794070247890206,664,9386659,5621039,562104,5058935
6392,Zé Carlos,70,841300,3495600527003884,302,2820449,104207,10421,93786
6393,Eric Remedi,22,4369600,5293835163883399,352,6440040,1474724,1475,1473249
6394,Ren Hang,28,1315500,8185145356741157,140,1719581,1265064,1266,1263798
6395,Simon Rhein,43,1242400,5969602030628331,182,2157802,1419461,14195,1405266
6396,Jordan Rhodes,36,4962600,6466599504422760,495,7661822,6900150,6900150,0
6397,Léider Riascos,54,4362500,3024585752772489,558,8177785,8127542,8128,8119414
6398,Rodrigo Ribeiro,37,2395100,5051688483478314,299,4193073,2333821,23339,2310482
6399,Andy Rinomhota,36,4468400,9317458867619945,390,6660624,6280026,6281,6273745
6400,Birk Risa,56,2469700,3431704819385732,404,4857464,1157102,115711,1041391
6401,Cristhian Rivas,50,1147100,3892794833413665,254,2810872,1285945,0,1285945
6402,Harold Rivera,36,2709300,5844096877810934,332,4893018,174470,174470,0
6403,Tyler Roberts,61,573600,3607334223985535,284,2348448,2327181,233,2326948
6404,Marc Roberts,53,4203000,6851623504936675,502,6934108,1715239,1715239,0
6405,Nuno Moreira,24,2187700,7817280592649573,172,2903950,575419,576,574843
6406,Thorsten Röcher,31,3549200,8320393475501476,388,5661543,5301709,0,5301709
6407,Ronny Rodelin,34,3245200,3555028657664391,344,5582192,5074444,5075,5069369
6408,Thiago Rodrigues,53,1242200,8749315333851612,311,3196173,1158661,11587,1147074
6409,Hernandes,32,2722500,8548732570724900,281,3925329,3450922,3451,3447471
6410,Vítor Gonçalves,27,601200,8653979709527027,95,940933,283375,283375,0
6411,Lucas Rodríguez,39,2420500,5929765193703777,325,4556627,1873112,187312,1685800
6412,Martín Rodríguez,45,4962100,9472460197947310,560,8341043,152836,0,152836
6413,Aldair Rodríguez,50,4382500,6368402513398886,579,8019764,6591218,660,6590558
6414,José Luis Rodríguez,65,944000,9246895647526639,342,2946072,2069328,206933,1862395
6415,Maximiliano Rodríguez,23,2383600,7739663907348254,180,3227779,401271,402,400869
6416,Sebastián Rodríguez,45,1173300,7071313587435551,245,2471327,582890,58289,524601
6417,Cristopher Rodríguez,69,2275200,8233358006876334,500,6102435,1604262,1605,1602657
6418,Nicolás Rodríguez,39,4436400,5417851001766185,434,6631797,5311740,53118,5258622
6419,Jackson Rodríguez,24,3341600,7914484374620284,270,4838511,3807244,0,3807244
6420,Luis Romero,38,3615600,3337511085736406,337,5352487,2143655,21437,2122218
6421,Philippe Rommens,55,4868300,6268945327413027,581,7890151,4508126,45082,4463044
6422,Dave Romney,63,559700,7304712563346430,276,2186851,2045010,0,2045010
6423,Connor Ronan,25,4689300,7547658402402548,379,6848782,5052572,50526,5002046
6424,Frank Ronstadt,34,2340300,8518188736886353,302,4171717,1620012,162002,1458010
6425,Ros,46,4347400,3112339888570604,449,6955334,5968075,0,5968075
6426,Damian Roßbach,64,1943800,8607003057956640,429,4451061,1975239,1975239,0
6427,Nicolás Rossi,55,524000,8390930576412790,236,1989672,1110511,0,1110511
6428,Raphael Rossi,69,1042700,6991066050313427,384,3430678,2035376,0,2035376
6429,Óscar Ruiz,50,2298600,5197392057767862,410,4883100,1983098,1984,1981114
6430,Leonardo Ruiz,62,4033200,9584732525843415,511,7137963,6232343,0,6232343
6431,Víctor Ruiz,52,2633100,3592557420243503,402,5016280,3773921,378,3773543
6432,Carl Rushworth,30,4926800,9211541511750520,445,7835190,6279167,628,6278539
6433,Serdar Saatçı,42,2861500,6645841168243412,377,5248716,4599805,4599805,0
6434,Halid Šabanović,55,306800,5081066506121118,181,1263092,1204071,1205,1202866
6435,Armando Sadiku,32,2918700,3065580323672264,284,4451862,929976,9300,920676
6436,Ibrahim Sadiq,40,334100,6106970252584287,152,1124585,58370,0,58370
6437,Scotty Sadzoute,36,1015300,5216668877103972,169,1929150,277313,0,277313
6438,Jorge Sáenz,69,2503000,5380797873781900,535,5782131,1628380,16284,1612096
6439,Lars Sætra,54,3325700,5856946433790752,488,6692511,6330213,634,6329579
6440,José Sagredo,42,2474900,4643608160717605,327,4070854,3009383,301,3009082
6441,Ömer Ali Şahiner,24,4590200,5757123245565921,371,5986898,1315928,131593,1184335
6442,Oliver Sail,37,2124800,9101890006835702,252,3383876,429533,4296,425237
6443,Amir Saipi,35,4116700,4595331559991666,395,6276934,792235,79224,713011
6444,Henri Saivet,64,1501600,6162732453781137,361,3731245,1211707,0,1211707
6445,Amine Salama,34,1281500,4930806210355533,202,2335257,1794248,1794248,0
6446,Eddie Salcedo,50,3184900,4382604059433753,433,5499064,4305044,430505,3874539
6447,Anton Salétros,66,3561500,5561921223149692,525,7193163,2367879,237,2367642
6448,Alessandro Salvi,69,1670300,5990426830122255,384,4060823,3022127,303,3021824
6449,Ronaldo Sánchez,40,2530400,5592467853577538,256,4077186,2090879,209088,1881791
6450,Luciano Sánchez,37,2776900,5627663866215156,299,4443775,914779,914779,0
6451,Luismi,31,4883900,3200705570925319,397,6865419,1684143,1685,1682458
6452,Josema,28,2870400,8848670148309623,260,3835424,3815913,0,3815913
6453,Juan Sánchez Purata,41,4757800,7058523517943715,434,7274945,3458690,346,3458344
6454,Nacho,27,1643800,8797648218742912,178,2492425,2281092,0,2281092
6455,Niklas Sandberg,53,841000,4398553321599827,237,2279055,1594619,1594619,0
6456,Dion Sanderson,64,1213100,7432092931200250,319,3245317,359158,360,358798
6457,Agustín Sández,58,2097100,6892865801165294,383,4502698,3932356,393236,3539120
6458,Gustavo Sangaré,33,838700,8240845716099449,120,1214779,1084834,1085,1083749
6459,Benjamin Santelli,45,3697900,8255300018846831,453,6989998,3204118,321,3203797
6460,Sergio Santos,25,4310300,5064328401435160,333,5673408,1330159,133016,1197143
6461,Abdoulie Sanyang,22,2374000,8381858799821981,185,2926281,2699699,269970,2429729
6462,Matija Šarkić,49,4120800,3325867297935232,508,7171272,1560062,1561,1558501
6463,Zvonimir Šarlija,57,2854000,8595179428776130,421,5215381,1116805,1117,1115688
6464,Martín Sarrafiore,37,928000,7466491108486221,146,1649889,1020438,10205,1010233
6465,Fernando Saucedo,41,2394900,3886905356261459,281,4024304,754967,0,754967
6466,Bruno Sávio,32,1435600,4887357956952368,160,2362657,214638,2147,212491
6467,Allahyar Sayyadmanesh,55,2220200,3595280567081080,365,4460879,2314881,2314881,0
6468,Stefan Schimmer,33,990600,4261532614666788,166,1758686,181313,18132,163181
6469,Alessandro Schöpf,58,3581800,9842121314970402,518,6595027,2472146,24722,2447424
6470,Marvin Schulz,52,4219800,4234288263563478,518,7267271,5258813,0,5258813
6471,Stefano Scognamillo,67,1741400,7504422705853814,440,4655051,3609914,0,3609914
6472,Zito Luvumbo,24,4911900,5786026266176041,382,7279291,3351699,0,3351699
6473,Moustapha Seck,55,3518900,5797651662972321,481,6153061,644,0,644
6474,Marcel Seegert,61,1552100,8236323011507649,333,3713956,3106872,3106872,0
6475,Jacopo Segre,69,841500,8071725832793762,311,3070028,2871025,287103,2583922
6476,Muhammed Şengezer,63,1174000,3985883354227308,383,3927546,1052691,10527,1042164
6477,Aaron Seydel,27,4507900,9024558414070246,345,6255865,587936,5880,582056
6478,Jamie Shackleton,70,1805700,5733149796422750,423,4236720,2589554,0,2589554
6479,Shi Ke,66,4062000,7411471477452324,635,8297276,8111278,81113,8030165
6480,Maryan Shved,26,4614600,7411124118775689,336,6244827,2941523,29416,2912107
6481,Mahamé Siby,67,414000,7458801878148060,334,2746195,1075182,1075182,0
6482,Kalidou Sidibé,55,992600,4790936421896413,325,3250770,2071394,0,2071394
6483,Jörg Siebenhandl,41,842600,9405684285447045,144,1574963,1312309,0,1312309
6484,Dávid Sigér,26,3924200,9784633279342122,383,6560209,2470938,0,2470938
6485,Marco Matias,69,547800,6552580122492375,292,2391012,1553929,155393,1398536
6486,Zé Manuel,36,4729600,5449760642032842,448,7189707,6562502,6563,6555939
6487,Jean Carlos,66,868700,5217129477050077,363,3320173,2999392,299940,2699452
6488,Judson,33,3374300,6562261192860482,350,5192576,496204,496204,0
6489,Sim Sang Min,55,1366800,4231672371699112,304,3309020,1516734,0,1516734
6490,Ellis Simms,50,1832500,6826279762134484,342,4256738,2220225,222023,1998202
6491,Sarpreet Singh,68,2487000,9970981286740370,459,5196325,4251475,0,4251475
6492,Sheriff Sinyan,40,3668800,3879745841308081,433,6236522,1406773,1406773,0
6493,Jonathan Sirois,66,3805800,5869209879825568,595,7128707,4462071,0,4462071
6494,Issouf Sissokho,50,1675400,3731214714363909,297,3397381,2429666,242967,2186699
6495,Alpha Sissoko,33,745100,3866984934897132,113,1172856,419871,419871,0
6496,Will Smallbone,37,3976500,9462742074005460,381,6083790,1147980,115,1147865
6497,Rafael Camacho,60,3596200,7403170334906893,570,7046601,1504232,15043,1489189
6498,Álex Sola,43,3458900,8974025821069001,354,5733389,2787432,0,2787432
6499,Santiago Solari,22,3015500,8711417334657610,249,4034545,3398453,339846,3058607
6500,Nikola Soldo,31,2467000,8008760092889926,285,3953635,774688,775,773913
6501,Jhon Solís,68,1905700,4882504636052866,452,4483480,4067542,0,4067542
6502,Oliver Sonne,31,4714500,6281861795110934,459,7326948,5117127,511713,4605414
6503,Ramiro Sordo,49,4519600,6287936023113463,521,7231080,1606313,0,1606313
6504,Mads Bech Sørensen,31,979800,4433552770466196,128,1629183,1545859,1546,1544313
6505,Issa Soumaré,29,1680700,6442663757892169,192,2488130,1138698,1139,1137559
6506,Furkan Soyalp,59,1543900,8037891371293156,322,3701492,798895,0,798895
6507,Jorne Spileers,50,4869300,9356485133347407,573,8246144,2031786,204,2031582
6508,Filip Stanković,38,4724200,6240906915520685,461,7253508,1836904,1836904,0
6509,Nicolás Stefanelli,69,803200,9034841121036823,317,2960590,19660,1966,17694
6510,Herman Stengel,40,3219700,4839103398330637,387,5271198,4591075,45911,4545164
6511,Dujon Sterling,50,809200,6914996155467372,217,2035873,1042428,0,1042428
6512,Filip Stojilković,67,4124500,9937803400894255,627,8168520,6645931,664594,5981337
6513,Sebastian Stolze,49,4709600,8691049065371196,492,7800927,4691097,4692,4686405
6514,Rafał Strączek,64,3767200,5726498543313149,538,7004077,4951410,49515,4901895
6515,Ryan Strain,68,2800900,5690654946792911,513,6525270,61502,0,61502
6516,Brad Stuver,36,1574200,9778681559865309,221,2770133,1674623,0,1674623
6517,Ibrahim Sulemana,31,1616500,9158750962415511,199,2637279,909111,90912,818199
6518,Fran Supayabe,57,942600,8601602329100878,278,2751089,516481,51649,464832
6519,Sander Svendsen,54,4215400,5856370233860842,508,7544535,5543196,5543196,0
6520,Michael Svoboda,53,1024900,6872568550010717,277,2658374,2652858,2653,2650205
6521,Mark Sykes,45,4222900,6901354174214112,500,6744846,5546403,554641,4991762
6522,Ross Sykes,27,3221400,6530523716996154,305,4998727,4419453,0,4419453
6523,Moussa Sylla,41,1355700,9484953508292873,228,2694297,1983530,199,1983331
6524,Dawid Szymonowicz,44,4555800,7963875095584669,536,8528245,1780889,1780889,0
6525,Ryan Tafazolli,58,2790400,3721418417396645,433,5452421,455608,456,455152
6526,Kyosuke Tagawa,49,4691100,3417619226124201,567,8117430,3224317,0,3224317
6527,Adam Taggart,48,747500,6388304501990062,209,1895881,1398655,1399,1397256
6528,Ravil Tagir,32,4756500,9549334811022214,467,6973556,2720622,0,2720622
6529,Matias Tagliamonte,29,1859800,6623843122293608,185,2779178,505028,50503,454525
6530,Mateo Tanlongo,63,3921200,9221590742555189,570,7584078,1107408,111,1107297
6531,Miguel Tapias,59,1807500,5386906050752174,386,4579597,1708148,1708148,0
6532,Oussama Targhalline,69,2951000,5646735779440467,474,5982745,3217355,0,3217355
6533,Niklas Tauer,43,3905200,3564604243521351,415,6181636,10867,0,10867
6534,Yohan Tavares,46,4641100,3947306480981981,527,7674396,3841834,3841834,0
6535,Casper Tengstedt,54,789100,4528190214987557,209,2120045,719872,719872,0
6536,Mailson,44,2577800,3710735007891216,344,4886988,2628885,2628885,0
6537,Tanner Tessmann,62,3234100,6318476318746285,495,6701576,1879978,0,1879978
6538,Maximilian Thalhammer,65,2834900,5405706600956073,485,6285169,2258255,2259,2255996
6539,Jamal Thiaré,46,3625100,3549560437156557,407,5958706,3114003,31141,3082862
6540,Marco Thiede,39,4884400,9870863646179741,518,7659620,7134127,7134127,0
6541,Bobby Thomas,53,952400,5047887328490586,260,2560072,1794276,180,1794096
6542,Brandon Thomas-Asante,59,2476500,6176583999138936,402,5202133,4059614,406,4059208
6543,Timothy Tillman,55,3195700,3041245664798943,395,5617309,5603426,0,5603426
6544,Bastien Toma,52,4020400,9733433143047597,546,7294941,5811271,58113,5753158
6545,Mirko Topić,22,4898900,7858843281270531,447,6718341,5786827,0,5786827
6546,Joaquín Torres,34,4565900,5425755181905947,454,7171357,4131071,41311,4089760
6547,Abdoulaye Touré,57,3242200,6148851771976063,470,5814175,3335241,0,3335241
6548,Boubacar Traoré,47,4655400,9876868910271192,555,8489752,3867650,387,3867263
6549,Bubacarr Trawally,32,725200,5676730116415840,114,1255456,1010404,0,1010404
6550,Anders Trondsen,27,3336700,7780973628451625,347,5321533,2521240,0,2521240
6551,Mohamed Buya Turay,59,1701200,9899370416606355,361,4014126,3367736,337,3367399
6552,Hüseyin Türkmen,61,3167800,8659658463711027,540,6582417,6541728,655,6541073
6553,Turrientes,24,4839800,6568365153763944,388,7212718,607277,607277,0
6554,Gennaro Tutino,26,3171200,6398194808345931,298,4741445,3705287,3706,3701581
6555,Marián Tvrdoň,41,4501100,4712148715382956,415,7048160,4988400,49884,4938516
6556,Josh Tymon,31,2819500,9302471378297798,274,3819132,2951375,0,2951375
6557,Maximilian Ullmann,35,1129000,3668381777275471,156,1886075,1663576,1663576,0
6558,Luciano Ursino,48,3617000,5083423998444357,441,5854046,2251058,2251058,0
6559,Necip Uysal,36,4745900,9994127506875495,451,7359533,6446993,0,6446993
6560,Ramiro Vaca,45,3471300,6859290053265614,454,6241061,6110457,61105,6049352
6561,Kyan Vaesen,64,2249500,8969341850146046,480,5015900,1480162,1481,1478681
6562,Etienne Vaessen,34,4647500,7059985926227332,466,7279786,3514834,3514834,0
6563,Leonardo Valencia,57,1511300,8903780979596404,339,3798439,1800321,1800321,0
6564,Valera,66,4214100,8592058371394726,589,7270030,1043334,1043334,0
6565,Vallejo,49,2839700,6014502621704744,388,5191653,1448531,14486,1434045
6566,Gustav Valsvik,54,2608500,3491500704947880,409,5490537,349174,349174,0
6567,Luca Valzania,52,3378900,8495650907964534,448,6249713,1502198,15022,1487176
6568,Pelle van Amersfoort,67,1262700,6124958753618995,361,3764148,786518,786518,0
6569,Kévin Van Den Kerkhof,66,4369700,5578277292573495,613,7829534,1070168,107017,963151
6570,Ignace Van der Brempt,33,4051400,8430882957906593,380,5966728,235141,0,235141
6571,Hannes Van Der Bruggen,50,2639900,6372312769856268,420,4871160,3000401,300041,2700360
6572,Lukas Van Eenoo,65,1436500,8529245057307774,419,4199443,2517877,0,2517877
6573,Bram van Polen,68,2416200,7520120978019291,447,5379872,996649,0,996649
6574,Bart van Rooij,55,1913700,4036015764306509,372,4282879,3344552,33446,3311106
6575,Tom Vandenberghe,48,2611100,4500078551072502,362,4870581,3937023,3938,3933085
6576,Oscar Vanegas,26,4401000,7450477450595406,410,6442831,5370583,5370583,0
6577,Miguel Vargas,52,2756500,4571695655302047,433,5733889,2397694,23977,2373717
6578,Thibaut Vargas,45,3652700,8199890528904639,453,6370708,4088223,4088223,0
6579,Indiana Vassilev,24,2437300,6891218680064728,220,3488694,1551372,156,1551216
6580,Bogdan Vătăjelu,59,4029900,6733930526913455,541,6958913,6064887,0,6064887
6581,Ignacio Vázquez,63,3560600,8647701833365201,531,6890951,4349184,435,4348749
6582,Marko Vejinović,43,4001900,7117991162356932,452,6242920,2639874,264,2639610
6583,John Velásquez,69,1903500,5328135506790984,438,5130472,1201192,1201192,0
6584,Dylan Vente,37,1076100,5997530081892362,176,2053904,321310,3214,318096
6585,Elvio Vera,23,4493600,8122131272720737,409,6924923,5222945,5222945,0
6586,Jesper Verlaat,29,4342700,4076630075752058,375,5995721,3707730,3707730,0
6587,Vincent Vermeij,54,2784900,6555753554195212,399,5255715,2418921,2419,2416502
6588,Arno Verschueren,36,2584100,3375124943128203,292,4075775,3345157,3345157,0
6589,Luca Vignali,40,4229600,8860165514579989,480,7158775,307571,30758,276813
6590,Christian Vilches,25,3241200,9883738770809116,267,4464159,2581058,2581058,0
6591,Yordi Vílchez,51,480000,7146503670498537,204,1657603,531478,5315,526163
6592,Roberto Villamarín,25,2364500,4311002036556661,212,3317855,2373940,2373940,0
6593,Alan Virginius,25,3676600,7787653710320343,300,4925038,4192919,419292,3773627
6594,Emiliano Viviano,67,4460800,4021663448213828,664,8984754,6623519,0,6623519
6595,Zak Vyner,38,4172400,9194871005338601,461,6379998,3055171,0,3055171
6596,Leopold Wahlstedt,63,3113000,6963376869429113,467,5947929,5261749,526175,4735574
6597,Christian Walton,64,2531400,3126678665028195,486,5746054,3849598,0,3849598
6598,Wang Shangyuan,26,2845700,8328341987449466,221,4050272,502824,502824,0
6599,Django Warmerdam,44,512800,6887775890821831,176,1512830,852032,85204,766828
6600,Boy Waterman,50,1040600,6871382692651031,262,2595127,1849905,18500,1831405
6601,Duncan Watmore,49,1388600,6474357984623647,288,3210066,2927332,2927332,0
6602,Erik Wekesser,32,4911800,7690288129728048,436,7062891,4130211,41303,4088908
6603,Erick Wiemberg,29,3850900,7105772140828093,343,5886151,4880426,48805,4831621
6604,Joe Wildsmith,25,4731500,5113050125295969,439,7249751,3564803,357,3564446
6605,Willum Þór Willumsson,33,1643600,7943236704374183,167,2172339,1733760,1734,1732026
6606,Henry Wingo,52,599300,4445142506315015,225,2018268,194451,0,194451
6607,Rafał Wolski,37,4274300,9867208910141349,444,6489987,2992074,0,2992074
6608,Nathan Wood,45,1433700,3017037685506967,244,2914443,392869,0,392869
6609,Ryan Woods,32,4578600,4906464827108644,386,6663443,4593471,460,4593011
6610,Rubén Yáñez,26,2833200,6735782000317972,295,4367826,379679,379679,0
6611,Yang Hyeon Joon,62,1004300,4439701959486301,337,3041260,1035770,103577,932193
6612,Yang Liyu,26,409800,4704497588318361,66,491811,385256,3853,381403
6613,Jamie Young,47,2980700,4318936924155681,407,5358028,99296,100,99196
6614,Mohamed Youssouf,29,2840900,5131285781446357,255,4285231,1438639,1439,1437200
6615,Frank Ysique,36,3766500,3305313358564834,379,6005023,4354397,4355,4350042
6616,Yuri,43,2332400,3809094002653748,301,4068530,1684974,1685,1683289
6617,Giovanni Zarfino,54,992000,8487876498893911,285,2620975,1222336,0,1222336
6618,Oskar Zawada,40,3272000,7360762646770447,324,5284381,4772563,478,4772085
6619,Mehdi Zeffane,35,2284600,4121263191917949,262,3457657,2803050,0,2803050
6620,Kevin Zenón,49,1998500,6206982061692572,303,3626682,1062783,107,1062676
6621,Michael Zetterer,42,4545600,7973353491769195,498,7352100,297202,297202,0
6622,Zhang Xizhe,40,2420400,6152715482122451,290,4065585,153536,154,153382
6623,Zheng Zheng,58,1885500,5450231652249334,348,3762548,1671079,1671079,0
6624,Zhu Chenjie,60,3103000,7733159264530950,421,5215256,2508745,2508745,0
6625,Zubiaurre,47,1329300,8237170797765621,230,2756926,123804,0,123804
6626,Hendrick Zuck,40,2554700,3448257144332549,320,4465279,3360418,33605,3326813
6627,Dilan Zúñiga,69,1735500,3537254065048518,391,4247221,2334410,2334410,0
6628,Łukasz Zwoliński,43,2997900,6270646656241576,377,4952556,3440965,345,3440620
6629,Shuto Abe,36,593100,4772498230783795,137,1271877,273454,0,273454
6630,Dickson Abiama,66,4416400,7749306255476910,680,9339990,6074965,6075,6068890
6631,Dawid Abramowicz,62,4662600,3242092702167113,650,8885474,8097573,809758,7287815
6632,Lalas Abubakar,32,923000,9427865767661673,144,1597023,919989,0,919989
6633,Asumah Abubakar,34,768600,8598456982346354,135,1358726,597823,598,597225
6634,Giorgi Aburjania,47,2613500,9256548398735038,348,4552010,3154107,3154107,0
6635,Elias Achouri,31,2859300,4938242558285805,261,4041406,656020,6561,649459
6636,Ebou Adams,26,3605800,7249241314003987,328,4987942,2447665,2447665,0
6637,Tonni Adamsen,44,1590400,4463126427265937,261,3138059,497787,0,497787
6638,Victor Adeboyejo,33,1167700,5486368841194441,175,1995752,1148725,1149,1147576
6639,Bobby Adekanye,57,2776900,8892102618898842,450,5649938,3265622,0,3265622
6640,Kemal Ademi,26,1308300,4489349634046794,117,1752000,1244658,124466,1120192
6641,Jordan Adéoti,39,4541600,9329249556275165,461,7256022,2502900,251,2502649
6642,Albert Adomah,60,2990800,7627784740837223,464,6198636,3179775,0,3179775
6643,David Agrón,54,1700100,5855137646382467,339,3586677,2841251,2841251,0
6644,Brian Aguirre,37,415200,5006494450602740,109,915085,34480,3448,31032
6645,Emanuel Aiwu,54,462500,3071128923708860,270,2219875,1761242,1761242,0
6646,Abdullah Al Ammar,53,4217100,9802003726654778,524,7677503,4872275,48723,4823552
6647,Abdulaziz Al Bishi,63,2326200,8865016528682750,395,5164371,1774473,0,1774473
6648,Mohammed Al Kuwaykibi,47,2627500,4079607003847906,400,4994159,2318137,232,2317905
6649,Sumayhan Al Nabit,24,752400,3812666980794109,58,770601,56120,0,56120
6650,Madallah Al Olayan,36,3309800,8984719817404359,416,5832764,111511,0,111511
6651,Abdulmajeed Al Sulayhim,35,2285600,4814435080278310,293,3777936,3105060,311,3104749
6652,Sofiane Alakouch,49,1446700,7050804139120404,282,3047194,1335551,1336,1334215
6653,Francisco Alarcón,65,976100,6162884725331641,327,3155362,167068,16707,150361
6654,Alarcón,25,4846100,3987841532974303,455,7036783,4530009,454,4529555
6655,Miiko Albornoz,70,2498900,9059742364068144,478,5319813,1235977,0,1235977
6656,Gonçalo Borges,28,1640400,4377398600069864,174,2581165,334971,0,334971
6657,Tom Aldred,69,3406500,3497790216992646,528,6899674,3474440,3474440,0
6658,Ajibola Alese,28,4604500,4126771607312726,458,6782416,5690122,0,5690122
6659,Matías Alfonso,38,1153800,3239364196281659,225,2519077,1782332,17824,1764508
6660,Ezequiel Alfonso,39,4856700,9030992128390762,470,7216309,5470201,0,5470201
6661,Baba Alhassan,65,1790700,9393284119765620,396,4565776,1943752,1943752,0
6662,Fidan Aliti,55,581100,3117509808309015,242,2014667,112793,112793,0
6663,Ryan Allsop,35,587500,9439923772222105,106,1020635,634314,63432,570882
6664,Jostin Alman,61,3952500,6654090185687427,560,7953162,76906,76906,0
6665,Osvaldo Alonso,25,1457100,9253142592853518,114,1824363,1702549,171,1702378
6666,Javi Alonso,62,1004700,8750790671342482,349,3181183,1254308,1255,1253053
6667,Jaime Alvarado,68,1720100,4621793486155720,388,4377095,4176589,418,4176171
6668,Cristian Álvarez,58,4001800,4311918718057629,484,6626347,5530970,0,5530970
6669,Favio Álvarez,59,2526800,5064546291822135,449,5370181,5231734,0,5231734
6670,Kikas,34,3004600,9183445670860488,343,4697779,1170891,118,1170773
6671,Jun Amano,67,4269100,7631937372046917,569,7496248,4760942,4761,4756181
6672,Etienne Amenyido,55,3190700,6356400210296332,476,6297411,5989290,5989290,0
6673,Jamal Amofa,33,3360700,5273574804107256,341,5404176,4974653,0,4974653
6674,Ben Amos,62,2847200,9880876373655645,423,5633458,843681,84369,759312
6675,Malte Amundsen,26,1108500,3962183019353214,108,1486774,624428,0,624428
6676,Frederic Ananou,52,728100,4230986957317533,200,1854795,801058,80106,720952
6677,Jeppe Andersen,36,3633300,7220509063563403,394,5824824,4157510,0,4157510
6678,Hugo Andersson,40,3112000,3291920993276107,334,4930188,606308,0,606308
6679,Adam Andersson,63,4626900,5509010839446939,559,8419970,893448,89345,804103
6680,Elias Andersson,61,3763000,4588573045685298,515,6536887,5338177,5339,5332838
6681,Martin Angha,67,335400,5423077113414545,314,2305049,2002601,2002601,0
6682,Álvaro Angulo,42,4573200,9250440928199357,436,7227760,6997462,6998,6990464
6683,Larry Angulo,31,4614000,5197050168610933,446,7175768,68617,68617,0
6684,Peter Ankersen,37,4016800,7635218853139364,394,6408793,4517930,452,4517478
6685,Janis Antiste,29,4707700,5811850417313045,388,6370263,1607174,1608,1605566
6686,Oliver Antman,52,2237200,5868457167500842,338,4274431,3129498,3130,3126368
6687,Marcus Antonsson,63,304700,3625212724398513,268,2151848,1153400,1153400,0
6688,Pablo Aránguiz,49,3306600,9838985542172135,456,5754560,5369403,537,5368866
6689,Kelvin Arase,31,3468000,8148407322123868,371,5647181,3705074,370508,3334566
6690,Miguel Araujo,33,3551300,3331283561149828,310,5022131,2391762,239177,2152585
6691,Juan Arboleda,49,804900,6300469528613963,223,2127845,858305,85831,772474
6692,Jean-Pierre Archimbaud,38,2556300,6327595894726503,290,4255709,2944826,29449,2915377
6693,Afeez Aremu,46,4696200,6413040402025643,487,7489137,7102929,0,7102929
6694,Igor Armaș,22,956700,7148568514500831,104,1302744,308893,30890,278003
6695,Yoël Armougom,62,4206900,5765356550390214,604,8075220,6847515,6848,6840667
6696,Daniel Armstrong,46,3128400,5566236109600813,444,6199961,3892628,3892628,0
6697,Kervin Arriaga,48,2857400,5376831623690609,366,4878584,1364170,1364170,0
6698,Carlos Arrua,59,3262900,6021117643136578,480,6492418,2211478,2211478,0
6699,Yamil Asad,60,1253100,8782000007096699,318,3311965,1870514,0,1870514
6700,Samuel Asamoah,30,3864800,5029123803203812,370,5785182,2734713,273472,2461241
6701,Gonzalo Asís,37,1804800,5967626819588825,217,2952602,2320995,233,2320762
6702,Joseph Attamah,54,3145700,8886326948007436,452,5618777,4569626,4570,4565056
6703,Julián Aude,29,943200,3901870758533592,122,1530164,1119629,0,1119629
6704,Rafał Augustyniak,64,3135500,8063138055418276,493,6510779,1828427,183,1828244
6705,Donis Avdijaj,56,697900,5783510006811066,313,2621947,1327743,132775,1194968
6706,David Ayala,41,4307200,4971679115911891,431,6429218,2096759,209676,1887083
6707,Mehmet Can Aydın,69,1123800,8214839367191303,389,3782140,3050148,30502,3019646
6708,Florian Ayé,28,2788500,3048826525113989,228,3966888,813819,814,813005
6709,Gustavo Sá,46,4645900,9935883862152694,485,7191101,5715374,0,5715374
6710,Joseph Baffoe,60,2630600,5436787137897638,464,5886441,3110873,0,3110873
6711,Ștefan Baiaram,44,2593200,5781985672212654,373,5100358,1959898,19599,1940299
6712,Ante Bajic,64,2691100,9168560743350613,438,5181248,210420,210420,0
6713,Waleed Bakhashwain,48,2863100,5108879021951079,400,5522789,5417954,5417954,0
6714,Mihai Bălașa,47,4615800,7416020910258032,464,7291495,2661534,0,2661534
6715,Daniel Silva,65,3972800,4474952688264610,660,8070028,3555558,3556,3552002
6716,Mamady Bangré,55,4270600,3991631032903842,502,7185270,1826012,1826012,0
6717,Péter Baráth,33,687700,4628373135842934,125,1239588,478607,4787,473820
6718,Roony Bardghji,70,3034300,4546228311711954,499,6266994,2258547,0,2258547
6719,Ahmed Barman,49,553300,5476454803791000,221,1833375,1102860,1103,1101757
6720,Anthony Baron,26,1253300,9622672709623954,121,1730015,208380,20838,187542
6721,Bernabé,67,2066700,5623522074788814,491,5579066,340549,3406,337143
6722,Bautista Barros Schelotto,33,1656600,4265439057441415,202,2629951,1849936,184994,1664942
6723,Matheus Aiás,50,3032400,9237782744450578,417,5148311,5143322,5144,5138178
6724,David Bates,57,3963000,7962249484378464,503,7376188,5487872,0,5487872
6725,Antoine Batisse,24,4219400,9646350821953062,361,6521627,4193977,41940,4152037
6726,Malik Batmaz,31,344400,6459495133818804,70,509089,403475,403475,0
6727,Marvin Baudry,42,349900,6400932739771613,117,883868,874097,0,874097
6728,Jonathan Bay,51,604800,8852235398923501,210,1721995,345572,0,345572
6729,Thomas Beelen,70,4637800,3007667175428859,683,9499252,201483,0,201483
6730,Andrea Beghetto,40,2670900,7351691277903463,305,4353855,3188910,319,3188591
6731,Aziz Behich,43,3152400,6727438900399462,378,5735684,3907788,391,3907397
6732,Hanno Behrens,23,1144900,9685295342475558,75,1170889,978901,9790,969111
6733,Efkan Bekiroğlu,64,1655800,3294989680344922,370,3931748,1375608,138,1375470
6734,Luca Belardinelli,42,2974300,9120473876181477,313,4772425,1636002,0,1636002
6735,George Bello,38,1538000,7955845761061917,243,3099892,3048258,30483,3017775
6736,Giuseppe Bellusci,47,4018500,5572120193437893,496,7222567,1087065,0,1087065
6737,Nicky Beloko,46,1112000,4538190675033474,201,2098928,797033,7971,789062
6738,Carlos Beltrán,67,3646400,8230957389127993,509,6940721,5955268,596,5954672
6739,Syam Ben Youssef,27,4589800,8692079756686251,354,6362596,3053871,30539,3023332
6740,Benaissa Benamar,27,2426100,8786614071844075,223,3731116,1245099,124510,1120589
6741,Amine Benchaib,60,4749900,4726169091479715,667,8515391,1938441,194,1938247
6742,Steven Benda,49,4369200,9565521423382476,510,7238484,5118609,512,5118097
6743,Leonardo Benedetti,51,3991000,7571155934471844,475,7180289,6658767,0,6658767
6744,Adrian Benedyczak,33,3961000,7868636535751725,415,6657112,479476,479476,0
6745,Jorge Benítez,50,3209800,4503281914398435,453,6152808,6001884,601,6001283
6746,Ryan Bennett,58,1887400,9572327640094199,368,4073835,3594342,359435,3234907
6747,Nicolás Berardo,62,565300,7294612270871792,244,2175659,1412428,0,1412428
6748,Loïc Bessilé,56,4956400,4747893716267496,613,9150619,335910,3360,332550
6749,Jefté,30,3793400,8060381964473198,347,5562647,564991,564991,0
6750,Vahan Bichakhchyan,52,4078500,4764969331383247,513,7101362,3226015,323,3225692
6751,Soufiane Bidaoui,57,932300,9135106449784336,330,2976992,2010117,2011,2008106
6752,Juan Bisanz,58,4898200,3374595178407683,588,8489974,1273515,127352,1146163
6753,Martin Bjørnbak,48,3943400,8452469428509931,463,6877951,5707803,571,5707232
6754,Corey Blackett-Taylor,52,2804400,3743395125845385,429,5591504,657326,0,657326
6755,Jérémy Blasco,50,4525800,7564114392559834,538,8369199,6875430,0,6875430
6756,Joaquín Blázquez,60,934400,7048342330219006,281,2666787,1628048,1628048,0
6757,Anthony Blondell,69,3739500,9885191356185954,565,7595382,6684696,6684696,0
6758,Bror Blume,60,3464100,6130172900396601,514,6467361,1173863,117387,1056476
6759,Victor Bobsin,58,3014800,9901533267937436,489,6239995,227217,22722,204495
6760,Roberto Bochi,58,2420400,8125240150587816,415,5105858,3789269,0,3789269
6761,Rodrigo Bogarín,66,1363100,4601974343701479,346,3420774,2204596,0,2204596
6762,Damjan Bohar,35,1747200,5684789096888370,219,2900108,2499239,24993,2474246
6763,Rémy Boissier,70,1955600,3969880829591299,446,4668958,4211639,4212,4207427
6764,Malcom Bokele,68,4026400,5013517263103571,547,7386356,480534,48054,432480
6765,Jack Bonham,55,528500,6064406989449267,239,1901900,1802603,18027,1784576
6766,Hendrik Bonmann,37,1965200,6066167279999178,247,3261178,444402,4445,439957
6767,Nikola Boranijašević,28,3262300,5702611167756148,302,4821203,219755,21976,197779
6768,Fabian Bordagaray,48,1839700,8322354189942921,295,3509754,2348341,0,2348341
6769,Heriberto Tavares,23,4899200,7917223891580738,425,7281028,4924471,49245,4875226
6770,Alexandar Borkovic,46,2268100,3050720291685753,327,4490444,3799106,0,3799106
6771,Dany Da Silva,48,4581500,6447479738829990,499,7809575,2545125,2545125,0
6772,Chiki,50,1582200,8453017037937231,286,3339858,115973,11598,104375
6773,Sebastian Borza,47,3263000,9274717384136942,460,5946962,4326203,4326203,0
6774,Benjamin Bouchouari,57,4336100,4171454945004575,581,7802259,3036162,3037,3033125
6775,Khalid Boutaïb,59,1621300,8214078990510930,354,3807834,271839,0,271839
6776,Amine Boutrah,23,2482300,5660880638787038,164,2994126,295213,0,295213
6777,William Boyle,23,4627800,4917178060310784,392,6530897,3085133,309,3084824
6778,Luke Brattan,33,4555000,4409050982947744,427,6334543,758056,759,757297
6779,Iker Bravo,40,3482700,4159405098030103,405,5873935,792313,7924,784389
6780,Nicolò Brighenti,55,3610400,5022504236128423,499,6193202,6131130,613113,5518017
6781,Sebastián Britos,33,1554100,5949798282874165,196,2574585,1735324,173533,1561791
6782,Kevin Broll,51,4457300,5812232044524080,531,7780996,1809314,0,1809314
6783,Moritz Broschinski,43,2142900,6936210790345839,287,3659686,3396402,0,3396402
6784,Jevani Brown,66,3649400,7844220731263431,557,6958891,2391307,2391307,0
6785,Thomas Bruns,58,2997200,8448185185643203,452,5692512,2175845,0,2175845
6786,Sergiy Buletsa,64,2770100,8790303423227888,526,6342462,760626,760626,0
6787,Cameron Burgess,52,2514100,8281293207527168,368,4849594,1946362,194637,1751725
6788,Valentín Burgoa,27,441400,5771583166253053,44,372816,54232,0,54232
6789,Cory Burke,42,1870800,7805373972420993,246,3223581,1248604,124861,1123743
6790,Oriol Busquets,40,2083000,4444641946702523,286,3562689,2240896,2240896,0
6791,David Button,26,3134900,9388467235182720,222,4419551,3474344,34744,3439600
6792,Nathan Byrne,41,1975000,9063731185129201,248,3281720,121298,0,121298
6793,Esnaider Cabezas,52,1143800,9237019685281055,277,2954024,240009,241,239768
6794,Jeronimo Cacciabue,42,3595200,4644286410880474,440,6194979,5032496,0,5032496
6795,Anthony Caceres,34,943600,9083979816413007,151,1751196,320895,3209,317686
6796,Nicky Cadden,46,4275900,9402578671740441,490,6824519,2453207,0,2453207
6797,Chris Cadden,43,4104500,3641041137748027,452,6621056,3982977,3982977,0
6798,Beder Caicedo,38,923500,9931876455381748,161,1746415,971232,971232,0
6799,Edison Caicedo,65,3373800,5729139453002053,510,6620084,5787637,57877,5729760
6800,Maximiliano Caire,48,3875100,7230426656921464,475,6622440,4303250,431,4302819
6801,Martín Calderón,66,348000,3996105802647287,298,2381784,929662,92967,836695
6802,Kerim Çalhanoğlu,23,1810600,8312258326563815,150,2564267,2135240,213524,1921716
6803,Drake Callender,66,1287500,5269302595598250,399,3942353,899150,89915,809235
6804,Samba Camara,38,326100,3641493403229722,115,886046,766710,76671,690039
6805,Ousmane Camara,60,4334000,3050766613104307,593,7320393,314218,3143,311075
6806,Campuzano,40,1887300,6308866882823024,282,3487800,1905526,0,1905526
6807,Nicolas Capraro,67,1076800,7528925490855736,372,3594368,1075366,1076,1074290
6808,João Carlos,34,998200,7677189167392715,176,1782472,667933,0,667933
6809,Fernando Cardozo,61,3821000,5924250722289960,506,7343757,278268,0,278268
6810,Graham Carey,60,4287500,8730593689582279,571,7453522,1938379,193838,1744541
6811,Yago Cariello,63,4472000,6057258611142184,528,8445478,4503404,0,4503404
6812,Bryan Carrasco,49,621900,7185542191552264,198,1670451,192213,0,192213
6813,Jordan Carrillo,54,2123500,5560597767378837,376,4357725,1544446,15445,1529001
6814,Josué Casimir,42,4967800,9464979556418750,465,7193379,3351025,336,3350689
6815,Yohan Cassubie,61,1493600,3010208132075782,373,3640837,1788639,178864,1609775
6816,Gonzalo Castillo,25,1344400,4993370130970823,114,1771754,960108,960108,0
6817,Jens Castrop,47,4794100,5879988640710231,526,8387725,7752044,7752044,0
6818,Yoann Cathline,28,654300,7174934055164778,95,1011994,671893,672,671221
6819,Emil Ceïde,36,1474600,3703593980686342,224,2683749,1172989,118,1172871
6820,Yuriel Celi,36,3639700,7831720478382086,407,6070203,842559,8426,834133
6821,Alessandro Celli,51,2520100,7763548196619084,333,4118202,379952,3800,376152
6822,Edwin Cerrillo,38,1889500,3300683237646667,225,3107041,2732769,274,2732495
6823,Yerson Chacón,23,2373100,5257939467184162,218,3220087,2385322,2385322,0
6824,Youssef Challouk,65,2626100,4129222327218596,514,6553112,956889,9569,947320
6825,Charilaos Charisis,26,2941300,9427411406749229,269,4112652,2413957,2414,2411543
6826,Samir Chergui,38,776900,4537978897661348,194,1714583,801694,0,801694
6827,Julián Chicco,54,3013800,7240203995868642,442,5909640,5518217,5519,5512698
6828,Edward Chilufya,43,4576600,8086371513358539,469,7571029,1464234,147,1464087
6829,Jeyson Chura,42,451900,3973188913270379,150,1193477,32938,0,32938
6830,Sadık Çiftpınar,29,4654100,5781559569868828,356,6245201,1523772,1524,1522248
6831,Sokol Çikalleshi,70,2517600,9254655353437011,469,5854484,781230,7813,773417
6832,Ramazan Civelek,44,4521300,6207084686822773,490,7482917,6804250,68043,6736207
6833,William Clem,47,3625300,3247700580918594,464,6355473,2861021,287,2860734
6834,Enrique Clemente,35,3693900,7786396599134646,361,6147057,3503958,3503958,0
6835,Óscar Clemente,34,1810300,7270173769499908,215,2882502,2324027,233,2323794
6836,Collado,38,2970500,5168780343904997,295,4361486,2338424,2339,2336085
6837,Ebrima Colley,27,4228600,9889435568777350,349,5873636,2123153,0,2123153
6838,Brad Collins,27,3487600,4045910909795508,301,4865500,2228439,2228439,0
6839,Callum Connolly,26,3871600,6565093988392657,358,5621380,3455645,346,3455299
6840,Jomaine Consbruch,33,4871500,7844806529698245,498,7539083,4523232,452324,4070908
6841,Andrew Considine,44,3320100,3908154488611555,419,5736932,3378548,337855,3040693
6842,Nikita Contini,69,1595100,7697406436949435,398,4306745,2589943,0,2589943
6843,Oliver Cooper,65,4303700,6142279167311534,587,8000832,1403640,140364,1263276
6844,Colin Coosemans,44,3151500,5733934036546612,412,5587115,4870446,487045,4383401
6845,Gabriele Corbo,28,4846500,9074102110796542,466,7031259,5839248,584,5838664
6846,Sebastián Corda,53,757300,7272123517565657,224,2081535,1931458,19315,1912143
6847,Niccolò Corrado,68,2283000,4390241454421074,448,5340699,3842702,3842702,0
6848,Marcel Correia,68,1498200,5258430732961643,377,4149950,50161,0,50161
6849,Ismael Cortez,26,4504100,3821641617862618,364,6263179,1065845,1065845,0
6850,Gustavo Cortéz,28,2724900,5323528778922823,265,3926727,3324824,3325,3321499
6851,Marcel Costly,69,1844000,4007983905925567,448,4914782,4888327,4888327,0
6852,Ismaila Coulibaly,33,3794100,6123564276735026,357,5817869,864961,865,864096
6853,Mamadou Coulibaly,36,2217700,3743684177607456,275,3918767,195123,196,194927
6854,Hayden Coulson,50,3194100,7648743333477711,421,5351586,772613,0,772613
6855,Conor Coventry,41,1847300,8279934096315546,241,3000232,2218611,22187,2196424
6856,Cade Cowell,34,2814600,3464280724227461,287,4182901,3256030,32561,3223469
6857,Lewie Coyle,58,4728400,8243764415293481,607,8323805,2057997,20580,2037417
6858,Jonatan Cristaldo,68,4005000,7635226379515769,574,7738844,6235435,623544,5611891
6859,Christian Cruz,45,4760600,6152366841052199,497,7276909,3026478,3026478,0
6860,Lucas Cueto,37,4626000,4167684450783859,474,7607589,4497647,449765,4047882
6861,Liam Cullen,55,2256600,5886268193998232,357,4459623,629564,629564,0
6862,Alan Czerwiński,39,4355400,8508587836098434,428,7020435,5252524,5253,5247271
6863,Chico,48,1203500,7273402174820583,280,2985080,1015822,102,1015720
6864,Xande Silva,62,3176700,7826108472750000,452,5726515,5417619,5417619,0
6865,Marrony,36,2020100,4150404244728311,244,3300871,2095869,210,2095659
6866,Pedro Moreira,31,339400,5597859296509391,96,763372,554466,55447,499019
6867,Christoph Daferner,48,4649600,5374218710447195,479,7787143,1913241,192,1913049
6868,Wessel Dammers,29,4712600,4186381750139300,412,6867362,5627389,56274,5571115
6869,Bradley Danger,37,1879200,6509809411880967,270,3683102,2824522,0,2824522
6870,Fabio Daprelà,45,4224900,7806772196357513,497,7338787,5999455,59995,5939460
6871,Quentin Daubin,29,4383000,6863174565308590,421,6546597,5397257,540,5396717
6872,Éric Davis,59,2741300,5974604023230227,404,5428162,2265357,227,2265130
6873,Cameron Dawson,60,3430200,9880835932879629,501,6391574,4395273,439528,3955745
6874,Justin de Haas,34,2588500,3154852642501065,271,4190000,2473627,0,2473627
6875,Jeffrey de Lange,66,3595400,5390644660849141,524,6730965,2165521,2166,2163355
6876,Guillermo de los Santos,57,4617300,8168746204678882,594,8023161,321114,0,321114
6877,Manuel De Luca,41,1318800,8486949044313758,206,2386433,1281305,128131,1153174
6878,Ronaldo Deaconu,48,3963100,6095466553348783,442,6937829,6779156,677916,6101240
6879,Harlee Dean,58,891800,7736142631169704,285,2551599,1445320,0,1445320
6880,Saulo Decarli,43,1173200,7150322509527709,236,2697140,899293,89930,809363
6881,Liam Delap,54,3771300,5788657594336606,494,6691761,2487112,24872,2462240
6882,Tom Dele-Bashiru,60,3548300,6535303418354040,505,6799877,4170176,417018,3753158
6883,Adil Demirbağ,29,3543800,5195967963570739,370,5455534,3965740,396574,3569166
6884,Clément Depres,31,853300,7358629462135540,116,1423866,809886,809886,0
6885,Kastriot Dermaku,50,3641400,6242031768292468,499,6525823,1763268,176327,1586941
6886,Nicky Devlin,66,1909900,5842026747424971,447,4517749,525017,0,525017
6887,Yan Dhanda,31,3692800,7919957968162701,337,5613620,3721338,3722,3717616
6888,Alessandro Di Pardo,70,3768700,3848962364725607,552,7514852,442201,4423,437778
6889,Francesco Di Tacchio,58,1804300,4938585707550564,339,4006291,706865,706865,0
6890,Bambo Diaby,66,907600,5411019880023958,289,2773415,565008,566,564442
6891,Salim Diakité,65,3368400,5216938772981752,556,6549867,3839330,3840,3835490
6892,Oumar Diakité,22,1832100,6079815382741219,150,2496553,877598,87760,789838
6893,Djibril Diani,61,3137300,7709425171001746,517,6682911,4843731,484374,4359357
6894,Lucas Diarte,39,2897600,3183050000573842,373,5424540,1456220,1456220,0
6895,Vagner,46,2870700,4790129945003741,401,5032490,5019573,0,5019573
6896,Guillaume Dietsch,23,4607900,3875936823029256,356,6313545,3619075,36191,3582884
6897,Greg Docherty,48,1243900,7025324918991460,270,2877701,91911,9192,82719
6898,Alexis Doldán,39,922100,3555076557586893,210,2087084,1592472,159248,1433224
6899,Maciej Domański,25,2153500,6384321871154233,209,3044981,103752,1038,102714
6900,Benjamín Domínguez,62,962200,3883499741217553,272,2693474,2152380,215238,1937142
6901,Janoi Donacien,22,3411800,6396521606704947,287,5031458,3132552,314,3132238
6902,Christos Donis,69,1909500,3486936076844953,383,4255447,365993,366,365627
6903,Nene Dorgeles,68,3350300,9063163878206890,467,5892679,551602,551602,0
6904,Pius Dorn,50,3913400,5480569562158723,477,6705396,6449557,645,6448912
6905,Tomás Händel,35,3390200,4416378767174213,395,6001509,4139440,41395,4098045
6906,Júnior Brumado,29,3306600,7944468271220657,319,5507965,3514495,3514495,0
6907,Andre Dozzell,34,1460800,8735415575152428,170,2352443,2255710,2255710,0
6908,Denis Drăguș,67,2626900,9212214188912135,541,6311063,3206749,0,3206749
6909,Anderson Duarte,35,4028400,6708725840019948,420,6052609,6038975,0,6038975
6910,Chey Dunkley,60,4216300,8832298483786171,557,8238966,2929777,0,2929777
6911,Mathias Dyngeland,35,496800,6889482914279977,137,1247466,1065026,10651,1054375
6912,Patryk Dziczek,25,3335100,5467555850419348,264,4788628,2409339,2410,2406929
6913,Adam Dźwigała,23,2888700,8114180119916917,224,4105937,2552585,0,2552585
6914,Josh Earl,69,3861200,8479376990920897,592,8068982,2149904,0,2149904
6915,Santiago Echeverría,68,641900,6389029627145762,325,2746668,819746,820,818926
6916,Dennis Eckert Ayensa,63,4880800,4069365693984705,707,9536987,4897749,4897749,0
6917,Rarmani Edmonds-Green,34,2551200,3783373600601358,307,4046728,364818,365,364453
6918,Oliver Valaker Edvardsen,22,2442500,8475452108018172,172,3199192,2759349,2760,2756589
6919,Raheem Edwards,64,1679800,8618171772553795,374,3958944,3034116,303412,2730704
6920,Mike Eerdhuijzen,57,1079300,3033110013694754,276,2839923,2283033,0,2283033
6921,CJ Egan-Riley,69,1972500,7070127892864553,470,5034706,4556608,456,4556152
6922,Marvin Egho,36,1837900,4194979131121409,209,2955821,696477,0,696477
6923,Mohamed El Arouch,60,2523300,4394136489368849,400,5069367,2580913,25810,2555103
6924,Idris El Mizouni,52,3329200,7928051107470905,418,5897145,4107342,0,4107342
6925,Redouan El Yaakoubi,59,555800,6696381065697324,250,2074505,97091,0,97091
6926,Callum Elder,68,1239000,3842448825386778,353,3430155,2173327,2174,2171153
6927,Juergen Elitim,57,4728500,9935752616399539,601,7846894,5873885,587389,5286496
6928,Renaud Emond,37,884400,7072501644727896,154,1684433,1560467,15605,1544862
6929,Yannik Engelhardt,54,3889500,6474245890390861,481,6836067,429570,429570,0
6930,Niall Ennis,44,2059500,5050336173695135,279,3529272,1866877,1867,1865010
6931,Devis Epassy,29,3277400,4280497352853101,278,4654187,3621903,363,3621540
6932,Kristian Eriksen,53,2534200,7118873172549293,416,5198815,4394260,0,4394260
6933,Ataru Esaka,24,3260000,3687103364578373,233,4253119,4042813,4042813,0
6934,Mustafa Eskihellaç,26,3002700,3186262885347197,273,4413817,1921124,193,1920931
6935,Runar Espejord,25,3016100,7197476694000693,271,4003991,1041360,104136,937224
6936,Edu Espiau,66,3619300,8777509533681317,605,7405717,7001839,700184,6301655
6937,Roger Espinoza,59,2000600,7404473859702979,380,4151378,2326893,232690,2094203
6938,George Evans,35,637100,3918483657212050,117,1188831,397026,397026,0
6939,Mourtada Fall,39,4538700,7700500984280378,490,7121937,3116427,3117,3113310
6940,Marco Farfan,62,1171400,4576694131114795,376,3456019,2640723,264073,2376650
6941,Yassin Fekir,68,2483000,8897401722562279,446,5307968,4647467,464747,4182720
6942,Robin Fellhauer,61,400400,9987397412286703,235,1751209,189243,18925,170318
6943,Shane Ferguson,40,854600,4128494382621030,151,1691940,1671978,16720,1655258
6944,Hugo Fernández,31,702100,5252080243615160,105,1027247,184259,1843,182416
6945,Paulo Ricardo,46,4529000,3466913362148818,513,7637562,3828354,0,3828354
6946,Lucas Ferreira,42,4103300,7279367773109855,399,6052392,5251854,0,5251854
6947,Andrés Ferro,43,4188300,7706240869903879,460,7089853,3819115,382,3818733
6948,Frank Fielding,49,1863000,3387900108551151,321,3963227,2843529,284353,2559176
6949,Arquímedes Figuera,58,1048000,9116512565849970,295,2888537,480939,481,480458
6950,Karol Fila,57,1765000,3035216147591468,318,3784499,570069,5701,564368
6951,Ivan Filipović,57,3908700,4562644011313658,481,6438465,1268060,0,1268060
6952,Mathias Fixelles,32,2124400,6908443883723125,258,3613725,1793027,180,1792847
6953,Jón Guðni Fjóluson,53,4879000,6475131887516132,506,8114454,944064,944064,0
6954,Ashley Fletcher,35,3170300,4911711383727820,290,4684058,327104,32711,294393
6955,Agustín Fontana,40,829800,7236819666979864,153,1683188,134238,13424,120814
6956,Alessandro Fontanarosa,55,457900,3094837005891601,222,1733637,302234,0,302234
6957,Rodrigo Formento,63,3983000,9119376739863088,563,6976462,4654208,0,4654208
6958,Tyrese Fornah,42,572500,6700468596850097,165,1507741,867244,0,867244
6959,Chris Forrester,50,1599700,4272236182367459,279,3292506,274291,2743,271548
6960,Amankwah Forson,64,990800,3101443727491239,337,3343000,1472821,1472821,0
6961,Iván Franco,63,1889700,8368372363789871,366,4097810,1317166,131717,1185449
6962,Franquesa,24,1926100,5563851493479320,167,2413740,1815893,182,1815711
6963,Gonzalo Freitas,60,916500,3409052695975483,310,2770284,2308954,0,2308954
6964,Martin Frese,62,1216400,7098502405487473,339,3171246,2575974,0,2575974
6965,Per Frick,65,4597000,6215262444775520,554,8495921,248953,248953,0
6966,Mads Frøkjær-Jensen,51,319900,7917845841313097,212,1659072,533123,53313,479810
6967,Aldair Fuentes,24,3458100,6610810076881846,293,4604962,4163437,416344,3747093
6968,Michael Fuentes Vadulli,67,507500,4833161140379028,336,2804658,1915797,192,1915605
6969,Aidi Fulangxisi,34,4628500,8050332141767405,464,7561046,6040705,0,6040705
6970,Matías Galarza,42,3182400,6344540457322229,417,5733081,4627116,0,4627116
6971,Nahuel Gallardo,62,1584300,6021979220338152,325,3785001,1391206,1391206,0
6972,Esli García,30,4265200,4678370295982086,430,6955982,6398885,6399,6392486
6973,Bryan García,57,2110900,5474681963222390,425,5209418,3451635,346,3451289
6974,Pablo García,24,4093500,6777837864153902,368,6111895,279426,2795,276631
6975,Espen Bjørnsen Garnås,69,3445900,6146629311850286,571,7072981,1627748,0,1627748
6976,Luis Garro,27,1535200,6546492239089817,157,2294487,1584761,159,1584602
6977,Ben Garuccio,68,1331000,4764764422698302,343,3643516,2174848,2174848,0
6978,Joe Gauci,35,4093200,5618399032595525,362,6081953,2405173,240518,2164655
6979,Pep Gayà,41,2803100,9341258162899326,323,4634379,4039539,403954,3635585
6980,Garland Gbellé,69,1322700,3364393656365380,372,3746002,899612,900,898712
6981,Yann Gboho,47,1677700,3526634178149393,272,3409314,2897462,2897462,0
6982,Christian Gebauer,52,3929400,7028206581285947,494,7223548,4270247,42703,4227544
6983,Andreas Geipl,49,4779300,7225380474098271,611,8593684,3199931,32000,3167931
6984,Francisco Gerometta,51,2360900,5792074694388336,375,4481142,1590484,1591,1588893
6985,Krystian Getinger,57,3858000,8788733085075011,539,7381257,6643325,6643325,0
6986,Virgil Ghiță,55,721800,9918665010003294,262,2338398,1442685,1443,1441242
6987,Liam Gibbs,57,646700,9249428979404957,239,1972479,886633,8867,877766
6988,Armin Gigović,63,1253000,3745777643799669,356,3664380,948692,94870,853822
6989,Brayan Gil,23,2125600,8970973013619993,185,2912366,1014927,102,1014825
6990,Kosmas Gkezos,49,2925700,5412197258989623,410,5435015,3626921,36270,3590651
6991,Dave Gnaase,31,1921500,5694968097586336,216,2986155,2219061,2220,2216841
6992,Marcos Gómez,24,2858400,8673947652663302,253,4122765,2488660,2488660,0
6993,Paulo Bernardo,26,3593200,4291965544399518,325,5583560,3509163,0,3509163
6994,Wilmar González,28,2974300,9338047090910892,270,4540491,1654063,166,1653897
6995,Ramiro González,36,2704300,3135585783657595,306,4483812,2504701,2505,2502196
6996,Leonel González,66,4193900,3765297539898154,577,7555858,1660551,1660551,0
6997,Óscar González,22,3447700,5395370606853578,315,4917843,2334677,23347,2311330
6998,Cristo González,30,1017300,7533559974739185,121,1486407,549481,550,548931
6999,Charlie Goode,42,1132500,6408039276212087,218,2367085,1798656,179866,1618790
7000,Thijmen Goppel,34,4868100,7971442873874413,402,6811458,991180,992,990188
7001,Mathieu Gorgelin,62,2629300,4127734165005736,463,5637191,3381058,338106,3042952
7002,Stefano Gori,40,1697000,4913266154336840,238,3055602,2070182,207019,1863163
7003,Kenzo Goudmijn,65,3129800,5974705252277624,525,7061740,1691326,16914,1674412
7004,Carlos Grados,69,1984800,9967464068826794,471,4840876,3693192,0,3693192
7005,Jordan Graham,63,346000,8324367021240824,290,2271803,814841,0,814841
7006,José Luis Granados,32,2004000,7688453872069193,238,3366532,961299,0,961299
7007,Jorge Grant,41,1479300,7518382164971076,234,2756520,908611,908611,0
7008,Simon Graves,62,2308400,3347120257757847,400,4552785,1150589,0,1150589
7009,Lee Gregory,31,928300,3063244099841695,148,1643145,632453,0,632453
7010,Patrick Greil,24,3676500,3825363082172261,338,5198059,1513638,152,1513486
7011,Leo Greiml,60,497900,7725180523077806,246,2123831,1168438,117,1168321
7012,Mathias Greve,35,348300,4856243630440393,96,720516,166453,166453,0
7013,Lukas Grgic,53,4533700,5911664619396628,566,7823396,2918592,0,2918592
7014,Magnus Retsius Grødem,34,3848400,4345159630442224,368,5980984,3355379,0,3355379
7015,Sten Michael Grytebust,35,1341000,5104054335134163,196,2338871,1179469,117947,1061522
7016,Pape Habib Gueye,64,4781400,3323087477754445,619,9350113,5191215,51913,5139302
7017,Makhtar Gueye,54,4653900,3535178207228496,521,7901775,1451143,14512,1436631
7018,Germán Guiffrey,48,4801600,9859654624042034,536,7807810,4323887,432389,3891498
7019,Daouda Guindo,39,2106600,7834751549802896,227,3091225,477556,4776,472780
7020,Leon Guwara,37,2622400,5103286702729091,307,4147378,3394783,33948,3360835
7021,Anders Hagelskjær,66,4351200,5113268376204347,601,8417404,8076315,0,8076315
7022,Elias K. Hagen,40,449100,9144013694311475,121,933229,379111,379111,0
7023,Tibor Halilović,26,4732800,5342597643487536,427,6555048,2187139,0,2187139
7024,Grant Hall,35,1939600,7612160922009030,253,3226880,2564173,257,2563916
7025,Pierre-Yves Hamel,46,2441600,9211567676635065,374,4290803,465335,46534,418801
7026,Vito Hammershøy-Mistrati,54,3535000,3375786923309443,463,5933112,4111767,0,4111767
7027,Saïd Hamulić,25,911100,8501786552561969,78,1055712,141874,141874,0
7028,Matěj Hanousek,69,4184000,5147499248517594,674,8134823,768030,0,768030
7029,Wes Harding,55,1705900,7437432442290189,363,3927741,2732566,0,2732566
7030,Peter Haring,28,1994100,6075394636440459,203,3079427,2329613,23297,2306316
7031,Kento Hashimoto,70,420200,4560761909876796,322,2373640,1636744,16368,1620376
7032,Niklas Hauptmann,43,2840800,3220649422529403,350,4809176,4233638,424,4233214
7033,Jonny Hayes,46,4563800,8138964892818814,522,7537367,879563,879563,0
7034,Laurent Henkinet,28,1905000,3434755591705626,196,2753902,708987,708987,0
7035,Bryan Henning,66,1718200,4763349663246836,386,4167073,3702460,0,3702460
7036,Nelson Hernández,40,1083000,6905437008926724,200,2194702,404055,405,403650
7037,Diego Armando Hernández,60,3166400,5175962970348659,517,6479149,4286229,429,4285800
7038,Hector Hevel,32,397700,5778301513433689,85,639364,377823,377823,0
7039,George Hirst,65,2604400,6513637052205537,486,5907524,2155100,2155100,0
7040,Ki-Jana Hoever,43,4092500,4691716118144654,490,7101391,5242186,0,5242186
7041,Jonathan Hogg,63,632300,6361137376722079,294,2536764,1160091,116010,1044081
7042,James Holland,25,1081000,7682600494417464,117,1502175,1236129,124,1236005
7043,Tom Holmes,62,2786500,6027589954708790,446,5542970,2933373,293338,2640035
7044,Jordan Holsgrove,50,4324500,9920997697428217,475,6760540,2183360,2184,2181176
7045,Santiago Homenchenko,23,4664100,3912418964410526,352,5941460,5168836,51689,5117147
7046,Hong Jeong Un,48,3857000,5981182898934571,459,7160531,4776085,477609,4298476
7047,Matthew Hoppe,44,1867200,8186668517615925,310,3848728,3211942,3212,3208730
7048,Sam Hoskins,70,2510100,9360231241671741,520,5509906,1343638,1343638,0
7049,Andi Hoti,39,2497400,4612393893174334,300,4439211,3271206,328,3270878
7050,Guillaume Hubert,34,1063400,3069150285319598,171,2000678,1213222,121323,1091899
7051,Joseph Hungbo,36,2316500,8759633284911132,234,3351165,2586498,0,2586498
7052,James Husband,70,4230900,8032641058927002,604,7716568,456449,45645,410804
7053,Sam Hutchinson,25,3187700,8852659158140233,251,4531118,2038195,2039,2036156
7054,Alex Ibacache,34,4525500,7938064458482019,494,7272732,6401121,64012,6337109
7055,Pablo Ibáñez,46,2750200,8554217663424179,348,4790984,3760103,0,3760103
7056,Adam Idah,63,1236500,7160117230801885,354,3447298,1446755,1447,1445308
7057,Blendi Idrizi,66,2321400,5680140490040698,494,5803605,1468725,14688,1454037
7058,Jay Idzes,47,4277000,8978484913729813,478,6812390,6267499,626750,5640749
7059,Gino Infantino,28,4672900,4834714926433710,403,6919445,2713143,271315,2441828
7060,Roberto Inglese,55,985400,6799424416610428,254,2635704,1404230,0,1404230
7061,Rodrigo Insua,34,370500,8608109640740377,93,726575,320929,321,320608
7062,Alexandru Ioniță,24,4601500,5264842382137075,385,6259209,5208401,521,5207880
7063,Dominic Iorfa,60,3589100,3452617351798418,550,6539108,2597121,2597121,0
7064,Tim Iroegbunam,48,3202300,6520041114466827,432,5380112,3333043,3334,3329709
7065,Galego,54,2095300,7475820690579007,375,4463638,2235421,0,2235421
7066,Marko Ivezić,50,1697400,4137412350529248,291,3311865,449768,44977,404791
7067,Paul Izzo,40,4202700,9603324299055085,453,6371286,3441582,0,3441582
7068,Diego Moreira,68,2690700,6798164995337813,509,5999896,3250934,326,3250608
7069,Nordin Jackers,40,2378600,4434939870315886,324,4017858,1236644,0,1236644
7070,Thore Jacobsen,47,2299700,5760004057839669,327,4216785,3968279,0,3968279
7071,Miguel Jacquet,67,782000,3208235207148707,351,3052730,1590070,159007,1431063
7072,Laurent Jans,67,4523300,7274350965775744,652,8508639,4813675,0,4813675
7073,Wolke Janssens,54,3668200,7145451095848864,478,6406640,3232079,0,3232079
7074,Nicolas Janvier,34,1854900,5709785312902914,229,2938571,545026,0,545026
7075,Renny Jaramillo,44,2597600,5532252987977536,351,4715521,3164214,3165,3161049
7076,Fredrik Oldrup Jensen,53,1511200,3685392389081185,285,3308716,161543,0,161543
7077,Jeong Seung Won,40,4213200,7332449226111648,395,6384177,2431037,243104,2187933
7078,Ji Xiang,62,1566700,8813202738704305,399,4080576,410956,4110,406846
7079,Jo Jin Woo,40,1371200,6481908497625382,236,2699167,620215,621,619594
7080,Ísak Bergmann Jóhannesson,34,3584600,6390053675763112,400,6177022,2984893,0,2984893
7081,Carl Johansson,56,4480400,5046593381998253,541,7668624,3561436,357,3561079
7082,George Johnston,48,2512700,4439267787520525,336,4336030,3470811,0,3470811
7083,Paul Joly,52,1492800,6811703727383314,298,3483365,1743127,175,1742952
7084,Thomas Jones,69,1963200,3784073519186858,483,5099737,2694083,270,2693813
7085,Cristóbal Jorquera,51,1610200,6983591862474650,284,3467272,2492688,24927,2467761
7086,Daniel Eduardo Juárez,63,1916100,3419840392495913,385,4202636,613263,0,613263
7087,Gideon Jung,34,594200,4140657061328568,93,929917,265056,2651,262405
7088,Markus Kaasa,59,3468200,9770065659967642,492,6547840,5617776,0,5617776
7089,Vladyslav Kabaev,31,4349500,4357886490870233,470,7436675,6991399,0,6991399
7090,Eric Kahl,45,1579700,5508998870164203,238,2878912,1716553,172,1716381
7091,Tobias Kainz,46,3615900,4102490727076501,437,6063520,2155729,216,2155513
7092,Mattias Käit,28,3143200,3994297309356070,297,4938327,1138424,1138424,0
7093,Osman Kakay,24,3235300,3675306764556978,303,4785343,4368752,436876,3931876
7094,Ola Kamara,30,4860300,3952294126061620,395,6622097,1703802,170381,1533421
7095,Alhaji Kamara,64,3036600,9618805665178353,495,6594477,2338365,23384,2314981
7096,Dijon Kameri,42,4889200,7178454361020888,486,6984569,2702301,27024,2675277
7097,Marco Kana,66,4455400,3466383339782714,639,9022858,8132429,8133,8124296
7098,Ahmetcan Kaplan,56,4057000,6323754303014138,547,7709101,1077390,0,1077390
7099,Goran Karačić,33,2196700,5662629220010342,248,3626101,2004114,201,2003913
7100,Ali Karimi,65,2266300,6695886721152721,472,5312324,549438,550,548888
7101,Karrikaburu,33,4650300,3038767238159919,493,7719878,7626399,0,7626399
7102,Fabio Kaufmann,33,2245700,8953797817835134,270,3947933,3054297,306,3053991
7103,Liam Kelly,69,939300,6919726091451347,317,3019807,1594752,160,1594592
7104,Naoufel Khacef,48,606000,5074907803527022,195,1599597,971949,9720,962229
7105,Facundo Kidd,65,4864600,3946527360988762,694,9146243,3249395,0,3249395
7106,David Kiki,44,1823900,8290872574119116,261,3217065,651170,651170,0
7107,Kim Seung Dae,69,975100,8127280345815154,339,3009492,1853302,0,1853302
7108,Kim Bo Sub,32,4976100,8117161087419371,504,8048518,4562524,4562524,0
7109,Kim Joo Won,58,1864800,3079623819350215,398,4442344,4347459,0,4347459
7110,Andy King,69,2874400,9779191479260734,472,5830598,4640686,4640686,0
7111,Liam Kitching,62,1258000,6033191899962923,342,3396351,425185,0,425185
7112,Anders Klynge,59,1346400,7119069972909096,300,3220701,674488,675,673813
7113,Anthony Knockaert,61,4888900,7952892212176390,661,9440176,4482961,4482961,0
7114,Vladyslav Kochergin,51,4440200,5284419351804422,523,7230083,3218390,32184,3186206
7115,Giorgi Kochorashvili,28,4401800,4013311947380163,404,6484769,1613377,161338,1452039
7116,Sven Köhler,35,344600,5513061764640870,118,932459,470132,4702,465430
7117,Aboubakary Koita,63,2964900,3720498750697655,515,6290873,906587,0,906587
7118,Karim Konaté,50,3881700,3959093228566306,447,6321365,2689633,2690,2686943
7119,Youssouf Koné,46,3883000,6134871169090033,449,6842256,2488084,0,2488084
7120,Ismaël Koné,43,2044700,8816845687625613,314,3743351,1371951,137196,1234755
7121,Bartosz Kopacz,43,777000,8004870374385258,171,1727840,947833,9479,938354
7122,Eboue Kouassi,62,4667100,6343517605180385,703,8531520,3841394,3841394,0
7123,Christos Kourfalidis,40,1134900,6931705452285043,170,2028021,1745696,0,1745696
7124,Niklas Kreuzer,70,3031600,4295366660579359,449,5462737,3316829,332,3316497
7125,Ruben Kristiansen,22,1762300,9328176516047689,114,2128341,363373,363373,0
7126,Nicolas Kristof,32,2160100,4913389052442231,202,3291385,2827352,0,2827352
7127,Mirlind Kryeziu,45,2474200,6200413963132873,341,4658556,2234517,223452,2011065
7128,Yuya Kubo,35,4995200,7960162278878848,497,7602012,2457516,24576,2432940
7129,Christian Kühlwetter,56,2675900,8034703144356246,443,5364269,1104022,0,1104022
7130,Stjepan Kukuruzović,51,4408400,6882615089835679,508,7326955,6973913,69740,6904173
7131,Filip Kurto,36,4322300,9499092565617886,426,6472874,5372846,5373,5367473
7132,Hasan Kuruçay,57,3793400,5643964000052445,573,7344474,1082783,10828,1071955
7133,Manuel Kuttin,32,1648600,5152927563512233,166,2493944,1647009,165,1646844
7134,Nika Kvekveskiri,35,1012700,7547682806903193,155,1768963,869392,8694,860698
7135,Antonino La Gumina,64,2025400,5433334574632740,397,4729737,1324102,133,1323969
7136,Andrea La Mantia,50,3220000,9466199746798666,449,6301600,3536018,35361,3500657
7137,Matías Laba,56,2627100,6101733079265380,433,5041434,4589548,4589548,0
7138,Darryl Lachman,22,1646800,4562164993755988,110,1838022,716057,7161,708896
7139,Léo Lacroix,31,4903500,4992047628735138,406,6772129,1320190,1321,1318869
7140,Tomás Esteves,58,2955500,5058331118506528,453,6022053,1635358,0,1635358
7141,Mayckel Lahdo,41,905500,3343793047012625,187,1877502,1044882,10449,1034433
7142,Ali Lajami,42,3789700,4883396464264190,408,5637755,2892669,289267,2603402
7143,Łukasz Łakomy,23,370200,8032732574322784,61,456322,363058,36306,326752
7144,Thomas Lam,55,812500,8966086737048382,267,2649336,2412099,2412099,0
7145,Anthony Landázuri,57,2207900,6549975458442713,362,4092846,3928261,3928261,0
7146,Hugo Larsson,52,3424200,8422915699978301,454,6506817,5963193,5963193,0
7147,Lasure,24,2640400,9607791796246724,196,3457478,51713,0,51713
7148,Lion Lauberbach,40,4536600,3839415659739952,454,7327884,4090330,409033,3681297
7149,Frederik Lauenborg,40,3680300,7756556945231521,413,5783402,1066375,106638,959737
7150,Shayne Lavery,31,4138200,8725015700440450,358,6380949,3531331,3531331,0
7151,Jordan Lawrence-Gabriel,33,4821000,7496314260020004,454,6978063,4598055,459806,4138249
7152,Richard Ledezma,64,4179500,5066570924707229,526,6837631,1275369,128,1275241
7153,Lee Soon Min,70,4317400,7160206730518432,656,8423644,5207821,520783,4687038
7154,Lee Gwang Hyeok,25,1315600,3743448370404477,104,1518861,1232843,124,1232719
7155,Lee Tae Suk,48,1159100,7349155118863065,227,2508310,2068980,0,2068980
7156,Tom Lees,49,2185200,4342730451175230,307,3862360,1003727,100373,903354
7157,Nicolás Leguizamón,58,2967900,7602013281209127,460,5362017,3537196,0,3537196
7158,Aníbal Leguizamón,65,3489000,5437887790233548,579,7142219,2003209,0,2003209
7159,Mario Leitgeb,69,3930900,8980244628623518,614,7938473,2262722,22628,2240094
7160,Nicolas Lemaître,57,4512200,4601453040566404,625,8413036,1856803,18569,1838234
7161,Sebastián Lentinelly,50,787900,4342352795760568,193,1742631,882950,8830,874120
7162,Donovan Léon,45,697700,9883145579629665,210,2007985,695597,0,695597
7163,Karlo Letica,51,2652400,9869886440972535,334,4532723,2798980,0,2798980
7164,Li Shuai,40,2984600,6277948019357209,356,4948825,4359368,4359368,0
7165,Nick Lima,51,723400,8602046568208484,213,2037223,1632792,164,1632628
7166,Gift Links,63,2242000,3372963291648638,451,5201886,3386453,0,3386453
7167,Warleson,47,4818200,9263869418040506,567,7990637,4194041,4194041,0
7168,Jesper Löfgren,26,2378900,7967826462947060,197,3075849,346713,3468,343245
7169,Felix Lohkemper,58,3524400,5029526733889058,450,6556679,5638472,0,5638472
7170,Jason Lokilo,26,1437500,6495017452137357,151,2169615,2015477,2015477,0
7171,Danijel Lončar,31,3452400,3058501645401568,303,4934542,2000657,20007,1980650
7172,Noah Loosli,44,3276800,4955133223727423,370,5545422,5403521,541,5402980
7173,Marc Lorenz,53,3554200,4956989902843744,435,5852319,4938295,4939,4933356
7174,Anderson Lucoqui,41,543000,4284680818791626,151,1343900,1223579,12236,1211343
7175,Karlo Lulić,69,4202100,6119527726916632,612,8319702,402647,4027,398620
7176,Valdemar Lund,49,2430500,7271171455047762,341,4251536,2758959,2758959,0
7177,Ramon Pascal Lundqvist,23,4647500,9762948547738757,384,6015080,996905,9970,986935
7178,Ma Zhen,43,4447200,8582124923507110,459,7198123,7181611,0,7181611
7179,Larrys Mabiala,63,4505800,5363848611863730,633,8166934,4597046,4598,4592448
7180,Angus MacDonald,51,1630800,3010867381106596,287,3448112,2485743,248575,2237168
7181,Zinédine Machach,64,1720900,9820733826872365,390,4225280,1953425,19535,1933890
7182,Leandro Maciel,60,2219300,4053638087543805,411,5129739,3905324,390533,3514791
7183,Zac MacMath,23,3421500,3801410885855501,229,4565914,2867397,0,2867397
7184,Abdullah Madu,45,337500,4299704086135286,176,1355941,863506,8636,854870
7185,Cassius Mailula,27,1305900,4551567242885944,126,1657712,475332,476,474856
7186,Filip Majchrowicz,62,2522100,8364420103285373,384,5041321,859896,85990,773906
7187,Jordy Makengo,55,1130200,9368157559028663,275,2903108,2901476,29015,2872461
7188,Charalambos Makridis,58,4082700,4755577990709216,616,7739502,5795200,0,5795200
7189,Nikola Maksimović,47,4766500,9939065777263311,578,8583068,492246,49225,443021
7190,Julián Malatini,37,1227800,5829292714022731,177,2217735,1077918,1078,1076840
7191,Felix Mambimbi,33,3246900,9900159011000377,322,4914988,516980,0,516980
7192,Harrinson Mancilla,27,2285700,5830349677149866,210,3269112,2407430,240743,2166687
7193,Alasana Manneh,23,965900,9556912211754511,68,1045935,379274,37928,341346
7194,Filip Marchwiński,59,1567300,4389573678792152,288,3369610,1196043,1196043,0
7195,Ivan Marconi,52,3191900,4087269633039842,414,5990596,5697417,0,5697417
7196,Antonio Marin,65,3813400,8303932679399717,562,7317111,2616175,262,2615913
7197,Marius Marin,57,4996200,6833611517950199,544,8161705,1682868,169,1682699
7198,Jovan Marković,38,2536800,6674108419557539,307,4354291,3584152,3585,3580567
7199,Gonzalo Maroni,61,1181100,7101076483255834,303,3175551,491225,0,491225
7200,Marko Maroši,52,1723900,4994128110179879,336,4140428,2719289,2719289,0
7201,Alejandro Marqués,67,3879500,8247213288210556,635,8023664,6086200,609,6085591
7202,Artur Jorge,58,3971000,9601569985730692,547,7469235,7075895,7075895,0
7203,José Marrufo,36,4429800,6472939468438833,433,6528742,617044,617044,0
7204,Teto,66,343000,7935590361377162,284,2102706,2050071,0,2050071
7205,Jefersson Martínez,60,2927000,7267046031975072,407,5429838,4462265,4463,4457802
7206,Ramón Martínez,53,3356200,5738239143172810,475,6526482,2677291,0,2677291
7207,Homer Martínez,41,1586700,9588227895810197,261,3246356,1758305,176,1758129
7208,José Marsà,39,3998400,8711176106922121,441,7073109,3988388,399,3987989
7209,Dominik Martinović,33,3108100,8839977557008072,348,4970960,1966282,197,1966085
7210,Matheus Martins,39,3331600,8528601552985642,363,5382358,3914017,392,3913625
7211,Benny Sousa,39,658100,7112707650627325,179,1726864,1452742,1452742,0
7212,Jan Hendrik Marx,38,340100,3063508871981836,121,889238,754382,0,754382
7213,Ephron Mason-Clark,27,1664800,5824874085131908,143,2273276,750611,7507,743104
7214,Julien Masson,44,3847400,8962577567392003,480,6554352,4640541,4641,4635900
7215,Mateusz Matras,32,3813300,7272741538042413,347,5457833,2270861,0,2270861
7216,Yusuke Matsuo,35,3437300,5988089708825935,374,5663986,4272732,42728,4230004
7217,Magnus Mattsson,51,981400,7649607209104888,228,2317499,2125556,2125556,0
7218,Chris Maxwell,33,2102500,6459320328718045,223,3303194,2712917,0,2712917
7219,Danny Mayor,38,3586600,6651812170138562,389,5952135,2195350,0,2195350
7220,Loïc Mbe Soh,59,1605100,9881672121631129,332,3702761,2394243,23943,2370300
7221,Nolan Mbemba,41,393100,4517159164982155,120,992746,395581,396,395185
7222,Moustapha Mbow,46,1312200,9997465732866359,269,2762950,828973,0,828973
7223,Ryan McGowan,56,3088400,8391448368834113,474,5916016,1371907,1371907,0
7224,Zac McGraw,30,446700,8881520706330013,97,756262,127050,12705,114345
7225,Tom McIntyre,53,1014800,9368417367403216,229,2326355,1641055,1641055,0
7226,Agus Medina,43,3115800,6866311906114655,370,4938208,1417505,141751,1275754
7227,Anis Mehmeti,53,1351400,5669348382171054,332,3692577,3570502,358,3570144
7228,Matteo Meisl,69,1423200,5623170962615472,399,3997029,3497044,3497044,0
7229,Filippo Melegoni,27,545000,7037820150507139,55,596030,208720,208720,0
7230,Carlos Mendes Gomes,32,2672400,3369232461904622,256,4020129,3898357,389836,3508521
7231,Joelson Fernandes,22,3487400,8199203937065644,337,5195754,4617733,46178,4571555
7232,Mauro Méndez,22,1822900,7958978158596967,140,2273445,327989,0,327989
7233,Hamza Mendyl,31,4744300,7870767796218639,441,7658508,3513533,3513533,0
7234,Teden Mengi,35,2130500,7670800937453968,289,3789409,1796917,17970,1778947
7235,Phillip Menzel,44,1568700,5704441204707545,220,2581109,371253,37126,334127
7236,Francisco Mera,56,703800,7410149391752334,251,2284495,182700,18270,164430
7237,Umut Meraş,24,314500,4053118695501719,41,271471,6848,0,6848
7238,Levent Mercan,37,3417600,5579100261620311,383,5778506,300552,301,300251
7239,Connor Metcalfe,33,3123400,7385913357859049,266,4203384,3817598,38176,3779422
7240,Senna Miangue,45,2279100,3910058665518420,305,3995750,444855,44486,400369
7241,Alex Millán,29,1062900,6982602927789419,116,1517905,290832,291,290541
7242,Arturo Mina,57,4183800,7107291591587731,612,8569455,1060357,0,1060357
7243,Ming Tian,29,4122100,8980362066774660,348,5741418,1146143,114615,1031528
7244,Demetri Mitchell,46,2023700,6148454034965015,338,4039716,2882400,2882400,0
7245,Marco Modolo,23,1304000,3191170416770122,88,1472967,490593,490593,0
7246,Rafinha,24,3212100,3076454554132512,304,4404316,3770433,0,3770433
7247,Andrés Montero,28,4963400,7839585879736808,458,7121175,2372764,2372764,0
7248,Manuel Monzeglio,67,1149700,8385215928026640,312,3203066,698706,6988,691718
7249,Simon Moore,57,3968700,4388467568903286,546,7039993,971897,9719,962178
7250,Elliott Moore,45,4704700,8787688163981299,520,7774228,1731223,1731223,0
7251,Erik Morán,42,4826500,3366796877646543,481,7925972,6376476,0,6376476
7252,Giotto Morandi,68,3664900,6254029773751010,555,7473400,4720208,473,4719735
7253,Diego Moreno,55,4900700,6769580932828772,563,8138739,5110602,5111,5105491
7254,Diego Moreno,70,483600,8469116510486193,317,2801282,2675538,26756,2648782
7255,Stefano Moreyra,22,3321100,9339514324835650,218,4412816,2208791,221,2208570
7256,Luca Moro,64,1516000,9274642846591654,355,3783427,2973815,0,2973815
7257,Joe Morrell,68,2618600,8595089549934938,518,6082718,5024778,0,5024778
7258,Sean Morrison,28,1657500,7916990221596194,142,2143832,1496186,1497,1494689
7259,Edwin Mosquera,30,324400,7667982554534643,57,365460,174406,174406,0
7260,Faris Pemi Moumbagna,41,3830700,7748404947754718,408,6537252,3228319,323,3227996
7261,Owen Moxon,51,836300,6262088778820779,224,2135455,2077974,207798,1870176
7262,Matías Moya,68,4745700,7300341702657667,670,9321091,3590001,35901,3554100
7263,Bartosz Mrozek,66,4825200,3984125150659246,575,8443945,757714,7578,750136
7264,Rui Modesto,29,681800,5706705656238895,102,1118053,825209,8253,816956
7265,Alexander Mühling,31,1632700,7727521615070373,198,2417300,274917,2750,272167
7266,Robert Mühren,68,4045400,6693683177708343,551,7393129,1366261,13663,1352598
7267,Tobias Müller,47,753800,8536575137573288,197,1736837,1680009,1681,1678328
7268,Vincent Müller,26,3959000,5904039050874437,340,6131019,5180655,51807,5128848
7269,Jake Mulraney,33,4603100,4111572933014582,393,6760235,3604571,0,3604571
7270,Maurice Multhaup,25,2063100,4308780265701848,172,2849655,464460,464460,0
7271,Jorge Félix,63,3414100,7964046269603581,562,7056588,110960,11096,99864
7272,Miki Muñoz,33,2426300,6369663682457045,269,3873414,3036745,0,3036745
7273,Juan Muñoz,42,4157600,4329680866034727,417,7162934,1943131,0,1943131
7274,Robert Murić,68,1426100,4382004584916496,379,4035080,3459861,3459861,0
7275,Yonatan Murillo,30,1700600,7111869497239844,177,2469954,1090625,1091,1089534
7276,Jorge Murrugarra,42,4700400,4082673635717865,463,7456499,1930119,19302,1910817
7277,Ahmed Musa,22,2797200,5957344289126994,191,3576831,379017,0,379017
7278,Visar Musliu,45,4787600,9216410285045063,558,8918205,3668807,36689,3632118
7279,Ibrahim Mustapha,63,4328400,4026450960110959,628,8585196,897782,0,897782
7280,Tomeu Nadal,65,4618300,8707058230865158,605,8532579,3274063,0,3274063
7281,Gerrit Nauber,38,4601800,6876997800694250,476,7202367,1193616,1194,1192422
7282,Abdoulaye Ndiaye,69,2263800,3717615446765480,446,5155553,2879792,2880,2876912
7283,Mor Ndiaye,30,441700,7503873969346657,89,774540,308566,309,308257
7284,Dragoș Nedelcu,67,894500,3455497212140753,327,3159854,2618593,2619,2615974
7285,Cristian Neguț,48,1911800,3624982379038372,344,4190729,4051948,405195,3646753
7286,Curtis Nelson,55,4718900,4654437003623329,597,7877667,6288950,62890,6226060
7287,Francisco Ramos,56,4110200,7378971368320093,479,7233281,3643199,3643199,0
7288,Simon Ngapandouetnbu,27,3911600,7581258579239828,390,6124352,1914095,1914095,0
7289,Pierre-Yves Ngawa,62,3936600,5521571472203414,577,7388790,6591175,6592,6584583
7290,Siyabonga Ngezana,32,3799200,6784206057890534,367,5657968,3408761,34088,3374673
7291,Julien Ngoy,63,1636900,3568783247429376,394,4527151,2415805,24159,2391646
7292,Noel Niemann,47,4343400,6134971931939914,474,6865271,593071,5931,587140
7293,Juan Nieto,70,4703900,8984556277225624,590,8515044,6301380,631,6300749
7294,Jarosław Niezgoda,45,3180000,6508685366983326,374,5794982,2232242,0,2232242
7295,Branislav Niňaj,41,4407000,5787038202659318,473,7503826,4583066,0,4583066
7296,Dan Nistor,50,1064300,3870817306496172,259,2789583,898296,8983,889313
7297,Justin Njinmah,64,1110500,5161510411055701,309,3304399,210320,21032,189288
7298,Ygor Nogueira,41,2706600,4696294796682616,324,4241235,89426,89426,0
7299,Jefferson,52,495800,7075385711773829,194,1730576,585456,586,584870
7300,Sam Nombe,53,4878000,9514632230102621,600,8212308,2668413,2669,2665744
7301,Simen Bolkan Nordli,43,3251000,9457085529703066,421,6341810,2995289,2995289,0
7302,Marius Noubissi,39,4690500,6318269299748143,497,8186619,369023,0,369023
7303,Joel Nouble,52,4586200,7935632213394221,542,7244092,4227433,422744,3804689
7304,Emmanuel Ntim,65,4860500,9059034506667560,606,8541997,7165848,716585,6449263
7305,Cristian Núñez,37,2981400,7672200156148651,295,4283595,4119491,4120,4115371
7306,Ché Nunnely,45,4438600,5211844322158774,485,7799467,7233408,0,7233408
7307,Paudie O'Connor,45,4285300,3993458794763812,443,6259140,3508667,350867,3157800
7308,Cas Odenthal,50,3935900,8493771465620445,482,6434180,4945073,49451,4895622
7309,Sandi Ogrinec,46,4623100,5745292798643453,483,7799622,7571361,757137,6814224
7310,Noah Ohio,40,3282700,5852698415011457,417,5915511,3318410,3318410,0
7311,Shinji Okazaki,48,3062100,9513436590047849,446,5712481,5347546,53476,5294070
7312,Jonathan Okita,49,2813300,8264389414470842,408,4984903,1919568,19196,1900372
7313,Olasagasti,31,3013000,5298587492675032,283,4204434,2444225,0,2444225
7314,Roberto Alves,62,779000,4435128135306119,282,2737840,585157,585157,0
7315,Yuri Ribeiro,44,4879000,9612022918023631,531,7897167,1805996,1806,1804190
7316,Alexandre Olliero,66,969300,8041570869840701,407,3617912,1657169,0,1657169
7317,Martin Olsson,48,970000,7064128211148397,213,2182099,1732248,174,1732074
7318,Raul Opruț,58,3557600,6217837471226385,485,6691435,2190485,220,2190265
7319,Christian Ordoñez,36,2807700,8802931223882696,285,4093894,448044,448044,0
7320,Gaetano Oristanio,27,2733300,7026941637398321,271,3973547,3678569,0,3678569
7321,Franco Orozco,45,2890600,4779002227927266,373,5159988,5141412,5141412,0
7322,Marcelo Ortíz,58,4605400,4695711070467124,567,8047312,6268260,0,6268260
7323,Juanto Ortuño,27,3070600,3298502704033225,279,4431761,978707,0,978707
7324,Jordi Osei-Tutu,59,1948800,3075265311676919,384,4151279,3741108,3742,3737366
7325,Takuto Oshima,56,3885800,4247947076146686,534,6892106,3571528,358,3571170
7326,Caner Osmanpaşa,51,942400,6080945510621330,261,2722910,1143162,114317,1028845
7327,Ferdinand Oswald,31,4915400,3711034654760758,450,7224053,5208651,520866,4687785
7328,Philip Otele,36,1375100,5839906167837920,229,2869565,140783,1408,139375
7329,David Otto,58,1624200,8035155513159868,350,3941260,2494066,250,2493816
7330,Amine Oudrhiri,31,699200,3848319846229668,109,1145298,1062570,0,1062570
7331,Samuel Oum Gouet,68,450700,6476610139155843,353,3047001,2978635,298,2978337
7332,Elisha Owusu,57,3338500,6278568362599315,504,6071569,3929834,3930,3925904
7333,Godfried Ayesu Owusu Frimpong,64,1357100,4181066683171126,386,4033966,3867567,387,3867180
7334,Braian Oyola,48,1322100,7641771617799788,238,2586633,1564119,1565,1562554
7335,Şener Özbayraklı,66,1420100,7440132346460699,394,3893953,2706823,0,2706823
7336,Tobias Pachonik,67,2559900,7962817672327118,478,5484685,546594,54660,491934
7337,Torge Paetow,26,1124100,5818082462631801,96,1467685,1213363,1213363,0
7338,Simone Pafundi,29,4795200,6341185936663481,431,7342076,6079707,607971,5471736
7339,Matías Palacios,63,4458700,7106642839190333,599,8465465,3169049,0,3169049
7340,Jhon Alexander Palacios,30,2301500,5509230229961683,197,3105099,1325472,133,1325339
7341,Antonios Papadopoulos,70,4111200,7329264469121573,638,7717623,4467741,446775,4020966
7342,Giannis Papanikolaou,27,2126600,4166778968411048,178,2912041,448143,448143,0
7343,Gaëtan Paquiez,49,1839600,5724243902467018,305,3458179,1480781,14808,1465973
7344,Park Yong Woo,47,613700,9958844436747179,221,1911677,1725635,17257,1708378
7345,Troy Parrott,69,1437500,3849722135366980,431,4124386,4004223,0,4004223
7346,Lóránd Pászka,70,1386700,7887538431149681,361,3829617,3409147,0,3409147
7347,Pierre Patron,63,2773200,6926944941026206,406,5367448,1704169,0,1704169
7348,Bjørn Paulsen,55,4304300,7406799398390578,540,7471271,116337,1164,115173
7349,Bartłomiej Pawłowski,53,2720900,5186228716003204,442,5474827,2084911,2084911,0
7350,Nicolás Paz,58,1035100,5697843909734007,306,3041912,2014992,20150,1994842
7351,Aynsley Pears,58,4978200,6485199906394224,678,9268756,2411127,24112,2387015
7352,Aleksa Pejić,67,4612200,7825917386697049,607,8710009,8040517,8040517,0
7353,Bryan Pelé,38,2864800,8496201958100877,353,4783140,572911,0,572911
7354,Matthew Pennington,68,1965000,4332368895504104,372,4057588,896127,0,896127
7355,Adrian Nilsen Pereira,39,2914300,4979396930618367,327,4539065,1337424,1337424,0
7356,Elías Pereyra,60,887300,7293445733123955,321,2981593,2893455,2894,2890561
7357,Manuel Perez,39,1295800,7532848331744780,194,2114187,385543,38555,346988
7358,Simone Perilli,41,2068500,8830158892706048,312,3839844,75305,0,75305
7359,Mauro Perković,35,822500,6986972453651471,159,1632377,659975,659975,0
7360,Denis Petrić,64,2584200,7541997744673663,447,5055762,2854218,0,2854218
7361,Dillon Phillips,38,3607900,8223976768513417,407,6118973,2792522,280,2792242
7362,Adam Phillips,46,4093300,3783404474334799,458,7328626,12113,1212,10901
7363,Fabian Piasecki,22,3524200,9044331436528014,301,4704326,2471350,0,2471350
7364,Juan de Dios Pintado,37,4745900,4455462347897578,451,7768170,4985644,4986,4980658
7365,Bruno Paz,60,4469100,6970215676501837,577,7870782,2613718,261372,2352346
7366,Johny Placide,66,3780000,4581950047074063,591,7436729,6722772,67228,6655544
7367,Mattie Pollock,34,2310600,5575872092433766,248,3686526,3634864,36349,3598515
7368,Pomares,33,2447900,7626423833073778,296,3822754,545606,546,545060
7369,Mihai Popescu,40,3563100,3006535606697468,391,5281918,4648442,46485,4601957
7370,Boris Popovic,39,1480000,5198357768370717,216,2614174,96333,9634,86699
7371,Segundo Portocarrero,28,1203200,8428606788082376,119,1612884,548953,549,548404
7372,Virgiliu Postolachi,29,1412400,7036071199717332,144,1977692,497843,498,497345
7373,Marvin Potzmann,52,2480200,5197122660780693,389,5027355,2194011,0,2194011
7374,Beñat Prados,61,859900,5819538997729832,295,2784430,1904460,1905,1902555
7375,Ijiel Protti,28,2951800,9942542907842314,290,4609240,1413187,142,1413045
7376,Ruben Providence,56,2321100,4050245354070590,380,4758739,896313,896313,0
7377,Stephen Quemper,53,4434100,4709873403479341,573,8065213,657517,658,656859
7378,Leopold Querfeld,27,2400300,3371342371391261,236,3521823,139963,13997,125966
7379,Domingos Quina,38,2622300,9861699228281390,279,3986226,2436295,2437,2433858
7380,Jhonny Quiñónez,48,4391700,3961538351500537,515,7540301,5240450,5241,5235209
7381,Sergio Quiroga,35,3135900,8446225903678561,340,5095686,3492765,349277,3143488
7382,Álvaro Quiroga,43,2130900,9072997808260290,262,3419228,1822349,182235,1640114
7383,Kasim Rabihic,53,4139000,6885383334162579,457,6763674,693412,694,692718
7384,Bogdan Racovițan,25,3300900,3105613550574461,309,4973218,1903170,1904,1901266
7385,Josip Radošević,31,422900,3472010319105395,78,589003,573243,0,573243
7386,Hamza Rafia,48,1188400,3555059207141531,277,2936462,2479375,24794,2454581
7387,Baba Rahman,22,1483400,9194514270437294,115,1948595,1051083,1051083,0
7388,Jukka Raitala,35,2656800,7563774330707876,278,4377620,1287793,129,1287664
7389,Diant Ramaj,40,1608300,8621064898994565,217,2770052,1380865,1381,1379484
7390,Eric Ramírez,48,2673200,8284650197694197,342,4590543,661460,66146,595314
7391,Eric Ramírez,29,1221400,3417933397201546,144,1972785,1815598,0,1815598
7392,Dani Ramírez,24,879500,4599912841061574,110,1328920,1315730,13158,1302572
7393,Luís Martins,30,1059300,6529762979139660,132,1659248,1154923,0,1154923
7394,Mathias Rasmussen,39,4252800,7811801994670802,456,7273472,4853125,4853125,0
7395,Mathias Hebo Rasmussen,61,2114300,5580629539261776,384,4213075,3975425,0,3975425
7396,Vadim Rață,41,3240700,7499414954577564,352,5428711,2934259,2935,2931324
7397,Nicola Rauti,39,1440100,6080947355363633,242,2840532,2148161,214817,1933344
7398,Nicola Ravaglia,25,4511400,3501425485829055,399,6552054,456382,456382,0
7399,Raimundo Rebolledo,30,3618200,7390067636547305,285,4644333,1784496,178450,1606046
7400,Luciano Recalde,26,4828500,7607179919946120,439,6782848,6252965,62530,6190435
7401,Constantin Reiner,29,3587900,5873495366015443,348,5622118,270032,271,269761
7402,Cafú,70,382500,6159970715588878,317,2418654,1891085,1892,1889193
7403,Giacomo Ricci,27,3487800,8109862126527869,321,5413925,2497469,250,2497219
7404,Clemens Riedel,52,4816100,8023672718208508,595,8510418,4320315,433,4319882
7405,Florian Rieder,68,429500,6211624723300132,336,2806606,810550,0,810550
7406,Jonathan Ring,43,4790900,6581318861323451,460,7309137,4348395,4348395,0
7407,Hansell Riojas,26,3898500,4536063810935816,356,5601855,3557118,3557118,0
7408,Braian Rivero,49,960000,9845388244221272,222,2234217,785772,7858,777914
7409,Cristian Riveros,65,1328200,9303673092555689,352,3641777,1645027,16451,1628576
7410,Blás Riveros,65,1533500,7190153558669438,332,3937473,1798394,17984,1780410
7411,Calogero Rizzuto,39,2284800,3546174547406987,260,3683395,2256648,225665,2030983
7412,Carlos Roca,30,2104900,5373233629972686,220,3265891,1565632,1566,1564066
7413,Valentín Rodríguez,58,4927300,6097701903133480,595,8319122,5974728,59748,5914980
7414,Luciano Rodríguez,52,4685700,9884603325341671,530,8208881,3770202,0,3770202
7415,Kevin Rodríguez,60,4270300,6763318835654906,584,7660008,5129844,0,5129844
7416,Alexis Rodríguez,61,3693400,8392363753604195,506,6902858,5057962,0,5057962
7417,Tachi,38,314100,4812866054058431,145,1150639,1048602,0,1048602
7418,Jack Rodwell,58,3217100,8347211126254326,508,6458717,44339,4434,39905
7419,Žan Rogelj,60,548000,9004069880122883,229,1803295,952228,952228,0
7420,Morgan Rogers,32,3746300,9619504268050793,334,5252666,4818115,48182,4769933
7421,Alex Roldan,51,975200,4170798883845980,223,2278394,1207801,1208,1206593
7422,Filippo Romagna,26,1964200,7939097721646004,191,2670280,2608034,26081,2581953
7423,Mahlon Romeo,31,4529200,5768068110781282,375,6230555,1646031,0,1646031
7424,Ángel Romero,67,416600,7502111129135268,322,2646353,1160600,1161,1159439
7425,Iván Romero,64,2548800,3902319769995625,458,5022907,2581867,259,2581608
7426,Romero,35,2322100,9682724099861226,259,3643266,868646,0,868646
7427,Shaun Rooney,39,4874700,9933082625854553,457,7181300,3688637,0,3688637
7428,Daan Rots,24,1456800,4644742540451715,129,1877590,1510110,1510110,0
7429,Matteo Rover,30,4675900,4298512625776372,476,6743755,6316838,63169,6253669
7430,Jimmy Roye,32,879100,8662674924550814,133,1483722,617703,61771,555932
7431,Donat Rrudhani,26,4368700,5660694700524647,360,6258589,6045979,604598,5441381
7432,Rubio Rubin,38,1456900,9224970933771519,199,2484506,716958,0,716958
7433,Espen Ruud,48,2972300,6760912508350465,388,5542555,3727276,37273,3690003
7434,Matěj Ryneš,50,4350100,6343424394819884,464,7053217,2793492,2794,2790698
7435,Jonathan Sabbatini,40,4836000,9182251657874765,511,7849822,332481,0,332481
7436,Emmanuel Sabbi,67,3892100,6447697999573068,578,7586628,2484494,2484494,0
7437,Thomas Sabitzer,35,4513800,5263246694307659,495,7220889,2362056,2363,2359693
7438,Loret Sadiku,24,3190900,5480828351177845,269,4154321,985253,0,985253
7439,Ole Christian Sæter,33,3735200,8407984532671511,371,5586203,256216,2563,253653
7440,Ibrahim Said,31,906600,9495240403650824,117,1387279,585943,0,585943
7441,Rafiki Saïd,57,2848300,8992497610697029,429,5713390,307897,308,307589
7442,Dylan Saint-Louis,46,2727500,3973414527162748,426,5443942,5410132,0,5410132
7443,Íñigo Sainz-Maza,22,1738200,4456288149911249,138,2273582,74807,749,74058
7444,Horacio Salaberry,50,2615600,6940400269347957,399,4615523,315109,0,315109
7445,Anass Salah-Eddine,41,1733200,8444503829509027,272,3342591,466029,466029,0
7446,Salinas,69,4249900,6377693764548558,657,8069608,3044308,3044308,0
7447,Benedikt Saller,48,2676300,5209639639378260,392,4847631,3196529,320,3196209
7448,Emil Salomonsson,45,2228600,8688073912793368,287,3747185,2596710,25968,2570742
7449,Jhon Sánchez,34,3778900,7202198967331817,365,6330370,2739565,0,2739565
7450,Felipe Sánchez,64,3103400,9160651487928134,485,6370358,1401260,141,1401119
7451,Christian Joel Sánchez,58,4874100,7376295892265785,624,8588136,8272390,827239,7445151
7452,Isaías,29,4574800,5687469045487168,391,6698665,3857758,386,3857372
7453,Sam Sanna,67,2364900,3101258987040141,449,5050798,4580520,458052,4122468
7454,Iván Santillán,42,1615600,3358277724181387,233,2704534,2360599,23606,2336993
7455,Ivan Santini,28,3092000,7663463354390556,294,5077399,1362398,136240,1226158
7456,Daniel Sappa,53,4499400,4591422395462672,559,7764941,6826823,683,6826140
7457,Cristian Săpunaru,31,2965500,8269785612903859,255,4044167,2147156,215,2146941
7458,Rodrigo Saracho,66,645800,6393714856260794,303,2732357,120819,0,120819
7459,Rodrigo Saravia,60,1785200,9662437475399115,350,3816846,3356236,3356236,0
7460,Veysel Sarı,66,1152700,4287126773500849,412,3614565,3036366,3036366,0
7461,Elvis Sarić,42,2766800,7261012233580781,346,4378723,11814,11814,0
7462,Jeremy Sarmiento,67,2725500,4972807331912296,490,5739820,3233694,323370,2910324
7463,Darío Sarmiento,48,364100,6576904294227557,195,1599625,1029389,0,1029389
7464,Romaine Sawyers,69,3893600,4711624671542844,535,7623970,1732120,1733,1730387
7465,Franco Sbuttoni,44,4046000,3925077625614486,478,7203132,1539327,1540,1537787
7466,Aurélien Scheidler,43,1228400,3485264257603922,217,2661071,324404,3245,321159
7467,Kjell Scherpen,58,2495300,7893552562799196,435,5249675,4977011,498,4976513
7468,Domenik Schierl,55,479800,8947733473865118,234,1839789,1292089,1292089,0
7469,Lukas Schleimer,61,1784600,8407228458789593,411,4509070,2380829,0,2380829
7470,Dominik Schmid,69,3262900,4456095322824454,588,7112572,5782990,579,5782411
7471,Kenneth Schmidt,59,1189800,6475121237467253,305,2843969,389459,38946,350513
7472,Luca Schnellbacher,52,1554700,5968381238666335,327,3773577,2128212,2128212,0
7473,Ricardo Friedrich,60,1058000,5147846197117884,301,3063881,1364532,137,1364395
7474,Kevin Schumacher,41,2836100,7125127167435461,375,4623452,2637114,2638,2634476
7475,Marco Schuster,59,4054500,7048150843809813,572,7929667,5602047,0,5602047
7476,Sebastian S. Sebulonsen,37,3029200,3887990859735826,325,4844056,3064058,3065,3060993
7477,Andrea Seculin,50,3808500,7882544245981944,523,6651576,5244061,5245,5238816
7478,Ayumu Seko,42,3334800,7417238499305122,356,5329196,4952603,496,4952107
7479,Boris Sekulić,44,864900,8714334881539789,164,1617732,874088,874088,0
7480,Seo Min Woo,25,3286200,4799166088657089,329,4986546,4450,4450,0
7481,Matías Sepúlveda,60,3214600,3825719118925193,493,6697626,4934169,0,4934169
7482,Francho Serrano,24,2276800,5894785008012735,194,3231232,750313,750313,0
7483,Riyadh Sharahili,70,560800,5055175576084157,294,2588107,526205,52621,473584
7484,James Shea,35,2072000,8554205181200653,244,3430754,1677495,167750,1509745
7485,Jamil Siebert,51,2277100,4358556549305649,342,4169432,2997878,29979,2967899
7486,Grego Sierra,57,3559400,6299432821229192,553,7462865,1937714,19378,1918336
7487,Danylo Sikan,22,3426800,8006345666409627,225,4645959,274088,274088,0
7488,Pedro Siles,30,1900200,4717541934238361,185,2533333,48142,4815,43327
7489,Marcelo Silva,24,2144500,8029320288287944,153,2583830,1074706,108,1074598
7490,Luiz Felipe,28,3532900,6555349435384456,334,5383172,4714967,47150,4667817
7491,Aral Şimşir,61,435200,4460212464301979,265,2142040,1774937,1774937,0
7492,Per Ciljan Skjelbred,44,1918100,5588135406167846,316,3644777,2366084,2367,2363717
7493,Anis Slimane,41,719400,3707490874435765,141,1465034,865215,8653,856562
7494,Paul Smyth,64,3890900,8194530869224471,513,6614106,1244165,124417,1119748
7495,Soberón,36,2073100,4570277916392410,244,3672417,2796525,0,2796525
7496,Patryk Sokołowski,58,2354700,5786486876708631,408,5146725,4881156,48812,4832344
7497,Wilfredo Soleto,25,664600,8594083679393746,57,680211,610590,611,609979
7498,Renato Solís,69,2349000,9991661170774030,482,5434694,3853351,38534,3814817
7499,Francois-Joseph Sollacaro,55,1530200,9426931117965556,345,3893458,89297,0,89297
7500,Michael Sollbauer,38,3969000,9440203220575879,391,6002119,4443060,44431,4398629
7501,Patrick Sontheimer,67,4394900,6462277924467417,641,9113598,8822573,8823,8813750
7502,Sondre Sørli,51,3831600,5168028007314240,510,7150208,5578654,5579,5573075
7503,Samuel Sosa,67,3406000,5592044395030819,500,6239266,647092,6471,640621
7504,Sebastián Sosa Sánchez,57,1613400,3929197857282609,310,3572428,1343768,134377,1209391
7505,Nicolás Sosa Sánchez,48,448100,3763750919707301,223,1862036,290436,0,290436
7506,Moussa Soumano,56,2980900,9726711932763317,447,5890476,2963870,0,2963870
7507,Caio Alexandre,44,2590600,5515664630600507,334,4422357,2416471,242,2416229
7508,Abner,37,1593100,9136016208130990,253,3225279,2612293,262,2612031
7509,Kevin Spadanuda,33,3472000,6212340223406359,359,5674260,58398,0,58398
7510,Adrían Spörle,62,1581400,4935468414033329,381,4223269,1652318,165232,1487086
7511,Jozo Stanić,48,499900,9003574318767599,197,1631771,1424367,0,1424367
7512,Dimitrios Stavropoulos,36,1987700,6205840141429236,257,3258956,130279,13028,117251
7513,Marvin Stefaniak,61,3666400,7062258634297034,607,7353407,5345669,0,5345669
7514,Simon Strand,64,3671200,7013146255261823,525,6879941,229010,22901,206109
7515,Luca Strizzolo,62,953700,4760962204592021,349,3273574,1394812,139482,1255330
7516,Mario Stroeykens,35,1688300,3233383105241257,233,3046605,1666594,1666594,0
7517,Jimmy,22,4896400,7065976363671803,402,7303159,1414412,14145,1400267
7518,Alexander Succar,33,336000,6637213270077372,93,667197,525431,525431,0
7519,Tomás Sultani,40,2840200,6697540820171059,358,5240516,2871868,2871868,0
7520,Daniel Svensson,56,2831800,4846868687661262,389,5468333,2163601,2163601,0
7521,Williot Swedberg,33,3655200,3340914782122681,308,4994720,4241937,0,4241937
7522,Walter Tandazo,56,2812100,7070378259957735,390,5139018,378885,0,378885
7523,George Tanner,27,3503100,4217439778663728,302,4996582,4266738,427,4266311
7524,Gonzalo Tapia,70,1446400,6627121303139706,423,4157580,819426,81943,737483
7525,Abdoul Fessal Tapsoba,27,663400,9372531811460519,77,827410,701323,702,700621
7526,Ertuğrul Taşkıran,31,4499400,9002573160773967,407,6870835,4780869,0,4780869
7527,Terry Taylor,50,2970700,5162321679344100,422,5850574,3750415,0,3750415
7528,Caleb Taylor,52,3739100,3112389443121369,485,7199007,5056562,5056562,0
7529,Jackson Tchatchoua,31,770500,9773976486637903,115,1282842,929956,0,929956
7530,Pascal Testroet,63,3218000,9641956722994917,509,6142060,3467019,3468,3463551
7531,Simon Thern,49,4564700,4949872670025036,508,8317210,5722893,0,5722893
7532,Bjarne Thoelke,56,362400,5131732315656779,244,1813329,1787878,1788,1786090
7533,Jordan Thompson,45,1413000,5409806617879350,268,2999052,2174143,217415,1956728
7534,Jordhy Thompson,57,1457300,4922712272926938,277,3125916,1025242,1026,1024216
7535,Jordan Thorniley,35,4189900,4075471894215183,420,6571000,3547591,355,3547236
7536,Lennart Thy,55,3941700,7550398698635496,583,7982693,252837,0,252837
7537,Alexis Tibidi,58,2299400,5019234393308876,442,5282243,3299015,3300,3295715
7538,Valentin Ticu,26,1270200,6455624983370937,119,1565337,123828,0,123828
7539,Horacio Tijanovich,48,1599300,3634429149158766,254,2971145,338123,0,338123
7540,Marco Tilio,41,3534900,7278475654166712,405,6013604,608687,0,608687
7541,Curtis Tilt,54,3236700,5687065539493102,436,5672486,104783,0,104783
7542,Kacper Tobiasz,30,3584700,8576351989551798,325,5033957,15501,1551,13950
7543,Fernando Torrent,69,4692900,7687927579582647,666,8781765,4239261,4240,4235021
7544,Alin Toșca,30,2080000,4063435744612750,197,3140470,1614399,1615,1612784
7545,Idrissa Touré,43,4988400,5109443334330296,494,8126930,3598767,360,3598407
7546,Yoann Touzghar,57,2508700,6595088058327393,431,5192737,2098136,210,2097926
7547,Bénie Traore,58,3143000,6848632933246919,523,6364884,6306608,0,6306608
7548,Joaquín Trasante,38,4103200,3468100812524506,451,6608960,1981701,1981701,0
7549,Philipp Treu,56,572100,5967643292044594,208,1651222,535938,0,535938
7550,Konstantinos Triantafyllopoulos,24,3207300,4313533318406825,265,4623281,2760086,277,2759809
7551,Cristian Trujillo,38,468500,3391154860385222,142,1257522,382380,0,382380
7552,Bill Tuiloma,50,1452000,3983510837002710,281,3096367,1234338,1234338,0
7553,Oliver Turton,37,3650800,8855035376583643,332,5147263,5026988,503,5026485
7554,Boné Uaferro,68,1357600,7121781065474739,383,3675920,835100,83510,751590
7555,Steven Ugarković,30,3238000,5453463527945389,279,4974455,1475942,14760,1461182
7556,Adrián Ugarriza,29,2467000,8302145717435701,236,3731535,84604,847,83757
7557,Naci Ünüvar,49,4513600,9705537204237457,560,8002055,3778940,0,3778940
7558,Ureña,40,2208200,9395901564702718,305,3979879,3485532,349,3485183
7559,Anthony Uribe,56,1393100,7125857428712867,315,3577971,868920,869,868051
7560,Georgios Vagiannidis,42,4938900,6382464679415939,473,7194056,601187,602,600585
7561,Sauli Väisänen,47,3770900,8889659644753445,417,6058309,4838849,4838849,0
7562,Juan David Valencia,47,1741600,6893207618068509,289,3585762,2484631,24847,2459784
7563,Jader Valencia,68,903000,3874135874945092,375,3460602,406370,0,406370
7564,Enrico Valentini,26,4735700,4954179492553188,389,7283066,5870518,58706,5811812
7565,Thomas Van Den Keybus,30,4683600,8403124754892622,405,6975791,2389745,238975,2150770
7566,Djevencio van der Kust,70,4455300,9138104489186198,639,8693367,2893124,0,2893124
7567,Jonathan Varane,46,1712200,3348493922965307,284,3331335,2364697,2365,2362332
7568,Diego Pampín,59,2220400,5165940390724204,413,4865037,1905312,1906,1903406
7569,Roland Varga,25,3926700,8593191242496663,309,5378546,730115,731,729384
7570,Jefre Vargas,25,4664300,3260314329744401,402,6611007,3806517,0,3806517
7571,Brayan Véjar,36,3368100,9470040011689150,376,5700953,3029915,0,3029915
7572,Pedro Velasco,59,3850700,4013811426558520,522,7285088,4258961,4258961,0
7573,Beycker Velásquez,56,1170900,4268705735910935,310,2969476,484298,0,484298
7574,Jairo Vélez,60,4848800,9527386842930521,594,8273081,7357023,7357023,0
7575,Brayan Vera,49,1291100,8517033468120256,319,3213238,122762,12277,110485
7576,John Verhoek,47,1632000,3780151853298011,312,3760170,2429528,24296,2405232
7577,Gonzalo Viera,30,532300,5206211214857325,90,830495,387378,0,387378
7578,Vilanova,64,1248100,6929473623148980,343,3302635,943845,0,943845
7579,Lars Vilsvik,50,3151200,9751137110562480,458,6046940,5681382,5681382,0
7580,Alessio Vita,33,4256000,3919866643511152,406,6786901,5854786,0,5854786
7581,Pedro Vite,46,3882500,8782990657015542,407,6272297,752078,0,752078
7582,Carlos Vivas,67,2754700,3961982219483590,473,5784152,3708296,37083,3671213
7583,Cristian Volpato,61,548200,3512324684803834,334,2906487,1129268,113,1129155
7584,Neto Volpi,42,1718800,7395059025208900,254,3071914,866521,866521,0
7585,Albion Vrenezi,23,2028300,6087277068736101,210,3071990,1051222,10513,1040709
7586,Josip Vuković,42,1112300,7147199298737177,217,2290551,1241825,1242,1240583
7587,Patrik Vydra,60,1550700,4181091465531816,365,3875897,2323665,0,2323665
7588,Martyn Waghorn,51,2351500,7574894359498255,353,4742763,1240852,0,1240852
7589,Fridolin Wagner,31,2179500,9913670451302098,250,3228039,2034353,2035,2032318
7590,Tyler Walker,48,1071900,4666838035027435,234,2371944,764181,76419,687762
7591,Liam Walsh,64,791700,6383963578242937,317,2790678,2712569,2713,2709856
7592,Joe Ward,51,1674400,4857488475040097,294,3279521,729749,0,729749
7593,Danny Ward,45,525800,9318027519106274,144,1263027,665650,665650,0
7594,Joel Waterman,44,3800400,5272756016648801,427,6419357,103976,10398,93578
7595,Kelland Watts,43,948400,9631166304184081,227,2275910,1762931,1763,1761168
7596,Oscar Wendt,35,4430700,9264722227673062,403,6253389,1092225,0,1092225
7597,Christopher Wernitznig,39,1936000,8929781421502852,285,3505774,681822,0,681822
7598,Philipp Wiesinger,63,2965100,8198816583256581,449,6250944,982388,0,982388
7599,Ben Wiles,44,4667000,7525988171425707,551,7862974,1187091,1188,1185903
7600,Jordan Williams,34,301200,3583614856588278,97,698853,284934,285,284649
7601,James Wilson,38,3290000,5895202097099773,360,5205814,5073546,5074,5068472
7602,Danny Wilson,57,1277500,7067356870669338,292,3098509,2423867,2424,2421443
7603,Marten Winkler,31,2321600,7857194689695098,235,3328827,2082923,0,2082923
7604,Manuel Wintzheimer,35,4084800,9312660667993017,402,6456920,651005,0,651005
7605,Przemysław Wiśniewski,48,2831700,4181686161874478,401,5230240,801230,0,801230
7606,Nick Woltemade,36,3158900,3920215230292130,348,5163350,167853,167853,0
7607,Kwasi Okyere Wriedt,47,2880700,8104096364588967,415,5671920,854324,855,853469
7608,Charlie Wyke,50,3223100,8322831773725318,392,5192385,1842921,1843,1841078
7609,Erdoğan Yeşilyurt,51,674700,3546784731988942,211,1986800,1351085,135109,1215976
7610,Kartal Yılmaz,43,4624800,4944723305026940,550,8282822,4864725,0,4864725
7611,Héctor Yuste,37,1904000,3819744423316695,230,3096549,1753194,1754,1751440
7612,Facundo Zabala,22,704100,5029038634964373,72,788549,391119,0,391119
7613,Caleb Zady Sery,41,1496800,4575250941801218,257,3016806,1980986,0,1980986
7614,Luka Zahović,38,4732000,3369578291822189,455,7768444,2372169,238,2371931
7615,Gjoko Zajkov,47,4494900,7812391934649718,507,7598931,276777,0,276777
7616,Luca Zander,58,1743400,5425882818295100,320,3596196,2130428,0,2130428
7617,Franco Zapiola,64,2537500,9215275886637576,460,5252142,4012841,40129,3972712
7618,Bryan,29,611000,6337669520693731,73,729982,709591,0,709591
7619,Manuel Zeitz,42,496800,9810642009939564,182,1560808,963114,0,963114
7620,Ekain,32,4781800,6051568821734644,425,6919476,6701170,0,6701170
7621,Jean Zimmer,40,1325700,9749793530852133,204,2274472,1850062,186,1849876
7622,Bernhard Zimmermann,37,815200,5824634071526462,161,1648304,317268,317268,0
7623,Ivan Zlobin,52,3548900,4100233657011715,432,6109132,1005304,1006,1004298
7624,Kenneth Zohore,37,3861300,6407983157475242,398,5976033,2669673,2670,2667003
7625,Ben Zolinski,39,3779600,7808230999488769,394,5987946,3164024,0,3164024
7626,Nadir Zortea,30,3121500,4630288866859449,284,4673420,2878204,0,2878204
7627,Adam Zreľák,36,1464800,9564983609011919,185,2360393,397877,0,397877
7628,Luca Zuffi,31,3893700,9924084515615949,325,6063359,886838,886838,0
7629,Dario Župarić,25,3519200,8414291020224522,286,4618666,405401,0,405401
7630,Graham Zusi,48,4492300,5349140949689812,508,7820318,2363243,0,2363243
7631,Paxten Aaronson,27,361700,5317073055869362,39,272754,48458,0,48458
7632,Abdel Hakim Abdallah,49,443000,4106466530831841,226,1709749,255548,0,255548
7633,Ali Mohamed Abdallah,34,1714700,8418759545089328,197,2630095,1025384,103,1025281
7634,Aly Abeid,65,3486600,3837193749810479,546,6983313,6756071,0,6756071
7635,Charles Abi,68,2717100,5689260616066179,475,6018473,5135485,5136,5130349
7636,Albert Acevedo,58,866400,8975747905347909,295,2649544,1067120,106712,960408
7637,Alonso Aceves,54,1262200,6275710974259405,292,3114889,975870,0,975870
7638,Aceves,60,1323200,7861683650171105,299,3345955,2909048,29091,2879957
7639,Vlad Achim,35,434100,4537835391885909,89,765940,510262,0,510262
7640,Yaw Ackah,36,3170300,8099840789797656,358,5017827,3667088,366709,3300379
7641,Carlos Adorno,50,774100,3156535432499882,217,1963351,1730587,173059,1557528
7642,Danny Henriques,68,1460800,7546483651483243,386,3754367,970804,9709,961095
7643,Alban Ajdini,55,671400,9906644406762300,274,2409800,1156261,115627,1040634
7644,Arlind Ajeti,22,4064500,6531379500000134,351,5510471,419908,41991,377917
7645,Ufuk Akyol,61,4524700,5883836352145316,526,8077865,3978366,0,3978366
7646,Nawaf Al Aqidi,62,882800,8466471404718825,326,2861743,435928,436,435492
7647,Ali Al Hassan,23,1114300,3874401245452191,92,1366830,920494,92050,828444
7648,Fawaz Al Sagour,31,2494900,4119430860101680,265,3573924,534759,0,534759
7649,Hamdan Al Shamrani,55,382200,8984141431767002,220,1782966,484810,48481,436329
7650,Tomás Alarcón,23,4850400,5032329649399919,432,7775065,6615362,6615362,0
7651,Lucas Albertengo,59,1524700,5547512199158780,324,3262243,1557811,155782,1402029
7652,Norbert Alblas,52,4585900,6895131777367506,590,7581920,6616017,0,6616017
7653,Alexandru Albu,50,685000,8729329203346807,215,1854755,1027860,102786,925074
7654,Aldasoro,32,3209400,8645247685886774,292,4752622,1916064,191607,1724457
7655,Julián Alfaro,25,2989100,6328512484840371,261,4385292,2007727,20078,1987649
7656,Carmelo Algarañaz,28,2091500,8573271572275027,171,2713796,1551230,1552,1549678
7657,Mukhtar Ali,62,1640700,9836097366629801,363,3802134,2839735,0,2839735
7658,Jak Alnwick,53,2693000,9019781902182837,369,4784119,2188068,2188068,0
7659,Joseda Álvarez,57,4322900,9751344103593528,575,8315201,6198970,0,6198970
7660,Iker Álvarez,59,1295600,6018467684842612,333,3136448,271172,27118,244054
7661,Léo Chú,44,3325400,4960264765137513,340,4980669,3670714,0,3670714
7662,Lucas,70,1290200,6278834078327266,387,3974155,2227603,2227603,0
7663,Ukra,51,1015100,7105703902675818,278,2911523,88500,0,88500
7664,Iván Anderson,37,3600000,8087093928493255,348,5403600,3564168,35642,3528526
7665,Bruce Anderson,59,1193400,3618291152456003,337,3267511,2698724,270,2698454
7666,Fernando Andrade,62,2724100,4075325855665004,439,5832951,919813,9199,910614
7667,Aleksandar Andrejević,23,3135600,5969770918107879,235,3950907,1921590,0,1921590
7668,Tino Anjorin,47,4604500,6307967775877910,526,7962845,3742597,0,3742597
7669,Celton Biai,33,998500,7715350634769013,137,1595378,936577,0,936577
7670,Valentin Antov,54,1248400,9733013203986580,328,3105999,605337,606,604731
7671,Kévin Appin,35,2193200,6950255326367022,266,3318488,1906921,191,1906730
7672,Walter Araujo,56,2975500,3309033783349758,484,6026690,4673108,4673108,0
7673,Jordan Archer,70,4241700,4041224938881147,658,8308201,5802021,58021,5744000
7674,Adu Ares,56,2331200,9617500084764890,429,5168181,4502934,0,4502934
7675,Gustavo Arévalos,51,935800,5740963330028679,259,2570239,833171,833171,0
7676,Yair Arismendi,30,2140200,9833395141629864,215,3228907,1641462,0,1641462
7677,Kristian Arnstad,23,433700,7530051717410574,21,199507,154185,154185,0
7678,Jann-Fiete Arp,64,4101100,5876144367098389,617,8244341,4490432,450,4489982
7679,Bright Akwo Arrey-Mbi,60,2748700,8102954513730869,506,5635627,4231355,0,4231355
7680,Serkan Asan,34,898800,8979066051264376,166,1799489,1417570,1418,1416152
7681,Adrián Ascues,49,1675900,5867473028988724,303,3433753,398470,399,398071
7682,Kristoffer Askildsen,44,722300,4900817213669131,198,1826877,1190106,120,1189986
7683,Dairon Asprilla,22,4529000,3718647658676493,330,6051767,5693870,570,5693300
7684,Yáser Asprilla,51,521600,9573900260997443,240,1974497,1973656,19737,1953919
7685,Abdullah Ateef,37,3604700,3229307308781611,405,5881176,5449325,5449325,0
7686,Nathaniel Atkinson,36,2110900,7488947616264493,228,3279565,2542793,254280,2288513
7687,Jean-Kévin Augustin,65,565600,9066914321059691,299,2593567,1304082,130409,1173673
7688,Charlie Austin,50,4397600,8585274110293009,510,8010500,2220332,0,2220332
7689,Durel Avounou,40,1796400,4252654688693819,243,3195449,3043429,3044,3040385
7690,Nazinho,45,623500,3198169037171852,198,1763810,1151006,1152,1149854
7691,Pape Meissa Ba,45,4073800,9893375958941609,475,7150728,6298376,6298376,0
7692,Ba Dun,47,2069600,8082693672339552,297,3925645,3186192,31862,3154330
7693,Edgar Babayan,36,2905500,4825593499470267,321,4714560,4171756,4171756,0
7694,Felix Bacher,52,3789300,8966244003755620,452,6272631,2510333,252,2510081
7695,Dominique Badji,45,2572400,8305453025116786,308,4375461,1955427,195543,1759884
7696,Youssouph Badji,26,1289100,4463146609055397,130,1764274,343209,344,342865
7697,Gabriel Báez,24,4909200,9970087942529396,447,7117868,5315470,0,5315470
7698,Bentley Baxter Bahn,29,492600,7812500687890076,67,592753,200481,200481,0
7699,Mike-Steven Bähre,49,2708600,8966892233093053,388,5108949,374845,37485,337360
7700,Michael Baidoo,57,3782000,5193282634303429,536,7002970,1024699,0,1024699
7701,Scott Bain,25,619300,9114129250308229,51,586065,224133,225,223908
7702,Saïd Bakari,69,2633500,5100327158259039,431,5734412,704282,70429,633853
7703,Makana Baku,49,1480700,8384443588097058,264,2960571,2006535,2007,2004528
7704,Romário Baldé,69,791400,8835172178696306,370,3308457,1976353,198,1976155
7705,Yasser Baldé,30,2211000,8789693030501028,225,3522144,546609,5467,541142
7706,Dominic Ball,54,1861900,9241001273161306,364,4365354,463651,46366,417285
7707,Florian Ballas,66,4511900,6688147260226307,664,8473747,785571,785571,0
7708,Thierno Ballo,32,3701900,7289196296188558,341,5315090,1198696,119870,1078826
7709,Axel Bamba,38,3660000,6620134553282827,361,5832500,1525752,152576,1373176
7710,Funsho Bamgboye,48,1739300,4579947817635529,327,3538320,3435520,34356,3401164
7711,Marcel Bär,36,4249500,8156290538301823,470,6932899,795535,0,795535
7712,Leandro Barcia,31,2070600,8782576917268867,242,3250071,1667167,167,1667000
7713,Martín Barrios,27,4079900,8410393591058939,363,5662987,3745278,37453,3707825
7714,Thierno Barry,51,4267700,5837715381248956,488,6902406,1099437,109944,989493
7715,Maxime Barthelmé,62,386300,4259092515879352,234,1896769,1175433,117544,1057889
7716,Mons Bassouamina,60,1446600,6032382214641781,344,3487942,1988669,0,1988669
7717,Lewis Bate,22,2673000,8026002572169006,193,3621115,92486,9249,83237
7718,Dominic Baumann,47,694800,6452997797139752,185,1701251,501499,502,500997
7719,Furkan Bayır,25,4922700,3683285283686836,471,7602057,6442420,644242,5798178
7720,Tom Bayliss,69,818000,4001796995833265,380,3239397,1084620,0,1084620
7721,Raúl Becerra,48,939900,6953921152556137,231,2363805,858322,858322,0
7722,Tobias Bech,26,980800,8218042019013489,104,1422519,681383,0,681383
7723,Ismajl Beka,54,1133000,4140609978738088,313,3321682,2891141,0,2891141
7724,Joe Bell,54,911000,8902669015559292,288,2774416,756931,757,756174
7725,Mohammed Ali Bemammer,40,2486200,3919085278287388,286,3773212,208872,209,208663
7726,Rico Benatelli,70,4325300,5778653409671709,655,9060210,7379483,737949,6641534
7727,Guillermo Benítez,54,858300,4894869895986298,230,2130159,1298278,0,1298278
7728,Miguel Ángel Benítez,69,2865100,7206670157566022,500,6197309,5369810,53699,5316111
7729,Jewison Bennette,44,4421400,6924507827950947,466,7517509,1083143,109,1083034
7730,Leider Berdugo,44,3034600,3854290240747683,352,5232541,1365189,0,1365189
7731,Gustav Berggren,70,4823600,5917415231261677,645,9122406,1974238,19743,1954495
7732,Emiliano Bermúdez,33,3154000,3717001354116546,334,4960523,1587956,15880,1572076
7733,Alexander Bernhardsson,28,4847500,9097090206633537,399,6901681,5358174,5359,5352815
7734,Steeve Beusnard,26,1684200,8450730436573716,165,2425543,738048,7381,730667
7735,Merveille Biankadi,44,3504100,9175760137607001,407,5878623,1494190,149419,1344771
7736,Tom Bischof,64,1407200,7756234889661834,409,4123583,864050,864050,0
7737,José Bizama,26,4889500,5921740996047408,390,6567969,6104869,611,6104258
7738,John Björkengren,70,4369500,8550251941748488,615,7985084,4809622,0,4809622
7739,Sondre Flem Bjørshol,29,4427900,4039218848436504,428,7128051,4209596,420960,3788636
7740,Jamal Blackman,65,4660600,5378153580927257,683,9420387,3016319,302,3016017
7741,Emmanuel Boateng,35,840200,6348652835782647,163,1713371,1227533,1228,1226305
7742,Billy Bodin,69,4544200,4406254841762844,655,9424174,689923,689923,0
7743,Darijan Bojanić,23,1744900,3755741724385575,153,2561605,2293360,229336,2064024
7744,Kévin Boli,64,3033900,4776791069095598,443,6079234,4021256,4022,4017234
7745,Bendegúz Bolla,40,3409200,7341268550240372,394,5603598,1229632,1229632,0
7746,Alexandre Bonnet,53,2876200,5605000506394696,429,5597295,1743309,174331,1568978
7747,Christopher Bonsu Baah,45,2168600,3299785121802462,309,3861613,2416069,0,2416069
7748,Marco Borgnino,59,2279700,6250855886235142,386,4622985,3467326,346733,3120593
7749,Osvaldo Bosso,23,4022400,5259067397002931,339,5750702,189881,189881,0
7750,Kenji-Van Boto,54,3722800,9054479224373825,473,6916141,1542694,1543,1541151
7751,Carlo Boukhalfa,33,4827500,9753798905562906,441,7916504,3933484,3934,3929550
7752,Aymen Boutoutaou,28,4017100,7940075151830762,399,6161463,1971295,1972,1969323
7753,Ruben Bover,50,2216200,8318316457249659,303,4187720,233361,233361,0
7754,William Bøving,42,2199500,8994303828830369,313,4062864,1774026,0,1774026
7755,Chris Brady,33,3308100,5345804841492834,336,5090787,1536981,1537,1535444
7756,Christopher Braun,31,302300,8665529045337535,101,728942,443724,0,443724
7757,Juanma Bravo,25,2511700,7279135805249931,231,3703231,3459980,346,3459634
7758,Pascal Breier,41,2734200,6497677648878027,342,4471330,3925389,39254,3886135
7759,Marco Brescianini,50,2297100,6654857000588829,308,4066036,466840,4669,462171
7760,Joshua Brillante,30,4197800,5919767986956289,427,6207484,977433,0,977433
7761,Jérémie Broh,63,2464700,8040617590003210,453,5434974,3405121,340513,3064608
7762,Javain Brown,22,2868500,5096848622659422,242,3983293,3043689,3044,3040645
7763,Ciaron Brown,23,1682600,5734604522386092,128,2158996,397389,3974,393415
7764,Alexander Brunst,39,3489100,6974684133095254,363,5763128,5389978,0,5389978
7765,Charles-Andreas Brym,24,2541500,3283275717063461,223,3795291,1882472,1883,1880589
7766,Buatu,51,3765200,6349144074069939,513,7390497,732245,7323,724922
7767,Roman Buess,22,4516200,8945707067799689,328,6652951,3033540,0,3033540
7768,Thomas Buitink,25,3146500,8695923679080839,299,4898941,2490995,250,2490745
7769,Oliver Bundgaard,64,468300,6315254648892990,291,2288313,334061,33407,300654
7770,Max Burgess,53,3639000,8641209734843065,471,6098819,5462503,0,5462503
7771,Graham Burke,69,1849100,3500366367102768,412,4661662,4258663,4258663,0
7772,Rocky Bushiri,51,2577400,9983976698821333,374,4549485,676766,676766,0
7773,Jakob Busk,50,4817900,8054394540711683,534,7571043,2730097,274,2729823
7774,Ezequiel Busquets,50,3313400,8671978380138257,383,5800750,284098,2841,281257
7775,Álvaro Bustos,32,2748400,3591205941837553,271,4036750,246250,0,246250
7776,Mihai Butean,62,3579400,3632953261436722,490,6858808,428020,429,427591
7777,Juan David Cabal,64,2820200,5792031331462886,461,5495154,1595150,1595150,0
7778,Carlos Cabello,38,526400,3149490464624830,135,1217994,932247,0,932247
7779,Cătălin Căbuz,47,2166800,6863253109308953,340,3969293,252941,2530,250411
7780,Cai Huikang,59,339700,9068653336433594,299,2390355,1476768,148,1476620
7781,Luis Caicedo,31,1645500,4013823909173290,190,2718278,1486147,1487,1484660
7782,Abdulkerim Çakar,40,1348300,7853457442554178,231,2563444,13121,0,13121
7783,Pablo Camacho,59,815500,7709175464280937,242,2166057,210084,211,209873
7784,Lamine Camara,43,787700,6784270248103140,189,1956163,1309726,0,1309726
7785,Álvaro Campuzano,69,1173100,3709360917318398,321,3249956,2301895,230190,2071705
7786,Luis Cano,51,1917000,3286556034268789,369,4310314,711791,0,711791
7787,Mihai Căpățînă,66,936400,8771369999037722,321,3117345,2261909,0,2261909
7788,Édgar Carrión,32,4794700,8892426117925274,447,7782823,1070943,0,1070943
7789,Florian Carstens,31,1737900,9113054689103820,187,2759754,294151,294151,0
7790,Cesare Casadei,50,1866800,8869932036124598,317,3663262,445152,446,444706
7791,Marcin Cebula,35,4226600,8346609068443581,417,6811681,3156073,3157,3152916
7792,Junior Cedeño,26,2593600,5433268424263842,249,3730635,2857193,285720,2571473
7793,Joseph Ceesay,50,314100,6563112220647856,180,1342379,173345,17335,156010
7794,Maximiliano Centurión,52,2840700,5486989848998810,410,5425655,3165928,316593,2849335
7795,Giuliano Cerato,53,4807500,3233193877827952,548,7879744,28922,2893,26029
7796,Carlos Cermeño,46,3073100,6290000011279559,378,5283345,755583,756,754827
7797,Boris Cespedes,70,1787000,4699055910964870,441,4664964,4251495,0,4251495
7798,Sava-Arangel Čestić,48,1960700,4694871646719572,308,3786899,2593646,0,2593646
7799,Mike Cestor,29,3536200,3886418757100317,323,5057172,2764054,277,2763777
7800,Tarık Çetin,23,4993200,8706018974391532,435,7639764,5059837,5060,5054777
7801,Wálter Chalá,69,1210500,7241586274067435,383,3461915,2391035,23911,2367124
7802,Edinson Chávez,33,460100,4580868827922411,86,750878,48646,0,48646
7803,Sunil Chhetri,68,3127800,6225806184844083,544,6503052,4192310,4192310,0
7804,Alexandru Chipciu,47,1594700,6832232650010467,261,3058890,1401715,141,1401574
7805,Kacper Chodyna,59,3730800,9124204035386589,534,7125896,2484292,249,2484043
7806,Agustín Chopitea,44,2194800,9364168798546401,302,4084286,1459922,14600,1445322
7807,Joris Chougrani,54,963700,9473697208709531,305,2780021,1375692,137570,1238122
7808,Andreas Christodoulou,42,3045100,7166638371723473,389,5673797,3583967,359,3583608
7809,George Cîmpanu,40,4205400,6716497780656965,397,6627500,1759390,17594,1741796
7810,Till Cissokho,33,2042600,6572661321525639,262,3309280,1124932,0,1124932
7811,Pelle Clement,26,1425300,4833668322624812,144,2009725,1661230,166123,1495107
7812,Alexandre Coeff,30,1158800,5487063183608390,161,2043988,121602,1217,120385
7813,Devante Cole,63,4029200,6547339776419373,591,8043737,55580,0,55580
7814,James Collins,30,1367300,4305307087400643,169,2181290,1564571,156458,1408113
7815,Racine Coly,29,4500700,7145344844851422,433,6755471,5678344,56784,5621560
7816,Gabriel Compagnucci,70,1049200,4859878363288202,385,3430132,993520,0,993520
7817,Christian Conteh,65,2852000,5782081514455685,420,5653075,1468253,1468253,0
7818,Tommy Conway,25,4196600,5631593602152274,383,6513587,5490715,5491,5485224
7819,Andy Cook,40,977300,3541405454086098,179,1918551,1284117,1285,1282832
7820,Theo Corbeanu,50,3890400,7453960936528301,500,7221808,1214734,1214734,0
7821,Mael Corboz,46,1959000,8432787055732730,315,4058551,2669081,2670,2666411
7822,Sergio Córdova,64,1751600,8349762453365153,360,4059648,412279,0,412279
7823,Fernando Cornejo,39,3986400,5790617855291130,465,6732240,6450852,0,6450852
7824,Ramón Coronel,28,3090900,3788585510776696,242,4284778,968958,969,967989
7825,Tomás Silva,47,859600,4929411126308835,190,1848311,1025503,0,1025503
7826,Cristian Costin,69,2068400,8896812931649836,446,5005271,1692987,1693,1691294
7827,Jordan Cousins,49,1445600,7832367678286181,305,3260656,171147,1712,169435
7828,Néstor Cova,55,2098200,9171360518799530,357,4169415,2552045,256,2551789
7829,Nemanja Covic,59,4651600,9325044962414108,564,7891554,928883,929,927954
7830,Ljuban Crepulja,58,2791900,4335967816788400,454,5274244,3827330,382733,3444597
7831,Saúl Crespo,43,2496600,5575081491011285,306,4285861,4024079,403,4023676
7832,Alejo Cruz,55,3180900,4425692855215678,473,6398347,1600976,161,1600815
7833,Luke Cundle,49,1749900,6204102348838290,311,3600772,8601,0,8601
7834,Marvin Çuni,47,3781200,3383024858696790,452,6363715,737543,738,736805
7835,Lovro Cvek,41,2973100,3107851784443824,351,4847733,1530127,0,1530127
7836,Christopher Cvetko,47,874000,9966798511602302,204,2109048,97748,978,96770
7837,Luca D'Andrea,39,1270500,7131720242877461,201,2414133,647154,648,646506
7838,André Luís,40,3108100,9102383267996606,375,5377305,4355221,435523,3919698
7839,Josh Dacres-Cogley,56,4564300,4868963340541639,574,8093734,5132223,51323,5080900
7840,Renat Dadashov,28,4347000,7296415930673900,371,6235521,1503742,150375,1353367
7841,Dalmau,65,410600,9702075391416904,360,2873354,2814393,2814393,0
7842,Vitalie Damascan,57,3280100,7536948127673952,491,6287539,4145994,41460,4104534
7843,Misael Dávila,47,4770300,8284088104530778,552,7592163,4402428,4402428,0
7844,Maël de Gevigney,42,3867600,5156715296008656,397,5889810,2648315,2649,2645666
7845,Lautaro,61,1100900,7579309278354918,333,3282938,1487676,148768,1338908
7846,Juan Cruz De Los Santos,47,483900,5618448161413574,183,1613899,728738,728738,0
7847,Daniel De Silva,57,814500,3468099508744005,247,2381353,1766917,177,1766740
7848,Koni De Winter,64,4649700,3257704248212762,558,7592762,317448,3175,314273
7849,Yannick Deichmann,24,1796500,9697982879147131,123,2057527,1617220,161722,1455498
7850,Mats Deijl,26,947300,7755261054177753,100,1206109,167922,0,167922
7851,Maxim Dekker,62,764300,6869522300028112,316,2984295,609730,6098,603632
7852,Luis Del Pino Mago,47,1377700,6760404578334725,272,2944315,665998,0,665998
7853,Moi Delgado,49,2113400,4430982979369556,356,4352520,3437250,3437250,0
7854,Delmás,37,2273400,8449383417183240,274,3846929,876406,8765,867641
7855,Yohan Demoncy,44,4892600,4315018973643389,499,7677121,5983758,5984,5977774
7856,Kyle Dempsey,34,1535100,9645307177677056,201,2496262,1798346,180,1798166
7857,Valentín Depietri,65,2026400,7812274015104896,407,4873413,2648162,2649,2645513
7858,Pape Djibril Diaw,28,3528400,4467119009628831,332,5359999,292118,0,292118
7859,Diomar Díaz,55,1275500,8924189887583541,300,3087742,1275444,12755,1262689
7860,Victor Dican,28,3164200,9645135709812496,276,4662300,541670,541670,0
7861,Adrián Diéguez,51,945700,9152922105655795,239,2298313,135058,13506,121552
7862,Lars Dietz,36,2558100,3414664686031696,285,3739949,1189285,0,1189285
7863,Ismaël Diomandé,44,1088200,9461517593759390,202,2312777,392595,39260,353335
7864,Maximilian Dittgen,46,1294400,6921082590890660,233,2547714,1068456,107,1068349
7865,Mohamed Djetei,31,3358000,9348761507078092,348,5391687,2643897,0,2643897
7866,Toni Domgjoni,68,3936100,6125957092155418,635,8490241,2271557,0,2271557
7867,Jerónimo Domina,38,1104200,4511436038164243,168,1970804,1910860,1911,1908949
7868,John Donald,38,3804200,3590514400531571,439,6499907,6279204,62793,6216411
7869,Mehdi Dorval,57,340000,7875611479873226,242,1896950,314094,315,313779
7870,Anderson,40,2714000,8455739519696625,326,4809907,2136211,2136211,0
7871,Hassani Dotson,64,3844300,8512227468240627,600,7603575,2390738,2390738,0
7872,Barry Douglas,22,2307800,5241590603870364,196,3148981,954557,0,954557
7873,Couhaib Driouech,53,3189300,8112375555427244,432,5581893,634780,63478,571302
7874,Michael Duffy,50,1142700,3818158861071347,302,3150483,1979386,197939,1781447
7875,Bryce Duke,59,1547800,9187457583475834,326,3456726,828629,829,827800
7876,Andres Dumitrescu,61,2412000,6179402140985839,376,4615783,1561075,15611,1545464
7877,Julien Duranville,40,747400,6219443626394209,168,1564747,1520889,15209,1505680
7878,Chris Durkin,60,2686900,3805892681629290,425,5442834,23593,0,23593
7879,Tomás Durso,43,2529000,3098279579642016,332,4448492,1175270,1176,1174094
7880,César,40,3238800,5100842764262006,373,5270184,3000168,3001,2997167
7881,Sampson Dweh,58,2432900,4858227042789197,428,4681218,1846047,184605,1661442
7882,Malcolm Ebiowei,27,2250800,7447479825354004,210,3418512,1601854,0,1601854
7883,George Edmundson,27,3853500,5509377484926792,397,5991239,3848392,38484,3809908
7884,Tayo Edun,65,2973100,9199934768916548,519,6381190,2915397,29154,2886243
7885,Curtis Edwards,57,3635000,7883259969734442,465,6089079,4268755,4269,4264486
7886,Vitus Eicher,24,3001800,6284746661643671,234,3893398,1529157,0,1529157
7887,Jacques Ekomié,38,330500,4897358081905359,134,988713,744395,744395,0
7888,Neil El Aynaoui,54,4912000,6441015311827928,616,9356835,4728500,4729,4723771
7889,Omar El Hilali,32,4553400,4637553870167275,484,7298010,3012150,0,3012150
7890,Simon Elisor,36,4869300,9837733289584582,471,7817990,161360,161360,0
7891,Martin Ellingsen,64,2026900,8210670436303051,437,4803160,3922705,3923,3918782
7892,Bartuğ Elmaz,58,3472000,8076441802297821,413,5956875,5136157,5137,5131020
7893,Elliot Embleton,57,4107800,5683458420943525,536,6796028,5726826,573,5726253
7894,Erik Engelhardt,31,1855400,3991947874024461,205,2841745,1674970,1674970,0
7895,Okan Erdoğan,47,4084400,8820591063029804,453,6616504,5994152,600,5993552
7896,Ethan Erhahon,24,4867700,7163265732580638,386,7315037,95842,9585,86257
7897,Tomás Escalante,43,447500,6189936847590510,159,1369405,573931,573931,0
7898,Dani Escriche,65,3379800,4522995291333393,564,7130723,239705,240,239465
7899,Jhon Espinoza,59,2952300,8351400249377641,430,5820695,5434597,5434597,0
7900,Felipe Espinoza,50,3186400,9340370382210903,475,6466779,294624,0,294624
7901,Juan Espitia,41,3687500,5968059718872459,442,6382257,3711862,3711862,0
7902,Santiago Etchebarne,57,3742700,7020355725640850,543,7307528,6958164,0,6958164
7903,Kion Etete,60,3514200,6130968308688637,466,6322967,450467,451,450016
7904,Neil Etheridge,40,990900,8467287197481930,221,2336194,340984,341,340643
7905,Corry Evans,51,1252100,8356636092916735,288,2821825,1083945,109,1083836
7906,Erik Expósito,39,3314000,4889575338121675,391,5711585,2491691,0,2491691
7907,Brooklyn Ezeh,54,3533800,8471342466155183,482,6272729,2819392,0,2819392
7908,Nené,27,2522100,8514512685600349,219,3571742,2013085,20131,1992954
7909,Ivo Pinto,40,2033200,6495956988626435,309,3825927,2899566,289957,2609609
7910,Konrad Faber,35,1112100,9754836444948314,179,1942097,1859406,185941,1673465
7911,Andrej Fábry,50,3656400,5714250757512021,434,6816526,2607472,2608,2604864
7912,Caín Fara,59,3121500,3656983705358244,455,5885085,2141657,0,2141657
7913,Paolo Faragò,46,3224400,3644249380413086,395,5551546,1012668,1012668,0
7914,Luis Fariña,64,1552600,8669608591804074,378,3715591,2958706,296,2958410
7915,Jacopo Fazzini,57,1132200,4492427013728428,298,2833672,2259704,2259704,0
7916,Adrian Fein,55,1341700,7866495108647884,311,3386324,2907089,2907089,0
7917,Mads Fenger,42,3321700,7558053215657352,357,5472361,1418934,0,1418934
7918,Arianit Ferati,42,1321000,4598933899234133,213,2549815,1715785,1715785,0
7919,Nathan Ferguson,58,1052000,3348204039392092,281,3028241,1251198,1251198,0
7920,Damián Fernández,24,2851700,7558541642155495,229,3988069,2625437,263,2625174
7921,Dani Fernández,35,1152500,4758897320030224,183,2056961,1484427,148443,1335984
7922,Andrés Ferrari,53,923400,3411659710427131,212,2151136,650197,650197,0
7923,Gabriele Ferrarini,34,3313200,5948820386981469,291,4622672,3834361,3834361,0
7924,Ioannis Fetfatzidis,33,2464100,9044231613537430,245,3751559,3116023,0,3116023
7925,Riccardo Fiamozzi,24,364100,7815595465869367,54,388762,34102,34102,0
7926,Richard Figueroa,60,2623200,4495681809417135,443,5461195,1426158,0,1426158
7927,Ioan Filip,43,973000,9920308653559581,203,2126880,216177,217,215960
7928,Kian Fitz-Jim,66,393600,4439341266694422,279,2129870,1436281,1436281,0
7929,Florian Flecker,30,1873500,5398017061895380,197,2936912,597313,598,596715
7930,Felipe Flores,27,2627400,5611674289121439,240,3698831,3697035,36971,3660064
7931,Mamadou Fofana,58,3108100,4553622934174638,418,5545699,3390536,33906,3356630
7932,Boubacar Fofana,63,1338500,5947936169419298,333,3482330,339844,3399,336445
7933,Ben Folami,52,2151600,3381157183856988,348,4281033,4096137,409614,3686523
7934,Chris Forino,67,1745700,4068949522645712,355,3958143,382734,38274,344460
7935,Alan Forrest,57,886700,3655538828612937,288,2789706,341543,341543,0
7936,Craig Forsyth,22,2680200,3941868809957932,238,3650442,2944436,0,2944436
7937,Fortuño,35,2468600,4878900170540190,312,4113147,2148080,214808,1933272
7938,Daam Foulon,25,3515400,6622193926167977,299,5143261,2596679,0,2596679
7939,Abu Francis,32,315700,5880571336059596,68,483449,112667,1127,111540
7940,Juan José Franco,38,3570800,5955394118695675,395,5742219,3149900,314990,2834910
7941,Guillaume François,26,2878000,6032756317965244,245,3975535,2728655,2729,2725926
7942,Liam Fraser,36,3599500,6415277983283533,381,5557485,5224120,52242,5171878
7943,Hólmbert Aron Friðjónsson,38,944000,7228744902520961,157,1712647,41526,41526,0
7944,Dominik Frieser,55,1797300,4833937969200126,344,3893718,627458,0,627458
7945,Nils Fröling,44,4688400,9469459158346841,549,8656423,4962696,0,4962696
7946,Jeando Fuchs,24,4122600,5726985643874264,379,6376481,3753745,0,3753745
7947,Joel Chima Fujita,25,3362400,5738179620694584,303,4966370,326940,327,326613
7948,Andrea Fulignati,67,2246900,3187079242216663,451,5150326,1247209,124721,1122488
7949,Juriën Gaari,59,2179100,6396121572346444,392,4575285,1039701,103971,935730
7950,Adrián Gabbarini,25,2424900,8577323874307209,239,3651368,2113170,2114,2111056
7951,Raymon Gaddis,48,3014600,3729642212347209,433,5593309,4437574,0,4437574
7952,Tomás Galván,67,347700,8730855514418768,261,2136061,519404,519404,0
7953,Valerică Găman,68,4965200,6165234744938322,622,8437084,6796789,0,6796789
7954,Jens Martin Gammelby,27,623100,5822983973875031,69,688410,264100,2641,261459
7955,Silvère Ganvoula,43,3561900,6011045617602018,395,5720757,3636593,0,3636593
7956,Luke Garbutt,24,4685400,6181039409482633,397,6436507,442479,4425,438054
7957,Borja Garcés,51,4958900,3082085942009249,604,8938946,7962018,797,7961221
7958,Damián García,64,4176900,7723160814250741,602,8112901,4417647,4417647,0
7959,Pablo García,70,3615300,6420778175192993,568,6862017,2743430,0,2743430
7960,Joan García,48,3106400,6691731099060589,397,5262065,1308206,1308206,0
7961,Mario Gargiulo,30,1762900,3975436563046795,185,2658045,518387,5184,513203
7962,Paul Gartler,53,2659400,9340002438636147,404,5331803,3880857,0,3880857
7963,Lamine Gassama,36,4880200,6571939848617538,462,7641385,1780641,178065,1602576
7964,Marcel Gaus,60,3432400,5647931157849749,523,6321030,6271004,0,6271004
7965,Felix Gebhardt,27,390400,7948051575987108,66,529593,174369,0,174369
7966,Turgay Gemicibaşı,44,309200,8446678677744321,147,1115352,585742,58575,527167
7967,Fabio Gerli,59,1424900,4614046756749631,339,3626099,643610,6437,637173
7968,Lamine Ghezali,51,4934000,6861429844529742,593,9100575,7289574,7290,7282284
7969,Iván Gil,42,3728600,5756465347173869,419,6495852,1024020,1025,1022995
7970,Nick Gillekens,51,4779300,4940426787797278,523,8338562,7301746,730175,6571571
7971,Mark Gillespie,27,4345600,3327116483024179,370,6454934,3682697,3682697,0
7972,Dylan Gissi,66,4260600,8690062943395192,620,8674177,7565815,7566,7558249
7973,Eddy Gnahoré,60,4876900,8361785258390038,620,8105026,241643,242,241401
7974,Giorgi Gocholeishvili,34,974500,9219317842248530,158,1817928,994545,100,994445
7975,Diego Gómez,32,2554700,3143048479176110,261,3867652,886941,0,886941
7976,Iron Gomis,33,4060900,6411502393938611,394,6484239,1520276,1521,1518755
7977,Donatien Gomis,55,1116700,3203831975401150,283,2845000,10344,104,10240
7978,Marcelo González,61,2744500,8062678417077532,481,5685277,2828909,2829,2826080
7979,Peter,61,3287100,8321663851854173,443,5929067,4119556,411956,3707600
7980,Urko González,22,3889300,3721024768513833,309,5470188,3229861,322987,2906874
7981,Lynden Gooch,26,3093300,4713676505362480,263,4787965,3771622,377163,3394459
7982,Liam Gordon,28,1054500,9892928487499315,112,1485146,653125,0,653125
7983,Jan Gorenc,42,713700,8362348710081153,165,1468593,1125081,11251,1113830
7984,Felix Götze,29,3202100,6009370300536231,310,4759064,2240953,225,2240728
7985,Pablo Gozálbez,30,4532600,5129389089188037,427,6268200,3378145,3379,3374766
7986,Jens Grahl,67,1212400,7639251100773309,385,3825752,443915,0,443915
7987,Rhyan Grant,22,615300,7310441546154936,38,494790,72515,726,71789
7988,André Green,39,4432800,3071558486772985,451,6773797,2989359,299,2989060
7989,Ruan,37,4660400,8484277824517324,434,7324272,2835693,0,2835693
7990,Adriano Grimaldi,31,339600,6468728191675447,67,485953,392652,0,392652
7991,Daniel Grimshaw,55,3743400,3878301019394209,452,6160739,21035,21035,0
7992,Simone Grippo,48,4668500,3821492894433416,566,8318817,8078926,807893,7271033
7993,Darijo Grujčić,64,2618600,8155099462366448,471,5930162,750839,0,750839
7994,Adrian Gryszkiewicz,22,2996300,5601461513818463,248,3950194,3296907,330,3296577
7995,Juan Cruz Guasone,66,4863900,6252831701030641,618,8245672,6458266,6459,6451807
7996,Raudy Guerrero,62,2574600,9169145222087846,441,5259668,283604,0,283604
7997,Nesta Guinness-Walker,65,809400,4341024253998508,304,2678100,117832,117832,0
7998,Muhammed Gümüşkaya,42,2923400,4239863967542752,363,5178272,4066277,407,4065870
7999,Jostein Gundersen,48,2835000,8686688572328700,356,4645097,2417833,24179,2393654
8000,Julian Günther-Schmidt,24,2689000,8437903179160628,237,3561391,108602,0,108602
8001,Ahmet Gürleyen,60,4236600,9019626472393068,603,8114548,3433460,0,3433460
8002,Carl Gustafsson,33,3385300,6300229076055838,334,5138292,29547,296,29251
8003,Filipe Nascimento,44,3698000,5744881449317582,473,6475775,1778880,177888,1600992
8004,Jon Guthrie,46,3798100,4090389382476255,477,6596012,1713378,171338,1542040
8005,Silvio Gutiérrez,68,4605200,8491160602036703,649,9312564,2608344,260835,2347509
8006,Daniel Gutiérrez,55,1682300,4488474528762851,357,4005327,2235689,223569,2012120
8007,Brad Guzan,33,1023200,3864506721872794,174,1868000,690419,0,690419
8008,Maxwell Gyamfi,43,4069600,4498564178360870,450,6386140,1901359,0,1901359
8009,Giovanni Haag,64,3126600,9671468686846303,519,6725433,5729939,573,5729366
8010,Maren Haile-Selassie,23,3625100,5723082588126626,340,5400455,3790450,0,3790450
8011,Besar Halimi,30,1950000,3250105892127380,201,2953104,2879607,0,2879607
8012,Lewis Hall,68,1111800,6768951407615278,349,3217065,391740,3918,387822
8013,George Hall,48,3477000,3348466422137568,447,6144063,2540966,254097,2286869
8014,Andy Halliday,26,3130000,5009360606304260,272,4268894,3766594,0,3766594
8015,Niko Hämäläinen,37,4574700,6127451577020375,408,7450550,1725970,17260,1708710
8016,Ben Hamer,59,524500,9804650666734387,298,2524926,916186,0,916186
8017,CJ Hamilton,65,4163500,6313797925637314,586,8237868,4370059,43701,4326358
8018,Sergiu Hanca,66,1481900,7703698378239047,396,4178820,2842989,28430,2814559
8019,Simon Handle,50,2842200,8803899196001246,407,5102015,4066139,4067,4062072
8020,Mads Hansen,67,607000,8713167565604123,267,2359643,1273137,12732,1260405
8021,Daniel Hanslik,64,1606100,6479634915860031,422,4340031,803466,803466,0
8022,Ryan Hardie,64,3577800,7614073041909166,598,7814014,3168332,31684,3136648
8023,Marcus Harness,29,3195900,4352730372570352,329,4921233,1450178,145018,1305160
8024,Nathan Harriel,37,3531800,5813652834071853,376,5281388,1012836,1012836,0
8025,Mark Harris,58,3181900,9228733583538438,426,5672365,3966014,3967,3962047
8026,Ellis Harrison,22,341800,4578823298571546,20,109999,75109,0,75109
8027,Haissem Hassan,48,4559600,5988298534238946,514,7220027,434180,43418,390762
8028,Tom Hateley,44,4779900,8098886175113122,519,7720819,2990336,0,2990336
8029,Omar Hawsawi,49,3091100,4224640867716368,366,5071235,2914094,29141,2884953
8030,Henrik Heggheim,30,3635400,8527603427074949,344,5861239,924249,924249,0
8031,Jürgen Heil,62,967200,6444423348373171,283,2604543,1625657,1625657,0
8032,Juan José Heinze,23,1179100,5661670840718865,90,1456981,759985,75999,683986
8033,Ramon Hendriks,43,2712200,7629376032208551,375,4977878,565780,56578,509202
8034,David Henen,68,2576200,8642233880884906,531,6054088,3272679,328,3272351
8035,Gustav Henriksson,49,1386900,8471181648900486,257,2690454,382801,0,382801
8036,Óscar Hernández,42,545400,8078631162383083,162,1499552,1292259,1293,1290966
8037,Ibrahim Hesar,34,3299700,9659542431528254,313,5316107,1680712,1681,1679031
8038,Perparim Hetemaj,53,4968400,5837677266806669,638,9379934,5312557,53126,5259431
8039,James Hill,57,3728000,3126608130756490,509,6721728,3577385,3577385,0
8040,Lukas Hinterseer,68,1268100,8630282987950294,420,3884984,1980102,1980102,0
8041,Leo Hjelde,66,3988900,5629359991266278,580,8077899,3511371,3511371,0
8042,Dominik Hładun,62,2094400,8996784712553849,405,4369678,3627503,3627503,0
8043,Noah Jean Holm,57,4345500,6427624515596783,587,8096729,6407149,6408,6400741
8044,Frederik Holst,57,2769900,7498614237143406,432,5658302,4496908,0,4496908
8045,Jason Holt,28,1039100,7816110611755948,99,1240710,13245,13245,0
8046,Siebe Horemans,36,2473200,5913635778367733,294,3843343,802875,0,802875
8047,Jizz Hornkamp,44,2178700,6376325095178196,324,4135144,3123603,3124,3120479
8048,Jordan Houghton,37,1370700,7966770002911843,239,2511959,1472078,0,1472078
8049,Jeroen Houwen,36,4336600,7510781708224830,473,7000695,6832601,0,6832601
8050,Sam Hughes,58,1980500,3300781108195771,354,3972289,3331211,0,3331211
8051,Daan Huisman,62,1720900,6593034095512190,411,4277920,990138,100,990038
8052,Hwang In Jae,42,4339400,5761614108438624,495,7598191,2284355,229,2284126
8053,Paul Iacob,56,788200,5078194644166360,308,2546900,1373112,0,1373112
8054,Matías Ibáñez,56,2498200,5237016182383319,383,4760770,3520325,0,3520325
8055,Cesar Ibañez,44,3325800,4605088053988673,376,5307251,4036716,4037,4032679
8056,Wilson Ibarrola,35,3124400,5841931657984540,320,4986738,1260615,127,1260488
8057,Luka Ilić,39,1924200,9405805995832570,270,3440781,833362,0,833362
8058,Tomoki Imai,47,2846900,6874598235061497,375,5192865,302561,303,302258
8059,Pablo Iñiguez,49,1924200,9990982506569598,310,3552558,423706,423706,0
8060,Manuel Insaurralde,27,1942000,7701240482122783,169,2865356,1989190,1990,1987200
8061,Nikita Iosifov,33,1193800,7005322396385732,170,2001318,1339500,1339500,0
8062,Alessio Iovine,53,1461800,7455661741817275,306,3292315,1345716,0,1345716
8063,Harry Isted,22,2427600,8347290242064091,190,3100216,865270,0,865270
8064,Iturbe,58,2779900,6090358764236436,403,5288047,2234749,0,2234749
8065,Juan Manuel Izquierdo,60,1528900,4532832380243871,396,3999866,1721091,17211,1703880
8066,Sebastian Jacob,30,1605700,5765470966844214,180,2530611,674317,6744,667573
8067,Valentin Jacob,22,3898100,6096873747156494,294,5183392,4708996,471,4708525
8068,Joe Jacobson,22,4583500,6021609806427904,385,7088123,5657841,566,5657275
8069,Marin Jakoliš,41,3904700,8461617863102594,396,6120272,5058534,0,5058534
8070,Rafał Janicki,24,4375800,3726582964597339,335,6065814,5169213,516922,4652291
8071,Isak Jansson,51,2692000,4361716514270861,421,5678817,5096843,50969,5045874
8072,Erik Janža,56,1835600,6438247440508480,362,3935675,207372,20738,186634
8073,Maudo Lamine Jarjué,49,1887600,5709176028406516,320,3903170,1136550,11366,1125184
8074,Paweł Jaroszyński,31,3318700,9729771499824294,269,4539201,2981275,29813,2951462
8075,Sylvester Jasper,25,2137000,6423564688473460,173,2726887,735318,736,734582
8076,Daniel Jebbison,23,3885100,4360635726621064,325,5776753,1566337,1566337,0
8077,James Jeggo,67,3678000,8962788929117033,595,7485209,2569892,0,2569892
8078,Victor Jensen,32,3317700,4302834172551214,342,5074156,2200609,220061,1980548
8079,Ruben Yttergård Jenssen,47,4351600,5187649076714819,450,6455517,3228495,32285,3196210
8080,Ulrik Yttergård Jenssen,42,2632500,9500561742372072,338,4538347,3364286,0,3364286
8081,Jeong Jae Hee,29,3729200,7795873790963385,361,5849920,3620867,36209,3584658
8082,Ignacio Jeraldino,65,3722200,5409715863602758,559,6954702,4250193,0,4250193
8083,Jiang Zhipeng,68,663800,9744773392889069,365,3058788,183762,1838,181924
8084,Dani Jiménez,54,1444900,3285755951987469,310,3465956,60775,0,60775
8085,Marko Johansson,27,3963800,6929361937117978,367,5817850,3635074,364,3634710
8086,Oscar Johansson,45,1816500,8252675197614225,306,3523810,722592,0,722592
8087,Marvin Johnson,52,4377000,4522686593593793,563,7781937,4257263,4258,4253005
8088,Max Johnston,66,2730500,8491272116467806,472,5922677,2969629,2969629,0
8089,Lloyd Jones,35,1938700,7614507190921599,237,3477874,3144116,314412,2829704
8090,Derrick Jones,60,4257900,7192211404272296,609,8089357,2483350,248335,2235015
8091,Edisson Jordanov,54,825300,3818901463917887,257,2402452,637471,637471,0
8092,Marcelo Jorquera,24,2853200,4090957712664234,253,4004522,2400435,2400435,0
8093,Jakub Jugas,69,4890700,9751190163569703,587,8313333,7052776,705278,6347498
8094,Saeed Juma,62,1294700,5544004998599727,314,3311974,1435578,1436,1434142
8095,Samuel Soares,28,495000,4169313877341065,84,703144,628096,6281,621815
8096,Leonel Justiniano,33,1098000,5178345537584930,157,1945277,452814,45282,407532
8097,Manu Justo,34,2172700,6356360379030493,265,3693936,489896,0,489896
8098,Lukas Jutkiewicz,32,416400,3532249623672908,113,923713,617750,0,617750
8099,Elvis Kabashi,23,3600100,3361685082288591,300,5123987,2432774,244,2432530
8100,Chris Kablan,56,2734500,4649981594472852,406,5202809,3141457,314146,2827311
8101,Kevin Kabran,31,4317100,6725382322717131,423,6576454,5676760,0,5676760
8102,Jakub Kadak,23,879300,4163172669803163,82,1105483,162325,163,162162
8103,Junior Kadile,62,3162800,3840354107344513,504,6351137,1033419,0,1033419
8104,Kylian Kaïboué,69,565500,5180663782148518,367,2872740,789254,0,789254
8105,Otar Kakabadze,62,1214800,6708317817063512,339,3631289,3511519,3511519,0
8106,Anthony Kalik,27,1980800,4218506627215984,218,3210217,2923291,0,2923291
8107,Lindrit Kamberi,39,1227600,6495156938772670,203,2447841,2088516,2089,2086427
8108,Aboubakary Kanté,61,4826900,6591253897571539,602,8786591,4358926,4358926,0
8109,Cebrail Karayel,37,3448100,6016734142932877,370,5495597,3061907,3062,3058845
8110,Oleksiy Kaschuk,47,2494600,9825983972338985,330,4435463,2528128,0,2528128
8111,Denso Kasius,32,978500,3407178551038883,122,1417363,716155,71616,644539
8112,David Kasumu,33,1380200,8306966848872956,206,2401888,1793421,179343,1614078
8113,Aléxandros Katránis,63,394300,7814954946441908,256,1864879,1792973,0,1792973
8114,Kévin Keben,30,4654300,8201430436700423,414,7244870,1007778,1007778,0
8115,Ákos Kecskés,47,1872900,8651487201872141,286,3441090,1536543,0,1536543
8116,Thomas Keller,64,1294700,7205231955206916,366,3845033,987360,9874,977486
8117,Marvin Keller,67,2192700,3722065683447140,492,5411823,1158779,1158779,0
8118,Stephen Kelly,66,3134700,7152614409818047,526,6298068,6155674,6156,6149518
8119,Liam Kelly,47,2771000,8628742489699393,379,4609581,1381206,138121,1243085
8120,Frankie Kent,22,3334100,7141251458263436,269,4930852,3408919,3408919,0
8121,Philippe Paulin Keny,69,3476600,8148271893574745,605,7396607,5576007,5576007,0
8122,Luca Kerber,58,3605900,5212054177247338,478,6625170,2415378,0,2415378
8123,Liam Kerrigan,32,3332500,5322384378787505,343,5505685,348317,0,348317
8124,Roman Kerschbaum,45,883300,9112592471325149,195,1942682,1146621,115,1146506
8125,Konstantin Kerschbaumer,45,4487700,9437181107085860,473,7297811,3987078,0,3987078
8126,Kerem Kesgin,43,2397500,4985505154247277,320,4245600,3918398,391840,3526558
8127,Josh Key,63,916500,4743750576439451,286,2832534,2341144,0,2341144
8128,Salim Khelifi,52,2331100,8159469965373670,378,4676629,4374403,4374403,0
8129,Abdukodir Khusanov,43,1792100,9179894144317459,238,3070087,856854,8569,848285
8130,Guy-Marcelin Kilama,32,1328300,6189984843760189,169,2033939,1698268,1698268,0
8131,Kim Jin Ya,33,746500,3969766229574434,127,1378819,514996,515,514481
8132,Kim Gyeong Min,54,4058500,4997746740244292,536,7170940,7130842,0,7130842
8133,Kim Tae Hwan,63,2394400,9905191930370159,409,5039533,3448459,34485,3413974
8134,Kim Bo Kyung,44,3438000,9647477307630847,388,5638250,3304314,3304314,0
8135,Kim Dong Min,47,3767700,8654017686267945,425,6059382,2607886,0,2607886
8136,Kim Geon Woong,61,730100,6205913784654008,281,2399422,2255826,0,2255826
8137,Leon King,66,4353400,3077911623357703,634,8809146,7466026,7466026,0
8138,Orestis Kiomourtzoglou,46,3179300,7611369030025308,394,5489166,4925451,4925451,0
8139,Peter Kioso,56,4352000,4468800721148794,531,8241210,3386989,0,3386989
8140,Yann Kitala,51,3737300,4810554004017422,538,7323281,481568,4816,476752
8141,Eric Bugale Kitolano,22,1238100,4924524137201239,94,1572216,254405,254405,0
8142,Mathias Kjølø,43,2171200,8414874163569745,355,4190879,1405383,140539,1264844
8143,Sebastian Klaas,68,2799000,9538446177339566,507,5866444,1847491,0,1847491
8144,Klaus,40,1089200,6564757480047460,172,2029666,1400560,14006,1386554
8145,Philipp Klewin,34,2279000,8777379635593346,235,3210957,2030756,20308,2010448
8146,Harvey Knibbs,25,1817000,7349393528564868,153,2461060,2263445,226345,2037100
8147,Yuki Kobayashi,54,2593000,3753131872356966,386,4703113,2802642,0,2802642
8148,Luca Warrick Koleosho,46,3742000,4586702025933212,415,6224067,5016299,0,5016299
8149,Dimitrios Kolovetsios,47,4860100,5781909832244550,551,8125213,5329167,5329167,0
8150,Gilbert Koomson,38,4410400,5952826845100455,424,6600583,453046,453046,0
8151,Peer Koopmeiners,68,3587300,8774079235211953,549,7481771,2979450,29795,2949655
8152,Patrick Koronkiewicz,61,844200,5444359024507746,349,3094773,729408,730,728678
8153,Luka Krajnc,26,2436400,6669289643695862,215,3539036,852769,852769,0
8154,Joris Kramer,44,571100,5995551559355584,167,1402135,794436,794436,0
8155,Blaž Kramer,32,4674900,4847787828594772,400,6750055,3058885,306,3058579
8156,Bledian Krasniqi,48,1229800,4856793433071149,290,2967421,1240711,0,1240711
8157,Anton Krešić,42,811300,9653396449916065,167,1647702,805766,8058,797708
8158,Dmytro Kryskiv,60,1421200,6696386290235707,344,3427202,2113739,0,2113739
8159,Lukas Kunze,46,1991500,7920965918884349,293,3536060,1161266,0,1161266
8160,Rafał Kurzawa,46,3432800,7167664572556471,397,5746435,4758948,476,4758472
8161,Stefan Kutschke,58,4115300,7472999170256572,562,7166878,6806186,68062,6738124
8162,Kwon Hyeok Kyu,56,3074000,6081227742389681,486,6509910,4534469,45345,4489124
8163,Jakub Łabojko,41,2467100,9751605663720353,297,4201840,880753,8808,871945
8164,Gustaf Lagerbielke,52,2698000,7573834807720678,382,4704364,986174,987,985187
8165,Fynn Lakenmacher,56,3699000,3640056662155828,505,7145547,4155259,415526,3739733
8166,Eugenio Lamanna,31,2592600,4998775716809969,304,4540042,4384937,4384937,0
8167,Macaulay Langstaff,26,369200,3297345866353135,62,493481,261978,2620,259358
8168,Eric Lanini,40,1294800,6136919051393718,208,2338146,1102734,11028,1091706
8169,Lassi Lappalainen,49,3185700,9092015068581043,456,5952159,5579148,5580,5573568
8170,Enzo Larrosa,45,1320300,3591379710052585,251,2926470,1013859,1013859,0
8171,Japhet Sery Larsen,29,2180900,5432430278226557,221,3237379,2072765,2073,2070692
8172,Mads Lauritsen,64,3870200,6652612471914510,624,7942213,6899370,6899370,0
8173,Joaquín Lavega,35,4059600,7041773020131756,381,6245351,2417742,241775,2175967
8174,Jamie Lawrence,42,2190000,6692081118098990,301,4207951,3181099,31811,3149288
8175,David Lazar,46,4298000,4991496605987229,481,7149793,1082626,109,1082517
8176,Matías Lazo,37,2835300,9264342280494145,338,4833260,196907,1970,194937
8177,Florian Le Joncour,63,2928000,7588812400167054,483,6005910,3297420,3297420,0
8178,Luke Le Roux,66,2036500,4989188483660174,399,4579838,4009742,0,4009742
8179,Orest Lebedenko,52,4783200,9624219094265223,543,8676415,6399353,640,6398713
8180,Lee Ju Yong,32,1864900,3837079923105954,202,2833149,2041833,2042,2039791
8181,Kelvin Leerdam,65,1007500,9284631560184480,349,3273279,3012580,30126,2982454
8182,Mateusz Łęgowski,33,1464800,9530038488058409,157,2341873,2047847,2048,2045799
8183,Julian Lelieveld,26,2284600,6860511537689296,190,3249417,1758423,17585,1740838
8184,Nunzio Lella,51,1730000,9638869296318510,283,3632465,428829,0,428829
8185,Tim Lemperle,28,4243700,5499334275565059,327,5925790,3926879,0,3926879
8186,Enzo Leopold,44,481900,9051670975348608,156,1395740,493362,494,492868
8187,Kevin Lewis,29,498600,4669527622505947,83,735694,530133,530133,0
8188,Jonathan Lewis,67,1704000,4089313467112152,409,4346470,1304373,0,1304373
8189,Li Ang,34,3289000,5298125237208579,325,5145973,1586506,15866,1570640
8190,Bryan Limbombe,68,1212800,8243731245659077,392,3912662,2460935,0,2460935
8191,Jaylin Lindsey,40,3301100,6882990525970328,392,5589889,5151208,0,5151208
8192,Evert Linthorst,60,3818400,7740794319583316,533,6866391,4882847,489,4882358
8193,Marcin Listkowski,39,4086500,4851881767980104,397,6074488,2279118,2279118,0
8194,Liu Yang,32,964900,4461551755182636,128,1507584,491408,492,490916
8195,Percy Liza,45,4388000,4430970791976772,474,6647353,2280958,2281,2278677
8196,Ivan Ljubić,60,2279200,3048678074902936,387,4659085,1578859,158,1578701
8197,Lenny Lobato,54,325000,7945282668341187,215,1728356,1589434,1590,1587844
8198,Lobete,30,1256800,5109755878417891,139,1907624,1081318,109,1081209
8199,Niklas Lomb,34,3677300,7641392757704488,378,5523348,738139,738139,0
8200,Enzo Lombardo,46,2510300,9673319336686856,342,4499706,511492,51150,460342
8201,Ryan Longman,31,3240100,9558212461278605,329,5127782,3323623,333,3323290
8202,Nigel Lonwijk,22,348900,6413590319743201,11,43200,26944,2695,24249
8203,Roberto Lopes,24,301900,4770552038325274,11,1384,87,0,87
8204,Fran Manzanara,30,4793800,3009140107288955,444,7191537,1178414,118,1178296
8205,Sayfallah Ltaief,68,3326300,5678946031936174,529,7081421,1640408,164041,1476367
8206,Williams Lugo,67,4727900,8623219053078222,688,9076478,1057056,1058,1055998
8207,Jakub Łukowski,58,774800,7654028420550719,307,2870218,500741,5008,495733
8208,Daniel Luna,57,2353800,3843126204765387,352,4386681,3843599,3843599,0
8209,Julian Faye Lund,49,1476800,7691483258312983,237,2568923,2098998,20990,2078008
8210,Valgeir Lunddal,61,3693600,8369878487401414,561,7272205,1152439,115244,1037195
8211,Adam Lundqvist,45,4054100,3069136598476707,435,6764921,4267589,0,4267589
8212,Rafael Lutiger,26,4840300,8734061196235271,430,7420804,1098826,0,1098826
8213,Thierry Lutonda,70,1199600,3410626487778642,433,4314794,71280,7128,64152
8214,Jay Lynch,27,3235200,3253979612881729,324,5070121,3960472,396048,3564424
8215,Luís Mata,24,3945200,8577046515647719,384,5812769,2533656,253366,2280290
8216,Ignacio Maestro Puch,50,4509800,7385960197132524,548,7891516,7815943,0,7815943
8217,Abdussalam Magashy,52,3652300,4538699654230384,498,7005473,2758387,2758387,0
8218,Sean Maguire,26,3117900,5045527767681427,297,4500000,4484460,4484460,0
8219,Jack Maher,33,4946200,3125776988004275,402,6753891,2881440,28815,2852625
8220,Sebastian Mai,55,1335500,5505525755645651,305,3332343,2690900,269090,2421810
8221,Lars Lukas Mai,65,2421800,9732389027450696,506,5610710,3354591,0,3354591
8222,Christian Makoun,41,4186200,6491855535512020,452,6726834,580159,0,580159
8223,Cebrail Makreckis,69,4672600,5112361722440995,673,9053323,3838070,38381,3799689
8224,Daniel Maldini,57,1416200,5772330786254736,385,3983565,2986075,0,2986075
8225,Joël Mall,50,977000,8818003503712802,247,2370723,1317232,1317232,0
8226,Streli Mamba,22,1410200,7972970863447601,101,1708570,84221,0,84221
8227,Juan Mancín,33,1424200,6628034430311264,173,2097325,925965,926,925039
8228,Roger Manrique,24,1124000,7142321874367750,119,1624783,1379287,0,1379287
8229,Brian Mansilla,66,2783900,7284833246912779,493,6026647,5245143,524515,4720628
8230,César Lobi Manzoki,35,838400,8717105772512784,151,1535385,1077027,107703,969324
8231,JT Marcinkowski,46,770500,9226249873657239,233,2045427,1685475,169,1685306
8232,Jack Marriott,44,2933200,9036169026539321,371,4764306,4662025,4663,4657362
8233,Luca Marseiler,52,4262500,4595355204816848,500,7725350,309886,310,309576
8234,Ronaldo Martínez,53,1635800,7324073379721966,299,3624752,3176194,318,3175876
8235,Miguel Ángel Martínez,40,3808800,7828152621677075,380,5949773,5229895,0,5229895
8236,Fernando Martínez,53,3534300,6533045735880813,428,6136451,3546900,3546900,0
8237,Felipe,47,2608600,6120713166615944,347,4507742,3122156,31222,3090934
8238,Javi Martón,58,1432400,8458461843629096,291,3226548,504115,505,503610
8239,Gaetano Masucci,43,1619700,9004904852795170,279,3265794,753809,753809,0
8240,Alexandru Mățan,61,2655500,3888868599886721,443,5364588,5048114,5049,5043065
8241,Cosmin Matei,43,2730200,6358074250230342,342,4953853,4541855,45419,4496436
8242,Alexandru Mateiu,49,2904600,3566756208581007,356,5070982,590575,590575,0
8243,Marcus Mathisen,42,4089200,7564625528747495,433,6670899,3044928,0,3044928
8244,Anthony Matos,69,2410700,4119403974607993,438,5254561,824251,0,824251
8245,José Mauri,59,1040300,7188738587225108,311,3101353,1226001,0,1226001
8246,Adrian Mazilu,62,4092900,8351072742541926,554,6843398,3087502,3087502,0
8247,Amadou Mbengue,42,4661700,8826882187750606,463,7450529,4003649,0,4003649
8248,John McCarthy,38,4910900,9347813222376307,452,6927258,6899268,68993,6830275
8249,Josh McEachran,37,3883100,7526343128163063,408,5972209,4320395,0,4320395
8250,Yaimar Medina,70,3435600,7013083323473831,590,7383976,1785781,178579,1607202
8251,Joshua Mees,30,3564600,3256993849903373,357,5917956,2644860,2644860,0
8252,Marcel Mehlem,56,3928400,7191610196808379,530,7405867,3338786,0,3338786
8253,Jonathan Meier,31,3342400,8506473456752360,321,4724955,2031772,20318,2011454
8254,Thomas Meißner,23,3246500,7646257342944501,263,4304365,178673,17868,160805
8255,Robin Meißner,26,2836100,3949520810814460,209,3874572,1589996,1589996,0
8256,Tim Melia,30,3333600,8806484117729058,339,5226911,816784,81679,735105
8257,Víctor Mendoza,56,3881800,5144439600222864,471,6473734,1717582,172,1717410
8258,Mehdi Merghem,49,4880200,5953362698650728,545,8512790,7162509,0,7162509
8259,David Miculescu,35,2491300,6424792698590879,238,3594834,2044829,0,2044829
8260,Jorge Mier,41,4319000,9225494095238165,477,6773389,6122387,0,6122387
8261,Javi Mier,62,2002600,7914208569630751,376,4351839,1360272,1361,1358911
8262,Alex Mighten,70,909800,4374067408671449,351,3165809,361997,361997,0
8263,Daniel Mikić,33,1414400,8442549513034238,152,2155518,82543,8255,74288
8264,Juan Millán,28,2471700,5703105427133094,232,3525968,1526554,1527,1525027
8265,Sota Mino,56,2591800,4178765272512952,440,4949527,4393033,4393033,0
8266,Leonardo Rocha,43,1516200,5342827675720524,216,2659793,126121,126121,0
8267,Damon Mirani,24,3107600,3878881925152294,256,4320225,4083820,4084,4079736
8268,Bogdan Mitrea,32,392000,6978957740917733,91,716480,11004,1101,9903
8269,Kevin Molino,26,3504400,8234132913559779,311,5313767,1875238,187524,1687714
8270,Nacho Monsalve,29,1441200,9214597601145119,166,2148275,698066,699,697367
8271,Juan Montenegro,52,972800,6825373061536900,238,2422519,691002,692,690310
8272,Jefferson Montero,40,1187400,9889974708406960,173,2122288,2047083,2047083,0
8273,Lucas Monzón,34,1908600,9152648333102984,223,2989920,1416146,0,1416146
8274,Pol Moreno,36,2396000,7635583242988253,266,3734031,2499689,2499689,0
8275,Dani Morer,66,3170000,6409413090803571,562,6516463,5594502,0,5594502
8276,Leandro Morgalla,31,3335500,5566353794406520,355,5399034,2110384,2111,2108273
8277,Nicolás Morgantini,68,2123600,8728391246854892,402,4932100,564729,5648,559081
8278,Aaron Morley,55,2732400,5581903250113590,411,5624722,1334777,134,1334643
8279,Raúl Moro,58,4793300,9259628873769157,581,8448524,7439376,743938,6695438
8280,Ravel Morrison,23,354000,8527972067647107,22,139871,107442,1075,106367
8281,Ariel Mosór,39,1733800,3546116844798793,262,3306647,929237,9293,919944
8282,Fabián Mosquera,34,2697000,3025851989510700,276,4069993,2355278,23553,2331725
8283,Juan David Mosquera,64,3303200,9653165158762789,495,6320121,2762173,2763,2759410
8284,Aimen Moueffek,63,4360200,5046074480534658,618,8364901,4127992,0,4127992
8285,Jonathan Moya,48,4632900,8271893790165322,492,7368766,7334598,734,7333864
8286,Lionel Mpasi,65,3890400,9006787916630737,517,7229156,6152326,615233,5537093
8287,Ernest Muçi,27,4105700,6097366911135825,366,5899577,3854947,0,3854947
8288,Arbnor Mucolli,31,3707000,5991890457713407,345,5627805,5625065,0,5625065
8289,Erwin Mulder,35,4724300,9288037955922814,471,8005325,3425318,3425318,0
8290,Rodrigo Muñoz,51,1848200,9691129410739251,296,3678278,1453558,14536,1439022
8291,Luis Muñoz,50,2670500,3124476328766660,349,4855384,2874041,0,2874041
8292,David Murillo,32,315300,7354865233254754,67,488203,70276,0,70276
8293,Derry John Murkin,58,3497600,4212805046635848,498,6611330,2611618,0,2611618
8294,Anthony Musaba,64,752600,8177661394683820,294,2452136,1660704,167,1660537
8295,Benito,40,486500,9406237279438474,134,1193278,678593,678593,0
8296,Alex Muyl,54,569500,6480598415400266,234,2093433,1123073,1124,1121949
8297,Tristan Muyumba,64,4003700,3452222444192120,612,8240447,3467497,0,3467497
8298,Moussa N'Diaye,31,2911500,7645557095990108,278,4462591,291009,29101,261908
8299,Andrew Nabbout,41,3759900,4080373110515572,428,6631078,6012229,60123,5952106
8300,Yuta Nakayama,70,4790200,4767960966137329,673,8744910,7790349,77904,7712445
8301,Adi Nalić,55,625600,6969396091461235,305,2761811,1097293,1097293,0
8302,Gonzalo Nápoli,28,1785800,3898571465537179,181,2703429,203321,204,203117
8303,Gian Nardelli,52,4055200,6629669747446349,522,7578043,7536404,753641,6782763
8304,Ivan Näsberg,37,2342500,9240013684258361,326,4325244,2429540,2429540,0
8305,Álvaro Navarro,50,2714200,6367752504276920,363,4861447,3115076,31151,3083925
8306,Julián Navas,24,364800,8783006179849592,39,274596,200134,201,199933
8307,Basilio Ndong,46,1497300,7764651629463961,274,3096165,495998,0,495998
8308,Alioune Ndour,55,4978400,8440625089358381,600,8122501,4558583,4559,4554024
8309,Ionuț Neagu,59,3290900,9357888118111516,461,5788471,1561517,1562,1559955
8310,John Nelson,62,1576300,5333726671969707,399,4494596,2636086,0,2636086
8311,Jayden Nelson,39,1426000,8966475545024854,215,2739325,2603737,2603737,0
8312,Jakob Nerwinski,29,594800,5467978744804904,66,680844,230749,0,230749
8313,Ruslan Neshcheret,44,4790100,5464671007907226,566,8234489,2554456,255446,2299010
8314,Maurice Neubauer,67,3030200,5377672940416243,521,6246873,5366892,5366892,0
8315,João Virgínia,61,1773800,3391744794261425,333,3761544,2450085,246,2449839
8316,Babacar Niasse,66,1972300,8336185709498806,425,4853669,1964275,196428,1767847
8317,Byron Nieto,54,656800,8318316841412785,218,1914985,1105310,111,1105199
8318,Miloš Ninković,32,1995400,8936447475349097,247,3124891,1370459,1371,1369088
8319,Nikoloz Ninua,30,1347400,9142612870185857,160,2020293,1005472,1005472,0
8320,Josh Nisbet,47,1820000,8495758102349513,327,3562908,2746703,2746703,0
8321,Alexander Nollenberger,29,4006200,4210961338769121,373,6404774,2622551,262256,2360295
8322,Ollie Norburn,46,3540800,4715966813791577,486,6818384,6192667,6193,6186474
8323,Osnar Noronha,39,3035000,6481492762416414,316,5078480,2116323,0,2116323
8324,Brooke Norton-Cuffy,24,3110300,4156765752867232,239,4098575,573597,0,573597
8325,Tijjani Noslin,60,4362700,8034481965154436,558,8225451,1013832,101384,912448
8326,Toto Nsiala,51,3338300,9442530869082496,434,5840460,439493,43950,395543
8327,Abdul Manaf Nurudeen,42,556600,7244206111407359,157,1327304,599661,0,599661
8328,Antonio Nusa,49,3705000,7704970948229317,441,5928255,1728183,1729,1726454
8329,Benjamin Nygren,32,3839100,9467209090028928,377,5895192,4687895,469,4687426
8330,Jake O'Brien,60,3286300,7117241758404740,475,6754502,4021705,4021705,0
8331,Warren O'Hora,50,3625100,4528809848768135,439,6576288,1394449,140,1394309
8332,Daniel O'Shaughnessy,41,4140200,3404731046657344,444,6492304,4539483,45395,4494088
8333,Johann Obiang,55,2309300,8312210833054931,358,4117897,718919,0,718919
8334,Jordan Obita,24,1130400,8127919813862789,117,1562867,1000136,1001,999135
8335,Hakeem Odoffin,54,774200,3357345968901971,274,2475717,217037,21704,195333
8336,Mohamed Ofkir,64,2153300,6434811401804954,437,4999782,4925758,0,4925758
8337,Ebenezer Ofori,64,712700,8020390421227333,326,2982100,448716,449,448267
8338,Nathanael Ogbeta,46,4530400,5087920759638166,497,7128309,4784950,478495,4306455
8339,Agustín Ojeda,39,2857500,4176049946636249,308,4713686,3524651,3524651,0
8340,Angel Ojeda,59,1823100,4950411289600678,387,4488937,3199657,3199657,0
8341,Bryan Okoh,23,4885600,6377778220378539,451,7741834,5495007,0,5495007
8342,Arthur Okonkwo,54,4455900,6997741082096790,560,8506742,4322003,433,4321570
8343,Mathias Olesen,46,2064100,4543702847167283,321,3687925,921076,92108,828968
8344,Hélder Sá,33,4750500,7446236150563111,504,7798628,881713,8818,872895
8345,Gonçalo Silva,64,3421700,7811781017421940,499,6615895,1429639,1429639,0
8346,Marcus Olsson,33,2843000,8412422035480612,245,4017659,3343232,334324,3008908
8347,Răzvan Onea,70,896400,5800503051140970,389,3303129,3287070,0,3287070
8348,Nicholas Opoku,44,1937300,7002659045384606,268,3566941,1795409,17955,1777454
8349,Joel Ordoñez,56,1740100,3893859933708339,342,3706132,3050742,0,3050742
8350,Roberto Ordóñez,25,3021600,5381116696503549,242,4260565,4246365,42464,4203901
8351,Charlis Ortiz,35,2215200,3744335073966728,287,3756312,1369628,136963,1232665
8352,Peter Ouaneh,24,3944500,9825866701937009,382,5973584,5710078,0,5710078
8353,Aziz Ouattara,66,1299400,3789601086304713,410,3738324,1170458,118,1170340
8354,Shady Oukhadda,24,1740800,4983920852940367,168,2574208,754303,0,754303
8355,Alpaslan Öztürk,40,1231300,9022740466185139,170,2041371,1514966,152,1514814
8356,Marlon Pack,54,3659700,8092762995177586,526,6541235,3617450,36175,3581275
8357,Manuel Palacios,45,2061300,7192712474359041,295,3863306,519072,520,518552
8358,Cole Palmer,48,377200,6691617276361543,194,1454857,556947,556947,0
8359,Radovan Pankov,60,966700,3294180048945665,292,2989756,669113,66912,602201
8360,Alexandru Pantea,47,2987700,7810222891169359,356,5273813,4422627,0,4422627
8361,Sotirios Papagiannopoulos,48,950600,8903690804416582,242,2363674,2339213,23393,2315820
8362,Joaquín Papaleo,35,1379000,4008103486043589,215,2412764,1322437,133,1322304
8363,Jayson Papeau,50,1960800,5833807374661961,309,3728712,2233316,2233316,0
8364,Merveille Papela,25,3033700,4823149049061994,218,3968540,486460,0,486460
8365,Park Soo Il,36,2317100,5688237032994390,258,3744031,637734,0,637734
8366,Álex Pastor,51,1684500,4461746826354729,302,3763293,2221042,0,2221042
8367,Nicola Pavan,35,1947400,9352159885976313,203,3109481,2699430,2699430,0
8368,Nehuén Paz,23,2856400,4859505669046694,237,3881311,1376261,1377,1374884
8369,Daouda Peeters,33,1463100,7651898186172013,188,2406685,1420454,143,1420311
8370,Mauro Peinipil,23,4144600,8703475229938125,302,5729294,4989666,4989666,0
8371,Théo Pellenard,29,986500,6681070166300628,142,1628128,1297842,129785,1168057
8372,Lee Peltier,43,2534400,3918570739930125,374,4795612,2154794,216,2154578
8373,Philipp Pentke,29,1853800,3111926854923801,175,2413299,2240508,2241,2238267
8374,Pietro Perdichizzi,61,2216800,7950917913178743,434,5029323,787677,78768,708909
8375,Andrés Perea,45,4278900,5684602352636225,513,7534624,1353467,13535,1339932
8376,Luis Perea,68,1698100,4568011865681891,427,4287747,3920107,3921,3916186
8377,Daniel Pereira,68,2488900,7529581275385536,472,5598545,4465862,0,4465862
8378,Panutche Camará,44,381400,7995101249091903,167,1220709,975028,9751,965277
8379,Matheus Pereira,35,4745600,6623269518696358,482,8071516,3772476,0,3772476
8380,João Queirós,59,3674000,3706934059949062,542,6950934,2780090,278009,2502081
8381,Nuno Reis,49,3973900,7747482701681626,450,6765049,2212548,2212548,0
8382,Rodrigo Pérez,28,2615700,4472413041306535,246,3768772,3286403,329,3286074
8383,Kevin Pérez,50,3402300,5020197744907175,408,5723046,3459300,3460,3455840
8384,Maximiliano Perg,37,3690700,5765513371236575,380,5788754,2208797,2208797,0
8385,Manuel Pfeifer,42,4647800,8057248717355332,515,7621128,2559660,256,2559404
8386,Romain Philippoteaux,49,2981900,9432832340298010,387,5361948,5224189,0,5224189
8387,Killian Phillips,56,1883500,6699605531790507,296,3580866,751781,752,751029
8388,Carl Piergianni,36,2862200,3691672371211200,337,4963088,2273388,0,2273388
8389,Kik Pierie,64,3701500,3825918866434644,513,6671897,4733681,0,4733681
8390,Shaquille Pinas,36,3509900,5333790905535657,325,5199602,1427571,1428,1426143
8391,Lenny Pintor,44,3266900,6875187785259409,413,5771272,4669058,46691,4622367
8392,Lucas Pirard,23,1894100,5568295182846096,145,2465687,2433521,2434,2431087
8393,Alexi Pitu,58,920800,7160689500442446,264,2691275,1462519,146252,1316267
8394,Júnior Pius,38,835300,9147123974114299,167,1667020,763266,764,762502
8395,Semuel Pizzignacco,68,1355100,9637628238817106,416,4262972,441137,0,441137
8396,Thomas Pledl,40,4829000,3757648080730668,473,7745702,206910,0,206910
8397,Ole Pohlmann,54,3820200,3190676824034629,454,6650551,1058100,1059,1057041
8398,Ernest Poku,24,2978700,4314713273772660,279,4570938,3835008,383501,3451507
8399,Robert Popa,43,396500,8307246788846755,141,1172487,1150219,116,1150103
8400,Laurențiu Popescu,62,2397100,3117055588231166,428,5289117,23703,0,23703
8401,Ovidiu Popescu,58,3312000,4077978692280107,461,5953263,2431961,243197,2188764
8402,Alvas Powell,31,3852300,9206261748001142,332,5538428,3153274,0,3153274
8403,Mateusz Praszelik,36,1610000,9632872704480216,185,2634271,1678772,168,1678604
8404,Nik Prelec,67,3972000,3179283841930308,549,7249882,1096681,0,1096681
8405,Christophe Psyché,36,2902800,8656040932087010,330,4776903,1919695,1920,1917775
8406,Miguel Puche,70,3519800,5562381096320500,550,6980216,2211971,221198,1990773
8407,Afimico Pululu,53,3841600,9023950658321996,421,5717877,5493460,549346,4944114
8408,Qian Jiegei,42,4544600,9134919196364842,468,7392201,2511483,2512,2508971
8409,Giacomo Quagliata,44,3251900,3617423746850274,403,5335877,2522039,252204,2269835
8410,Daniel Queipo,25,2446900,4445943199020035,213,3368023,738239,0,738239
8411,Diogo Queirós,31,3714100,3771776173777289,367,6184008,132665,0,132665
8412,Yuber Quiñones,25,495700,7743854153181095,60,560763,245395,2454,242941
8413,Wilson Quiñónez,54,669700,7825258081335044,282,2484736,1564310,1564310,0
8414,Yeferson Quintana,38,1094100,7917467793498752,173,2048904,1312664,13127,1299537
8415,Joel Quintero,58,4871500,5066671063215826,574,7849145,1546335,15464,1530871
8416,Franco Quinteros,30,1185100,8777150618440040,114,1487604,336035,33604,302431
8417,Aarón Quirós,66,4445200,8078712566942401,555,7575124,6739312,6740,6732572
8418,Sean Raggett,43,3018300,5381399905638562,368,5462790,1361515,1361515,0
8419,Marko Raguž,26,2028000,6129913395058457,227,3324083,1050919,105092,945827
8420,Michał Rakoczy,69,1256900,7314928580993120,405,3870309,3662366,36624,3625742
8421,Rubén Ramírez,34,2937800,3015854764837846,288,4573481,3370657,3371,3367286
8422,Adam Randell,70,4445300,6622419854038043,600,8099090,6624483,0,6624483
8423,Cornel Râpă,49,781900,3314421183889203,228,2194003,370942,371,370571
8424,Damian Rasak,28,509200,3288762095235820,77,730390,92067,92067,0
8425,Christiaan Ravych,67,2061300,6371229952131942,411,4977217,3976274,397628,3578646
8426,Djorkaeff Reasco,46,2730900,9180117864494510,346,4444695,3492558,34926,3457632
8427,Youri Regeer,48,3932400,9073701300769342,512,7701195,6779837,0,6779837
8428,Edisson Restrepo,64,1669900,8578022933541714,386,4126436,3549019,3550,3545469
8429,Taylor Richards,35,3674600,9596364647926834,391,5931660,100027,1001,99026
8430,Tim Rieder,48,2772200,8902300340498464,408,5200785,4377781,4378,4373403
8431,Søren Rieks,42,4527400,3231553739266075,480,7853227,5662973,567,5662406
8432,Connor Ripley,51,2137100,6223447219751848,350,4005214,601206,601206,0
8433,Roope Riski,67,3743600,3726065464825237,528,7256852,2932613,294,2932319
8434,Lars Ritzka,27,2930000,7577975077574072,270,4376039,2194414,2195,2192219
8435,José Rivera,59,4998400,7113560280472966,578,8580039,440101,0,440101
8436,Daniel Rivillo,54,4033700,4687709407594691,547,7889351,1698631,1698631,0
8437,Matías Rocha,67,865200,6718910497883170,334,3059734,559199,0,559199
8438,Ribair Rodríguez,40,3139900,3981312877902884,372,4872896,2884566,2885,2881681
8439,Axel Rodríguez,46,3038400,8141372782466778,345,5262911,2298165,229817,2068348
8440,Ignacio Rodríguez,46,2991100,5399740969538327,439,5562678,171658,172,171486
8441,Gastón Rodríguez,36,3562900,6017735393566712,380,6191057,3814663,0,3814663
8442,Pablo Rodríguez,68,2822100,4278980993360621,571,6678357,6669955,0,6669955
8443,Rayco,49,1440400,8570827031503822,312,3598437,716549,717,715832
8444,Víctor Rodríguez,46,4660300,5495814994627609,511,7819757,4711977,0,4711977
8445,Miguel Rodríguez,24,904900,8111215585631662,83,1123503,333011,3331,329680
8446,Samuel Rogers,36,4917100,6615991675669727,455,7446058,5307790,0,5307790
8447,Filip Rogić,44,4233000,3052988900640259,528,6915057,2493860,0,2493860
8448,Ante Roguljić,39,4189600,6200363723852436,436,7111065,1210784,0,1210784
8449,Daniel Rojas,30,1632600,6613931991937970,220,2911636,1194346,119435,1074911
8450,Juan Diego Rojas,40,4528500,9868172104611715,513,7147535,6320640,63207,6257433
8451,Ole Romeny,60,4360400,7692022284287458,579,8139182,4778694,47787,4730907
8452,Ruben Roosken,61,2994600,3318188057943626,483,5988145,2741551,2742,2738809
8453,Siro Rosane,54,2386900,3581148823938409,341,4751371,1427930,0,1427930
8454,Guille Rosas,43,4332300,5579921055640520,491,7570139,6393455,63935,6329520
8455,Max Rosenfelder,50,1061800,6901602569820023,270,2684457,2615413,261542,2353871
8456,Mathias Ross,29,1880100,7989194157450883,215,3069117,517928,517928,0
8457,Matheus Rossetto,68,2857700,5141298785496362,503,5987408,879095,879095,0
8458,Leândro,50,4182900,5807448975848346,520,7140777,3504849,3504849,0
8459,Alexander Rossipal,28,2450700,6201127545003623,251,3939095,497533,0,497533
8460,Baptiste Roux,23,1345700,5167271970799366,107,1612330,1101592,11016,1090576
8461,Jonathan Rowe,70,3250700,4784016838280573,553,6950300,6087403,60875,6026528
8462,Pirulo,41,1103000,6482708738993769,207,2284238,2180874,218088,1962786
8463,Jesús Ruiz,40,3920700,4133566969870871,470,6654299,2667419,2668,2664751
8464,Milan Rundić,43,1993800,3742430841689377,303,3711835,1256170,126,1256044
8465,Elias Saad,59,2756100,4230699350240773,441,5251453,643930,644,643286
8466,Alexis Sabella,55,4537100,8560204088544575,571,8436681,5773880,0,5773880
8467,Noah Sadaoui,44,2621600,5961087058459629,367,4912874,4777825,477783,4300042
8468,Görkem Sağlam,32,2972000,8361526841536739,310,4530959,1486321,149,1486172
8469,Semih Sahin,35,4233700,5474425252904347,437,7237020,1364453,137,1364316
8470,Raphael Sallinger,28,3754200,8119577958839981,371,5586463,2471686,24717,2446969
8471,Cris Salvador,36,743900,5421843350590705,164,1617212,238291,238291,0
8472,Lars-Jørgen Salvesen,27,3785100,4340944431489966,372,5843308,4875460,48755,4826705
8473,San Román,66,3464500,6046603348956577,515,7077813,2115096,2115096,0
8474,Tobias Sana,41,3543000,6224008450244678,357,5339166,17090,17090,0
8475,Alvyn Sanches,25,843100,7880769718240502,102,1120401,544852,0,544852
8476,Erwin Junior Sánchez,22,2350100,5971570301882324,187,2971492,892061,892061,0
8477,Diego Sánchez,43,1111200,6300654975188882,203,2072206,857399,0,857399
8478,Simon Sandberg,32,4901800,9413864775802533,443,7585625,6258314,6258314,0
8479,Marco Sangalli,48,1581300,3684221564512568,296,3568954,1417338,1417338,0
8480,Pedro Amador,30,1694800,7568793015385662,178,2464945,1137859,1137859,0
8481,Vinko Sapina,25,3820700,6923279779070196,355,5973498,5220877,0,5220877
8482,CJ Sapong,58,3002500,8559788607561280,484,6003014,4011981,402,4011579
8483,Marco Saravia,52,2968700,4539807359894315,433,6063722,262922,263,262659
8484,Killian Sardella,48,2954100,3854173881849315,399,5343701,1328239,0,1328239
8485,Mamadou Sarr,63,2093200,5802357528159067,420,5149395,1221867,1221867,0
8486,Alexis Sauvage,51,3662800,8486465840993746,438,5711919,3850030,0,3850030
8487,Gökhan Sazdağı,44,1426400,8234010878483441,243,2836423,257982,0,257982
8488,Liam Scales,61,3653700,4034550136370395,513,6735331,4031530,0,4031530
8489,Jasper Schendelaar,47,1292600,8530468394362159,240,2633801,832244,83225,749019
8490,Giancarlo Schiavone,44,2859600,3000889643583330,337,5015182,1698098,0,1698098
8491,Raphael Schifferl,62,2694600,6451722352793487,456,5547905,3654540,3655,3650885
8492,Patrick Schmidt,48,2486200,7504745811284110,394,4561457,987168,0,987168
8493,Augusto Schott,56,1380000,9068985718460114,350,3605889,1091635,1091635,0
8494,Tobias Schröck,46,2479800,7098427642032068,351,4705415,2047499,2048,2045451
8495,Morris Schröter,40,3090300,8913740061874081,365,5045804,573379,573379,0
8496,Luca Schuler,61,1896600,8696029070870326,429,4891598,4651527,0,4651527
8497,Patrick Schulte,68,1935700,6361105716531816,467,5239404,3121136,0,3121136
8498,Michael Schultz,37,1526300,3888248205970266,227,2814923,1361846,137,1361709
8499,Markus Schwabl,45,4194200,4646667803953009,488,6916777,1400972,141,1400831
8500,Petr Schwarz,52,4540000,8206428755624299,503,7254738,313168,31317,281851
8501,Iker Seguín,70,4466400,6709904815113750,571,7794647,7139722,713973,6425749
8502,Matthias Seidl,43,2208600,3774344734109684,299,4052918,583547,583547,0
8503,Václav Sejk,68,2200500,6601519689832328,480,5259254,3415950,3415950,0
8504,Batuhan Şen,30,3826400,8725331689481260,340,5558211,2309024,23091,2285933
8505,Seo Young Jae,33,3897200,4450502945199555,419,6172654,6152986,616,6152370
8506,Cemali Sertel,30,2647400,3142850132594042,262,4082098,1590258,159026,1431232
8507,Nicolás Servetto,47,3635600,7870856408460647,427,6420621,1112984,0,1112984
8508,Yoan Severin,52,4754700,6458940848438532,588,9185073,5977784,5978,5971806
8509,Jacob Shaffelburg,65,703700,4316587283046202,297,2685745,752666,75267,677399
8510,Liam Shaw,68,4573100,3952324338421643,652,8985974,8040667,8040667,0
8511,Jordan Shipley,36,1672000,6296837041523330,235,2808027,2493488,2494,2490994
8512,Nicklas Shipnoski,51,2164500,6756316643036855,362,4491340,334095,3341,330754
8513,Ilya Shkurin,45,537000,9919919916379571,221,1994176,64932,0,64932
8514,Raz Shlomo,69,2622500,8887167958235535,507,6038000,1811673,181168,1630505
8515,Armindo Sieb,56,1782100,9214570424454513,368,4139173,4026404,4027,4022377
8516,Nicholas Siega,58,567100,5793774613426507,250,2124202,1087476,1087476,0
8517,Rúnar Már Sigurjónsson,54,2667200,4890200136561786,404,5035064,3459010,3460,3455550
8518,Miguel Silva,40,4893300,4114013360805828,549,7589181,5346065,5346065,0
8519,Denis Simani,50,3775300,4286467576005760,423,6211008,3825319,382532,3442787
8520,Scott Sinclair,33,3761500,4579843323097928,362,5596941,3934591,394,3934197
8521,José Luis Sinisterra,57,4337700,7689319023972730,485,7036673,2570972,25710,2545262
8522,Olaus Jair Skarsem,24,3795200,3305502179107643,288,5218980,1753174,1753174,0
8523,Ari Skúlason,39,4603800,7564400157626029,467,7220024,4438863,443887,3994976
8524,Naatan Skyttä,56,1221100,3456977157404486,293,3071355,248340,248340,0
8525,Gabriel Slonina,31,2928600,8373847525953804,268,4647221,2133867,214,2133653
8526,Korey Smith,40,2395200,9397363838703483,293,4323353,579630,57963,521667
8527,Sam Smith,59,2565100,9879285480613157,377,4764726,4492296,44923,4447373
8528,Kyle Smith,32,3597100,4497630722367338,353,5663572,1634378,16344,1618034
8529,Franco Soldano,36,4197400,9687757152000582,383,6666769,2938582,294,2938288
8530,Edoardo Soleri,22,4322600,9724353183182811,374,5897778,157430,0,157430
8531,Matteo Solini,35,626000,6880863306638716,121,1144970,119501,1196,118305
8532,Adam Sørensen,53,2454600,6395266892481033,411,4897850,1295006,130,1294876
8533,Joaquín Sosa,44,735200,8362860875686784,162,1664642,377717,0,377717
8534,Sambou Soumano,42,2886100,7866871508432482,345,5034952,3362932,0,3362932
8535,Luke Southwood,30,948800,8050429951941624,125,1456031,188088,1881,186207
8536,Lucas Souto,26,1864300,6583526487466146,206,2704094,2206328,0,2206328
8537,Gianni Stensness,59,3979800,4562195643178613,598,7514228,7083772,708378,6375394
8538,Patryk Stępiński,24,1258100,3243150857581049,140,1771131,983333,984,982349
8539,Basil Stillhart,62,824800,9868461269400563,290,2549671,1877221,18773,1858448
8540,Dejan Stojanović,67,4358400,7810590288389354,595,8195438,5438353,54384,5383969
8541,Finn Stokkers,70,727800,8670225319199531,344,3006597,1918442,191845,1726597
8542,Petter Strand,30,4972800,8968640684607496,424,7460171,1195610,119561,1076049
8543,John-Patrick Strauß,35,3679200,9287147505389381,390,5608045,718587,71859,646728
8544,Jared Stroud,59,4499700,7057950450500709,538,7734993,2011226,2011226,0
8545,Nikola Štulić,48,3947300,5172848240565958,473,6944796,2373726,0,2373726
8546,Yeison Suárez,67,2776500,5519094391069931,476,5990812,4151959,415196,3736763
8547,Anssi Suhonen,55,2323400,8426652388058545,382,4494318,3884216,388422,3495794
8548,Toichi Suzuki,64,827900,7268849858718502,323,2830105,764714,76472,688242
8549,Svensson,37,3125200,8828766764780832,337,4867106,1989896,1990,1987906
8550,Habib Sylla,52,3183700,4942208443902442,464,6097992,4350954,436,4350518
8551,Eddy Sylvestre,29,2218500,7640419174884762,238,3616526,1814584,18146,1796438
8552,Michał Szromnik,50,631900,5677101494732272,235,2201187,1113543,1113543,0
8553,Jakub Szumski,65,3829800,4618905440268114,628,8476819,7642353,0,7642353
8554,Filip Szymczak,64,1766800,6535055521584239,372,4283792,765886,7659,758227
8555,Edvard Sandvik Tagseth,23,1835300,3052981794185224,148,2505161,1350077,135008,1215069
8556,Tang Xin,55,4813100,9246239872775689,586,8665842,7432387,7432387,0
8557,Dylan Tavares,37,3451000,8645151761946304,381,5484582,3357249,0,3357249
8558,Duplexe Tchamba,61,636600,5039721976903312,312,2831232,1883981,1884,1882097
8559,Loum Tchaouna,63,2192100,3569496513355495,424,4966334,247018,0,247018
8560,Allan Tchaptchet,22,970100,6181189237365911,64,1015794,483415,0,483415
8561,Tonio Teklić,68,1466800,5949800463319248,398,3805973,3749521,374953,3374568
8562,Miro Tenho,57,2599600,7321986460259133,390,5281953,2099848,0,2099848
8563,Niclas Thiede,54,700300,7038563317056583,251,2090521,1307510,130751,1176759
8564,Yannick Thoelen,69,2414000,7618363080936671,471,5250669,2868170,2868170,0
8565,Nigel Thomas,46,4442800,3591041664058545,453,7100633,5270277,5270277,0
8566,Stefán Teitur Thórdarson,56,3216600,9275074422689089,442,6124204,4971656,0,4971656
8567,Angus Thurgate,42,3798800,5433559931585921,426,5819494,3775963,37760,3738203
8568,Alex Timossi Andersson,31,1521300,9564116790929319,169,2224621,1347700,0,1347700
8569,Simy,45,2778200,5181322302296825,343,4598974,3639030,364,3638666
8570,Agustín Toledo,25,4855200,3644181117685876,414,7062839,257743,25775,231968
8571,Grzegorz Tomasiewicz,31,2595200,4200134141435080,273,4088545,3106803,0,3106803
8572,Silvio Torales,35,2063200,7797600160346911,247,3494335,3375988,3376,3372612
8573,Claudio Torrejón,38,3580300,4544054442189695,367,6028073,4137194,0,4137194
8574,Saúl Torres,53,2700300,7560407563088145,422,5378425,2372705,2372705,0
8575,Jairo Torres,69,2930600,4978938745767742,518,6250631,4664927,0,4664927
8576,Hussayn Touati,69,2683600,4344644845411907,513,6006255,1964084,19641,1944443
8577,Omar Haktab Traoré,52,618500,8770392037680720,196,1738493,753495,7535,745960
8578,Borislav Tsonev,70,1413700,9595756892706011,400,4132196,3089127,3090,3086037
8579,Blair Turgott,56,1572900,6607812492317448,269,3282229,881240,88124,793116
8580,Przemysław Tytoń,49,2693700,4491658208228275,373,4814714,139794,1398,138396
8581,Oscar Uddenäs,51,2672000,7313096067400142,403,5200520,406219,406219,0
8582,Daniel Udoh,45,773700,3610670298470392,209,1961042,1700411,1701,1698710
8583,Jonas Urbig,22,4510800,3691000589317920,368,6158477,1030798,1030798,0
8584,Maximiliano Urruti,65,3013800,8417880263205041,469,6060471,2428587,24286,2404301
8585,Edgaras Utkus,53,4037200,7304861070538872,522,7171656,752444,75245,677199
8586,Jérémy Vachoux,49,2219600,3991626121189764,343,4282766,2637650,0,2637650
8587,Octavian Vâlceanu,51,2889400,7586331179906510,413,5206242,3538550,0,3538550
8588,Hakon Valdimarsson,66,3714200,5953444478214765,570,7614088,2815748,2815748,0
8589,Kener Valencia,65,1353800,4447772257098372,315,3210193,1549497,155,1549342
8590,Joaquín Valiente,40,476200,3988694374722780,136,1077894,232623,232623,0
8591,Borja Valle,54,3187600,3513635567439652,457,6179454,3548276,35483,3512793
8592,Hugo Vallejo,54,351600,5341307191910265,218,1693764,490557,0,490557
8593,Dario Van den Buijs,64,1959100,9488908572280861,392,4318324,1701006,0,1701006
8594,Jasper van der Werff,43,4406300,4147534338507468,445,6801448,4418610,441861,3976749
8595,Alec Van Hoorenbeeck,57,4794200,9087799448741547,533,7634849,246356,24636,221720
8596,Rajiv van La Parra,54,3485900,5601220261803218,444,6358525,1537267,154,1537113
8597,Yoëll van Nieff,25,375600,9343607912763220,40,294051,11025,0,11025
8598,Éric Vandenabeele,26,3020500,8939378411221281,297,4667283,38219,0,38219
8599,Lisandro Semedo,40,3927900,9009319337776210,476,6517273,4234554,4235,4230319
8600,Ricardinho,35,2759600,5083663425139579,300,4180836,2490105,249011,2241094
8601,Vaso Vasić,68,926300,3258410361773465,311,3094723,2628946,0,2628946
8602,Víctor Vázquez,53,3837600,3784368437606234,490,7190045,5309893,530990,4778903
8603,Edison Vega,31,1071800,5336277451761760,158,1909138,554008,555,553453
8604,Marcelo Lopes,22,3786300,3813225420847722,306,5457095,3081989,0,3081989
8605,Josh Vela,36,1358500,5849945375866464,180,2068576,1874212,18743,1855469
8606,Odysseus Velanas,41,4003500,7194114189290681,423,6207446,3380000,338,3379662
8607,Diego Vera,64,3092700,8216710043283705,493,6256088,5976007,5977,5970030
8608,Nikolas Veratschnig,41,1908700,5146655140062725,250,3337752,2484814,24849,2459965
8609,Davino Verhulst,29,576700,9947276856407706,76,740888,724786,7248,717538
8610,Luca Verna,37,1792900,7220305432044353,249,3225085,2837786,283779,2554007
8611,Frédéric Veseli,40,3199800,6031778066198858,358,5201013,632617,6327,626290
8612,Viljar Helland Vevatne,48,4327600,6580812540163060,481,6770222,5590667,5590667,0
8613,Josh Vickers,66,4335200,3925935101626057,544,8112123,5705637,570564,5135073
8614,Luca Vido,56,777400,5633205456231412,224,2012053,557014,0,557014
8615,Gabriel Vidović,55,4347900,3758553238596491,524,7386572,2759263,27593,2731670
8616,Luís Machado,68,495100,4080180398565324,333,2625392,1626573,16266,1610307
8617,Andrés Vilches,40,884900,9029491230092521,167,1656465,1215807,122,1215685
8618,Oscar Vilhelmsson,60,3683300,7403443236479753,553,7720467,330976,3310,327666
8619,Christophe Vincent,26,4703800,9372248201851876,389,6928519,5525867,0,5525867
8620,Kévin Vinetot,64,3580300,4221401608274568,503,7039284,3492319,3493,3488826
8621,Ștefan Vlădoiu,39,4324700,3032266912511305,461,6899266,6761820,0,6761820
8622,Ben Voll,39,4952900,7489571752139658,546,7641215,1305060,1306,1303754
8623,Ilija Vukotić,62,1718700,9852448385981705,361,3631082,475035,0,475035
8624,Danny Vukovic,53,3795200,7987956681630360,530,7566762,1088868,10889,1077979
8625,Ali Şaşal Vural,48,4323800,9752567822452627,474,7028540,6437142,64372,6372770
8626,Ibrahima Wadji,52,4631800,6410279157954303,555,8003803,294247,0,294247
8627,Robert Wagner,53,2027500,8937063925650671,338,3957233,415344,415344,0
8628,Lachlan Wales,31,537500,6568249560812069,86,755058,243656,243656,0
8629,Wang Jinxian,70,1237200,7450959647534804,402,3805470,2773520,278,2773242
8630,Wang Shenchao,22,2186200,9010164374904149,192,3076778,2797752,2797752,0
8631,Wang Tong,45,3472700,9712990984732872,430,6173959,3139582,3139582,0
8632,Conor Washington,44,2799200,6186014008143346,369,5292814,246462,0,246462
8633,Elliot Watt,57,691500,5365590053268694,287,2342320,85701,0,85701
8634,Mateusz Wdowiak,52,4544100,3392993831007702,526,8238144,3467837,347,3467490
8635,Marcel Wędrychowski,32,2391600,9338632854118781,238,3551446,3293257,330,3292927
8636,Leo Weinkauf,35,3106200,6529752236521274,343,5064021,2515664,2515664,0
8637,Nelson Weiper,68,3627900,5483517614752651,556,6859160,2159576,0,2159576
8638,Jensen Weir,69,634700,8639680870995195,284,2501751,2285471,2286,2283185
8639,Morgan Whittaker,57,3713500,8253221501649744,533,7216198,4482486,0,4482486
8640,Danilo Wiebe,24,4641900,5962798433550642,422,7277810,3436452,34365,3402087
8641,Kamil Wilczek,40,4759300,5988382089228649,496,7639795,6210026,622,6209404
8642,Mallik Wilks,50,4069500,4449761322433009,540,7322782,33998,33998,0
8643,Paul Will,45,2552800,5302525134808025,367,4617213,1957199,196,1957003
8644,Derrick Williams,64,1953800,6102774306962533,438,4542651,729280,0,729280
8645,Josh Williams,28,3268100,9633100133664655,315,4927264,1955520,1955520,0
8646,Kane Wilson,49,1737300,9373072122419805,260,3151175,1504316,0,1504316
8647,Bobby Wood,24,1642800,8860330253495012,160,2405799,1808820,180882,1627938
8648,Richard Wood,30,4028500,9364628764780446,375,6439556,2756584,0,2756584
8649,Ben Woodburn,63,1657900,6239934554148423,341,3832950,1995121,200,1994921
8650,Lucas Woudenberg,70,3488900,3816229078008920,529,6686534,4248543,4249,4244294
8651,Callum Wright,42,3828300,3637377645253749,382,6137960,732238,7323,724915
8652,Matthéo Xantippe,44,1081900,7212863981603846,218,2318631,160270,161,160109
8653,Pape Ndiaga Yade,35,1503700,3681663673224441,191,2385980,166427,16643,149784
8654,Zeki Yavru,65,3623900,4736932171029740,538,6935856,959534,959534,0
8655,Dru Yearwood,34,4895800,4380254797563422,539,8037271,7122418,7123,7115295
8656,Yaw Yeboah,24,1305200,3832603567014630,98,1503676,259232,259232,0
8657,Emmanuel Yeboah,37,2449400,7454503290129831,257,4014600,2267040,2267040,0
8658,Yeon Je Woon,69,3846300,9707464130295292,542,7772942,911518,91152,820366
8659,Aygün Yıldırım,40,2037200,5467341200027736,278,3411407,3327703,3327703,0
8660,Yin Hongbo,58,704300,7643410668320509,265,2522449,2149638,0,2149638
8661,Daisuke Yokota,68,1064200,9908416880803656,405,3854219,3422364,0,3422364
8662,Isaiah Young,30,4985600,9665965344247011,390,6989336,1757999,0,1757999
8663,Utku Yuvakuran,60,3412300,9160216767656019,519,7096839,4409388,440939,3968449
8664,Nicolás Zalazar,49,3906100,6977215669099000,442,6131235,3403074,3403074,0
8665,Maximiliano Zalazar,64,566500,4599309436590364,299,2380915,1700521,1700521,0
8666,Žan Zaletel,64,1371400,4368121707659315,345,3381607,2420681,24207,2396474
8667,Edgar Zaracho,37,2637100,7497750939428471,300,4320354,3786467,379,3786088
8668,Mattia Zennaro,53,2037300,7421651692029454,391,4376945,4336160,434,4335726
8669,Zhong Yihao,30,3142200,4736290046945722,304,4680762,2871286,287129,2584157
8670,Leonard Zuta,36,3119400,3528225073578194,359,5092740,746279,746279,0
8671,Joël Zwarts,27,375400,3916506095794825,48,367691,1608,161,1447
8672,Matías Abaldo,58,2623900,6378079416309607,387,5093262,2755502,0,2755502
8673,Hakim Abdallah,23,1300200,7793146319702297,106,1689082,804947,804947,0
8674,Fabio Abiuso,22,4920600,6988366541485557,386,6980376,6624403,0,6624403
8675,Mo Adams,52,4474200,3897760271194991,553,8399656,3663179,367,3662812
8676,Jacob Adebanjo,41,4536300,7993032303086195,498,6895299,4569853,0,4569853
8677,Harrison Afful,22,4699100,9308430411499131,394,7056201,6730919,0,6730919
8678,Daniel Afriyie,68,1835700,4690697081479104,472,5130135,3642797,0,3642797
8679,Adnan Aganović,58,3578600,9973075521389836,457,6847079,4769057,0,4769057
8680,David Ajiboye,66,3637600,7397787838408332,548,6657329,3267361,3267361,0
8681,Nasser Al Dawsari,68,4794100,6601068384465375,721,10094668,5437524,5437524,0
8682,Mohammed Al Fatil,36,4346700,3018995699036522,456,7484863,1103067,0,1103067
8683,Hamadi Al Ghaddioui,30,2020400,4998236033956774,200,3148722,3048660,30487,3018173
8684,Khalid Al Ghannam,30,2335000,6974127895226642,255,3664397,2926726,29268,2897458
8685,Rami Al Hajj,43,3878200,6753967401095371,408,6614591,4844071,4845,4839226
8686,Fawaz Al Qarni,42,3905800,8557507679846880,421,6873932,2067918,2067918,0
8687,Saeed Al Rubaie,23,1393000,5748146216451917,95,1533009,1156423,1156423,0
8688,Ahmed Al Zain,25,4439500,9542222096855080,407,6484067,65932,0,65932
8689,Amir Al-Ammari,56,3547700,5728294829471184,445,6705574,3467313,3468,3463845
8690,Mads Albæk,44,2870000,9157302463354768,347,5158106,2669668,0,2669668
8691,Raúl Albentosa,35,4895500,8869209048817445,529,7991304,5596160,0,5596160
8692,Christian Alemán,49,2404300,8937612873270959,400,4571157,4116934,4116934,0
8693,Migouel Alfarela,47,4929800,5142848944053643,571,8531173,3073230,0,3073230
8694,Kerim Alıcı,29,1242800,4340382094301359,127,1826541,325849,326,325523
8695,Isnik Alimi,35,1129400,7017944118989525,144,1767650,530836,531,530305
8696,Sandro Altunashvili,50,3374500,7715060875844556,446,6286358,293796,2938,290858
8697,Sone Aluko,22,3054500,3276988939016613,208,4072600,2587526,259,2587267
8698,Rodrigo Amarilla,65,4539500,7377491672360586,643,8459879,3032901,0,3032901
8699,Youssef Amyn,65,4612100,4941504219753893,614,8442720,7585936,0,7585936
8700,Hugo Ancajima,55,3046000,9507650067021290,458,5961061,2851872,0,2851872
8701,Nilson Angulo,65,3332300,6082153822625133,520,6516323,1329,0,1329
8702,Marco Antonio Angulo,43,3054700,4884173026783573,337,5067575,2952709,0,2952709
8703,Luis Annese,69,3295400,5622164354790659,481,6407463,4116476,4116476,0
8704,Kent-Are Antonsen,27,4336600,6905624170631777,361,6083809,2163454,216346,1947108
8705,Alexis Antunes,54,2945500,5728249128279867,442,5860321,5426279,54263,5372016
8706,Julien Anziani,32,2010200,3071240519029666,221,3245200,160583,0,160583
8707,Aias Aosman,69,639000,6369006825788319,356,2819429,2145267,0,2145267
8708,Arambarri,57,892700,5069867453907566,253,2477666,503304,50331,452973
8709,Jon Aramburu,34,2188100,7426676629799574,249,3685349,1897488,190,1897298
8710,Arana,23,2407000,5411807751546351,220,3457062,1869079,186908,1682171
8711,Gabriel Aranda,67,4784800,8592529224004388,674,8777827,4806362,480637,4325725
8712,Vitó,67,548300,4325323636443240,329,2896017,2148399,2148399,0
8713,Musa Araz,27,4263300,9928380898467261,340,6274797,1814388,18144,1796244
8714,Juan Carlos Arce,42,2756500,6284989050233537,323,4396530,454046,0,454046
8715,Teodoro Arce,32,836800,4802752159266649,115,1319045,1252438,1253,1251185
8716,Theo Archibald,54,1269300,8844901832023357,338,3326228,566057,567,565490
8717,Taïryk Arconte,36,2165300,5224774145048232,274,3710963,861122,0,861122
8718,Simone Aresti,60,1822000,8065277750650528,361,3888880,3118057,0,3118057
8719,Daniel Arzani,69,3054000,5227060821855958,524,6065463,2234984,224,2234760
8720,Jasin Assehnoun,62,2365800,9840154110623988,377,4730154,4219617,4219617,0
8721,Isaac Atanga,52,2644200,9333256558225837,399,4813382,4427913,44280,4383633
8722,Avilés,43,861800,4207721063023840,189,1980718,1931458,194,1931264
8723,Oğuz Aydın,66,1543600,4832286902812803,356,3855801,1585316,1586,1583730
8724,Jonah Ayunga,22,3332200,5986899220811183,303,4613792,3620389,363,3620026
8725,Femi Azeez,33,350600,7411406377477185,99,732416,697523,6976,690547
8726,Pedrinho,36,2351400,7511709652662052,272,3774525,3402719,3403,3399316
8727,Adriel Ba Loua,48,1926200,9575437457343020,292,3457102,434562,0,434562
8728,Youri Baas,42,1420800,3312648971544133,260,3127617,2002266,0,2002266
8729,Khouma Babacar,26,1002900,9119123999271716,116,1457544,1073659,108,1073551
8730,Kearyn Baccus,38,1050900,6948710808629452,159,1882835,913753,913753,0
8731,Loïc Badiashile,42,3991600,5861574346661612,475,6787170,1737397,1738,1735659
8732,William Baeten,24,4497100,9817561108703743,390,6950016,2305180,231,2304949
8733,Thibo Baeten,33,3185300,5900295661356540,307,4644236,4317180,0,4317180
8734,Jean-Mattéo Bahoya,42,1128300,9679374548135144,186,1999930,1434281,0,1434281
8735,Stefan Bajic,54,2004100,4194481459905973,340,3822401,3803047,0,3803047
8736,Bak Jae Yong,45,2516200,4889922516970230,299,4361253,4193589,41936,4151653
8737,Marvin Bakalorz,47,4159700,3719421616304977,499,7489710,6321326,632133,5689193
8738,Zakaria Bakkali,60,1243800,6288235213409078,293,3041807,1263127,126313,1136814
8739,Enrico Baldini,67,2232900,4711495181369185,459,4861066,87926,880,87046
8740,Husein Balić,57,3379300,5902800352187694,478,6919089,2413609,0,2413609
8741,Tiago Banega,22,2066900,4868216424401340,193,2876760,1253675,1253675,0
8742,Johan Bångsbo,38,1182600,5025579854249830,193,2188806,1046552,105,1046447
8743,Sacha Banse,62,4627200,7263805744882714,580,7730184,2927679,0,2927679
8744,Tom Barkhuizen,66,4489200,8221340201490171,607,7875331,1616244,16163,1600081
8745,Orlando Barreto,57,4405900,9640228769408529,579,7372899,1826730,1827,1824903
8746,Connor Barron,23,3204800,6017223742802426,246,4046597,2289172,2289172,0
8747,Cristian Barros,28,2268000,3614362175033350,223,3155251,2078804,20789,2058015
8748,Jan-Christoph Bartels,24,2990300,9825006034491363,224,4183299,1909229,19093,1890136
8749,Jakub Bartkowski,42,2273600,7096613137080376,279,3648477,2873208,0,2873208
8750,Felix Bastians,57,3902400,8890807745987566,541,7675013,4298099,4299,4293800
8751,Romain Bayard,33,998200,3883784136874300,136,1581620,652405,6525,645880
8752,Emin Bayram,24,3721000,4491286327075709,359,5446367,2350685,0,2350685
8753,Tanner Beason,53,564800,8071548079521684,217,2008271,1457751,1457751,0
8754,Omar Beckles,33,1162400,5292830989044226,166,2163355,414547,0,414547
8755,Morten Behrens,63,1139800,3494608317477278,286,2910079,823792,82380,741412
8756,Steven Beitashour,48,1294700,7039699406340356,250,2851371,395349,0,395349
8757,Łukasz Bejger,48,1084800,6331271505882223,287,2757373,2713474,0,2713474
8758,Semi Belkahia,31,4768300,5840224465935712,470,6923411,1279453,127946,1151507
8759,Yassin Ben Balla,28,2430300,5726050870452964,212,3289867,1402339,14024,1388315
8760,Ayman Ben Mohamed,33,1789200,6546078120548846,234,3016631,227731,2278,225453
8761,Alexandru Benga,48,1631400,5876077381213882,290,3232436,945600,0,945600
8762,Ángel Benítez,29,765000,4384112518205914,113,1290989,808941,0,808941
8763,Bryan Bentaberry,33,1471800,4254358306116453,202,2560545,276027,277,275750
8764,Ron Berlinski,44,482600,8076819684354371,209,1849624,1407904,140791,1267113
8765,Emilio Bernad,26,3966400,5455232359384625,319,5336423,4591036,45911,4545125
8766,Miguel Berry,35,2131300,4705455381079766,239,3400289,3321200,332120,2989080
8767,Vicente Besuijen,45,4884400,8656207220085081,490,7893647,2186203,0,2186203
8768,Davide Bettella,31,4051700,8186362928756866,417,6040204,1452229,145223,1307006
8769,Alessandro Bianco,37,2045700,4037972308247471,259,3222340,3059544,306,3059238
8770,Ovidiu Bic,61,3911900,4900505156671021,509,6613627,4974251,4974251,0
8771,Luis Bilbao,41,1515500,7191138120709520,210,2414313,1389452,13895,1375557
8772,Kristian Bilovar,27,2830000,7043575031022086,227,4120016,571949,571949,0
8773,David Bingham,61,1917600,9036500459243402,374,4531947,2720193,0,2720193
8774,Daniel Bîrligea,43,3500100,6499724505288086,396,5713036,2260925,227,2260698
8775,Alexander Bittroff,42,2846200,5139260589278309,330,4898379,1771496,1771496,0
8776,Andreas Bjelland,51,2864600,9590076225709151,417,5318680,1042466,10425,1032041
8777,Morten Bjørlo,29,3184700,9889797636215965,279,4536387,1838006,18381,1819625
8778,Axel Björnström,44,3448800,9175040822866583,478,6274035,6178309,61784,6116525
8779,Tyler Blackett,62,2423500,3308566389993819,474,5466870,534190,53419,480771
8780,Nicolás Blandi,32,1852400,6454877629824519,208,2833554,1951686,1952,1949734
8781,Ole Didrik Blomberg,29,455900,7270972187729769,94,774656,128634,128634,0
8782,Emmanuel Boateng,43,3045100,3523467162436985,346,5103228,266326,2664,263662
8783,Damián Bobadilla,57,1598600,4457687535462884,310,3224560,9124,0,9124
8784,Aleksander Bobek,62,2086500,5679825017980114,430,4734906,2859585,0,2859585
8785,Matija Boben,24,2428700,5227545124538691,200,3472945,3290788,32908,3257880
8786,Radu Boboc,42,4299000,7046139171692017,476,7219044,1608692,1608692,0
8787,Éric Bocat,48,4277000,8865928115974546,489,7275183,3311472,331148,2980324
8788,Lukas Boeder,25,4291900,9118843653068864,377,6524093,660314,6604,653710
8789,Melayro Bogarde,46,1325300,4633960802037412,210,2373957,2228554,22286,2206268
8790,Luka Bogdan,37,4125300,6801176958303481,417,6552322,4805365,48054,4757311
8791,Agustín Bolivar,42,691400,6535012832235244,174,1628380,1212102,0,1212102
8792,Luke Bolton,35,566600,7056180592256645,147,1315083,327529,327529,0
8793,Elliot Bonds,41,4867400,7029760567791945,446,7687224,107684,108,107576
8794,Nicholas Bonfanti,28,2027300,3402062296913165,170,2494661,1672165,1672165,0
8795,Facundo Bonifazi,50,3313800,6612538242554629,467,5879298,5627435,56275,5571160
8796,Alex Bono,51,1922900,9638744131008538,326,3894181,1246852,124686,1122166
8797,Mihai Bordeianu,45,745200,8881853003593751,187,1861341,1433815,1433815,0
8798,Léo Borges,40,1748700,4016886102298290,252,3225402,1902554,1902554,0
8799,Tobias Børkeeiet,64,934000,7923848973368114,339,2991876,374591,3746,370845
8800,Dylan Borrero,31,4058200,5468064807887531,398,5910136,1590651,15907,1574744
8801,Frederik Børsting,23,4741600,5160051426641872,416,7137808,6212301,0,6212301
8802,Zacharie Boucher,55,1302500,3544008080485070,291,3342928,3297968,329797,2968171
8803,Abdelrahman Boudah,26,3811600,3839181088865430,315,5587188,1457138,1457138,0
8804,Nassim Boujellab,53,1661700,9293021841298385,333,3976869,2473965,247397,2226568
8805,Ibane Bowat,39,866000,3506715993407839,149,1636161,382414,3825,378589
8806,Oliver Bozanic,60,330700,6557199096840949,274,2007196,1336857,0,1336857
8807,Jayden Braaf,52,1683100,6601932450532654,310,3736999,2195290,2196,2193094
8808,Bilal Brahimi,61,4977600,8790712193655504,581,8895657,6806459,6807,6799652
8809,Frederik Brandhof,50,4169000,4035898950976980,536,7858914,4757499,0,4757499
8810,Zachary Brault-Guillard,43,306700,6540572334929151,148,1026491,645170,64517,580653
8811,Marius Briceag,22,4478700,5424597257370050,366,6040676,3875099,388,3874711
8812,Ethan Bristow,35,4246900,7812373829856897,429,6912164,608304,6084,602220
8813,Lucas Brochero,26,1095200,9068853628411576,137,1676567,1237083,124,1236959
8814,Samuel Brolin,29,4842100,3514164036137627,421,6976458,2701099,2701099,0
8815,Brandt Bronico,48,3493200,6821994998504152,437,5762615,3391481,3391481,0
8816,Marcus Browne,27,2840400,6159299816380533,229,3773050,2245118,2245118,0
8817,Sébastien Bruzzese,57,2741100,6560950965619557,427,5245511,1510317,152,1510165
8818,Lucas Buades,32,2675500,6736917550407098,284,4124943,1746665,174667,1571998
8819,Jesús Bueno,66,2186500,3417518057939849,396,4867453,3139460,3140,3136320
8820,Teal Bunbury,51,3176000,7500446258830401,403,5683470,2097352,0,2097352
8821,Lars Bünning,22,926600,3446586123492476,60,867630,482825,483,482342
8822,Tyler Burey,42,2582800,7592367163233724,325,4236063,1671511,16716,1654795
8823,Harrison Burrows,55,1987100,8045437804509410,402,4776891,2689433,0,2689433
8824,Marco Bustos,49,2326300,8191505863257628,319,4235269,827199,827199,0
8825,Matt Butcher,46,2905700,6971517507622770,383,4964703,4559003,0,4559003
8826,Calum Butcher,28,626100,4515897118887043,98,1015571,494222,0,494222
8827,Alessio Buttaro,58,1968700,8675677197752786,387,4521132,4283011,428302,3854709
8828,Luis Cabral,22,4558300,6438567322264190,382,6517907,2114996,21150,2093846
8829,Kenji Cabrera,30,3428700,4007699023783945,302,5226406,1797579,1798,1795781
8830,Malcolm Cacutalua,69,968500,9949699342359905,355,3244624,1654490,1655,1652835
8831,Diego Callai,42,1096200,5173405822423182,231,2280044,760960,0,760960
8832,Josh Campbell,67,3560600,6457596397909109,559,7495894,5944631,5944631,0
8833,Diego Campos,48,4907300,9938239596612770,541,8207096,1428242,142825,1285417
8834,Cihan Çanak,28,1483800,7626652054633560,141,2018856,1814484,1814484,0
8835,Atakan Çankaya,66,1278000,6439566449985559,372,3600180,1523998,1523998,0
8836,Erdem Canpolat,36,2306200,4153361784100389,290,4181112,3752213,0,3752213
8837,Christian Cappis,51,1303000,4270058629206098,271,2866330,2377063,237707,2139356
8838,Pablo Cárdenas,57,3518400,5870507626504334,486,6366082,5849330,5849330,0
8839,Adam Carlén,49,4840800,3327179213713870,619,8857331,4448206,445,4447761
8840,Jonas Carls,29,615900,3364158161227963,111,1032669,865886,0,865886
8841,José María Carrasco,44,2096800,7329614575223294,322,4034688,2383204,238321,2144883
8842,Giuseppe Carriero,42,4488100,4038247056694074,492,7221453,3156458,0,3156458
8843,Trevor Carson,43,1170000,8304876045206406,231,2676700,2297180,230,2296950
8844,Scott Carson,55,2576200,3334703844389969,417,5213129,3868350,387,3867963
8845,Martim Neto,54,627500,5659787741397943,234,2178778,122386,12239,110147
8846,Wanderson,59,3894500,6748899123122750,543,6762693,3507008,0,3507008
8847,Tino Casali,69,1576800,7598639220400751,418,4359080,3174085,31741,3142344
8848,Aljaž Casar,56,2574200,6331654757480190,374,5048315,2040794,205,2040589
8849,Luc Castaignos,50,629800,5302429810897267,247,2008514,885542,8856,876686
8850,Frank Castañeda,46,1049500,4284794628914765,224,2198295,1193007,0,1193007
8851,Rodrigo Castillo,31,4216900,7513029391522670,395,6981281,2472041,248,2471793
8852,Santiago Castro,64,1998400,8102553384394173,388,4607499,2871475,0,2871475
8853,Javi Castro,43,2353300,8474080098872520,304,4232434,1210356,0,1210356
8854,Cristian Cauz,39,2646900,6260545141086278,310,4738459,995270,100,995170
8855,Sofyan Chader,37,2884100,9336237698195841,377,5226596,4203511,420352,3783159
8856,Maikel Chang,65,971600,6939205111689093,359,3384782,1174151,11742,1162409
8857,Pablo Chavarría,48,4585400,3036747337101922,490,7886072,3742008,3743,3738265
8858,Yevgen Cheberko,61,392400,6874862960772612,305,2451132,166487,0,166487
8859,Mattia Chiesa,51,1824800,4411202086667505,374,4042851,3662615,0,3662615
8860,Michał Chrapek,28,3248400,7457583003010569,323,5101943,1923680,193,1923487
8861,Carney Chukwuemeka,46,1241100,6424972580558955,216,2349189,469834,0,469834
8862,Mateusz Cichocki,47,502100,8203619334015745,184,1620108,1505447,1505447,0
8863,Andrei Ciobanu,35,4501500,7639695591200202,384,6179163,5922341,0,5922341
8864,Denis Ciobotariu,24,3623800,6890168575944671,284,4883981,3645557,364556,3281001
8865,Cătălin Cîrjan,62,1015200,9435866119638481,371,3337596,2387338,0,2387338
8866,Amadou Ciss,52,1481100,3578620907170405,326,3444642,2091489,20915,2070574
8867,Giorgio Cittadini,41,4846500,6845521129781119,489,7869883,5411047,0,5411047
8868,Sean Clare,45,4120800,4303946938160179,437,6233966,61611,617,60994
8869,Mitch Clark,69,2957700,8861362835126764,501,5643263,2821477,2822,2818655
8870,Yannis Clementia,34,3758900,9308850687093556,363,5645486,4841740,485,4841255
8871,Denilho Cleonise,45,2919100,3932219950421544,353,4972608,2423884,24239,2399645
8872,Harry Clifton,68,1387400,8340252464277490,372,3553268,417513,418,417095
8873,Josh Coburn,29,1926200,4012587353880385,179,2566757,869168,870,868298
8874,Marco Collao,58,3672400,5593326609930957,503,6541019,1845782,184579,1661203
8875,Will Collar,32,1273900,5086675340514488,151,1942567,193090,1931,191159
8876,Archie Collins,24,4365300,5308048898165195,347,6196292,5960744,0,5960744
8877,Rubin Colwill,46,2742200,9049507833363411,332,4571171,3176601,317661,2858940
8878,Diego Conde,43,2610100,5485039967146925,296,4322028,2848654,2849,2845805
8879,Aloïs Confais,38,3060100,7820461156427973,353,4848194,2224562,22246,2202316
8880,Kevin Conrad,53,812900,4028186257215659,227,1983632,443651,44366,399285
8881,Rubén Cordano,42,4558000,9626075069378839,445,6933889,2491733,250,2491483
8882,Enzo Cornelisse,70,904400,9966522701580781,369,3398278,2372908,0,2372908
8883,Diego Corozo,26,1249800,5533598962082569,143,1759371,461538,46154,415384
8884,Killian Corredor,22,2104500,6058781036813178,161,2763026,751300,752,750548
8885,Lasso Coulibaly,61,3576200,8652212989967341,535,6910312,2988767,0,2988767
8886,Soumaila Coulibaly,57,2163600,5400380425367783,373,4234143,2109323,210933,1898390
8887,Valentin Crețu,68,4714100,7723537811480286,750,9629353,2191827,21919,2169908
8888,Nicolás Crovetto,32,3606200,3506459254819555,395,5829194,2719391,2719391,0
8889,Daniel Crowley,54,2863600,9390891419972185,418,5624880,3961361,0,3961361
8890,Jairo Cuéllar,63,4774100,4218222268768586,660,9689740,1014435,10145,1004290
8891,Brahian Cuello,63,3976200,9750943620888861,557,7471554,1473988,14740,1459248
8892,Juan Manuel Cuesta,65,3535300,4758578592891374,585,6987016,4573936,458,4573478
8893,Robbie Cundy,70,2350500,9920330754505533,444,4867352,1411169,1412,1409757
8894,Sessi D'Almeida,46,944400,4146038311203623,219,2222407,1017393,10174,1007219
8895,Silva,26,2251500,8596051291772977,198,3260754,2063327,0,2063327
8896,Pontus Dahlberg,57,2673600,5000928006589697,375,4722973,2281597,2282,2279315
8897,Dai Weijun,51,3068500,3823268529538116,425,5852081,4095188,4096,4091092
8898,Slavko Damjanović,59,2678700,3026739232069064,448,5328949,1127659,1128,1126531
8899,Luke Daniels,43,3124100,8670910577388418,434,5332381,3741806,3741806,0
8900,Donervon Daniels,35,2888300,9943496620499269,316,4692068,4669540,467,4669073
8901,Andrea Danzi,58,3168500,7107161770348947,425,6128537,1255479,1256,1254223
8902,Jason Davidson,29,1760000,5383412659985047,177,2756190,296143,297,295846
8903,Curtis Davies,41,351400,6868898026081064,129,982767,934048,0,934048
8904,Joyskim Dawa,25,3408800,3247810196936269,297,4953838,3458651,3459,3455192
8905,Brian De Keersmaecker,69,308000,6656603343872471,276,2010951,1702684,1702684,0
8906,Kevin De La Hoz,56,2429100,8418907433861173,369,4745309,4189272,41893,4147379
8907,Lucas Ventura,66,730900,9783791018310728,378,3411661,2117646,212,2117434
8908,Alessandro De Vitis,27,2785400,5589532967937152,284,4587180,2475881,0,2475881
8909,Gabriel Debeljuh,55,1069100,8891111403503682,293,2942017,361887,0,361887
8910,Logan Delaurier-Chaubet,62,4471200,5852087786513229,571,7667557,2583325,259,2583066
8911,Sacha Delaye,62,2803800,5138846441052223,476,5643880,3419520,34196,3385324
8912,Fisayo Dele-Bashiru,48,3669100,4754025689498892,444,6543817,5161446,51615,5109831
8913,Fabio Delgado,44,4536500,4105516987055696,490,7761701,972676,9727,962949
8914,Delgado,58,4650500,7395110189005288,588,8293803,873973,87398,786575
8915,Karamoko Dembélé,22,1811000,7200894866796917,137,2356283,2035351,204,2035147
8916,Kristian Dennis,41,2958000,5158866463938698,351,5025646,2221645,0,2221645
8917,Jérôme Deom,45,2714500,4496011449627468,362,4982051,3330001,3330001,0
8918,Abdoulaye Diaby,37,2407300,6572245650988110,273,3639772,1957703,0,1957703
8919,Yadaly Diaby,39,398700,4036667433780951,121,997458,594882,0,594882
8920,Ousmane Diakité,30,1923400,3887014510575740,220,2914460,457007,0,457007
8921,Paul Digby,56,666000,6977281231048584,232,2093768,146010,1461,144549
8922,Eren Dinkçi,49,3278600,5090490500775439,435,5669929,2061236,0,2061236
8923,Amidou Diop,44,1836700,7956028782801714,238,3301827,688665,6887,681778
8924,Clément Diop,55,3969400,3763660664451441,547,7297832,6863871,687,6863184
8925,Viktor Djukanović,43,2619000,7698413931785813,388,5315002,4883284,4883284,0
8926,Ivan Dolček,54,1458400,4736207775898992,288,3357463,1869733,186974,1682759
8927,Maxime Dominguez,54,2672200,3440775251000419,432,5120023,4449615,4450,4445165
8928,Dong Chunyu,60,3101700,3332690299015729,501,6150253,5458865,54589,5404276
8929,Lohann Doucet,22,3337800,3964518419130593,302,5101436,289353,0,289353
8930,Siriné Doucouré,44,4196600,8344221003111729,442,6883450,5564753,0,5564753
8931,Guéla Doué,60,4767700,5359316669583955,592,8444112,2670194,26702,2643492
8932,Jake Doyle-Hayes,33,2123500,8832902188544212,225,3071176,1180105,11802,1168303
8933,Stefan Drljača,35,4414200,6708289091533989,467,6928120,5675738,0,5675738
8934,Lukáš Droppa,67,1898400,4580047731065697,435,4748318,291230,0,291230
8935,Lance Duijvestijn,38,3510300,4111032199478591,388,5742389,1328220,13283,1314937
8936,Harrison Dunk,39,4487100,6588096421770186,474,7501317,1413153,142,1413011
8937,Jhon Durán,39,668200,7681082195359290,180,1615576,834505,835,833670
8938,Jimmy Durmaz,44,4805800,9757960086694735,491,7908226,3741235,374124,3367111
8939,Tom Eaves,43,2857300,4487416286469716,373,5323538,4937890,0,4937890
8940,Michael Eberwein,59,4970600,5119272713229574,604,8879366,7252391,72524,7179867
8941,Samuel Edozie,49,587800,4980385566878646,234,2139640,63847,63847,0
8942,Ryan Edwards,32,1134300,9055782828735049,165,1959862,220322,221,220101
8943,Mandela Egbo,69,1562900,7078421957790403,370,3995168,354414,0,354414
8944,Lilian Egloff,69,3303100,6328769413599037,567,6547447,2065448,2065448,0
8945,Kevin Ehlers,23,551800,9677730930364014,38,427137,255525,0,255525
8946,Christoph Ehlich,53,4840000,9273504691990797,514,7853861,3995235,3995235,0
8947,Daniel Eid,58,4164800,5085127275735455,532,7184460,4711884,0,4711884
8948,Mo Eisa,51,3471300,4358890233538368,467,5799849,1890955,0,1890955
8949,Pierre Ekwah,54,2229800,3716362408640310,385,4949012,1000140,100014,900126
8950,Oussama El Azzouzi,58,3800000,5765997854847455,525,6778143,1730633,174,1730459
8951,Zakaria El Ouahdi,22,1373100,3400041359077754,86,1493860,783767,7838,775929
8952,Mikael Egill Ellertsson,37,4631500,9169964627866832,421,7181451,6818866,0,6818866
8953,Xian Emmers,22,3878500,9948943897146747,340,5387217,5345276,5345276,0
8954,Keita Endo,62,3206600,8543224847299757,523,6679479,756241,756241,0
8955,Mario Engels,63,2180000,9004948767487152,426,5113591,4718586,4718586,0
8956,Lawrence Ennali,23,2029300,9407616447326957,162,2733299,379561,379561,0
8957,Ziya Erdal,69,1119300,7226941777147720,368,3303477,731742,73175,658567
8958,Sebastian Eriksson,68,2353000,5567340091663701,492,5481336,340252,341,339911
8959,Victor Eriksson,69,1421600,3188928434839111,335,3548140,2660511,0,2660511
8960,Ertuğrul Ersoy,59,3652400,8174443048091876,448,6286455,4127282,0,4127282
8961,Julius Ertlthaler,67,2360400,6306094604541859,493,5221484,4651065,465107,4185958
8962,Julian Eseiza,35,2283700,3012083970411331,277,3724515,924687,0,924687
8963,Samuel Essende,52,4586400,5549894376278760,593,8249333,4110486,0,4110486
8964,Jean Lambert Evan's,51,4980200,6940434878849417,520,7862929,1016449,102,1016347
8965,Saeid Ezatolahi,62,858600,7040040623391584,288,2601464,275082,0,275082
8966,Wahid Faghir,31,4849600,6138828718685486,445,7210451,5701043,5702,5695341
8967,David Fällman,37,1880900,8840393160085667,237,3312974,1743408,0,1743408
8968,Akin Famewo,59,4670800,5070088717347258,635,8488016,1936897,1937,1934960
8969,Sultan Farhan,29,1754400,7185927485102029,174,2526912,1400752,140076,1260676
8970,Priestley Farquharson,58,2434600,9392043926807705,435,5519270,51139,0,51139
8971,Neil Farrugia,43,4829100,4580068486450814,512,8309775,291083,0,291083
8972,Betim Fazliji,31,2010000,9850213232125755,254,3493833,1644123,165,1643958
8973,Gino Fechner,30,4851600,7996428690483436,436,6874369,2714519,272,2714247
8974,Joel Felix,48,601500,5401315978823567,222,1900294,256784,256784,0
8975,Volnei Feltes,60,3384900,4594618210120237,577,7286061,6871931,687194,6184737
8976,Alexis Fernández,23,1479500,6483033279986363,129,1931560,1736309,173631,1562678
8977,Nicolás Fernández,66,2141700,5099356641740747,440,4766474,4509778,451,4509327
8978,Matías Ferreira,37,461700,7934533691238989,130,1058821,189664,190,189474
8979,João Valido,58,753900,4962079170577923,265,2372397,661162,6612,654550
8980,Julián Figueroa,41,1895400,5361682576695632,254,3317666,2278856,0,2278856
8981,Alexandr Filin,60,2918200,3275779468437797,489,6265362,5166263,516627,4649636
8982,Ethan Finlay,39,4128100,4372716376338279,384,6002328,4648684,46487,4602197
8983,Kolbeinn Birgir Finnsson,57,1008500,7558764848702919,280,2597348,2300968,2300968,0
8984,Lewis Fiorini,67,2668200,7458020864336532,466,5708823,3139237,31393,3107844
8985,Tom Flanagan,44,3460600,5725672874337556,430,6626759,3430359,0,3430359
8986,Leandro Fleitas,27,2760000,8625092811852526,268,3928536,3373396,0,3373396
8987,Marcin Flis,61,3010000,4654537884681462,439,5454839,5263067,0,5263067
8988,Aldo Florenzi,57,3125000,6502324576248620,440,5992413,3781285,37813,3743472
8989,Eduard Florescu,27,543700,7076163891743252,75,750279,52957,0,52957
8990,Malick Fofana,67,4700800,5049506764959947,604,8731922,2891085,2891085,0
8991,Théo Fonseca,33,4045100,9401231431469107,354,6048049,1974122,1974122,0
8992,Anthony Fontana,23,4747700,6207834064874407,393,6401677,2507794,25078,2482716
8993,Tiago Morais,30,3240000,5975873481536348,263,4235403,2261038,226104,2034934
8994,Marcus Fraser,32,1808500,8468049821112234,184,2780053,1714494,1715,1712779
8995,Pierluigi Frattali,37,1903400,4145940511064901,267,3238159,1168082,0,1168082
8996,Emil Frederiksen,42,3631100,4206579746485219,386,5531209,3704995,371,3704624
8997,Matt Freese,22,1244300,7284779701763163,83,1343362,1099987,11000,1088987
8998,Lewis Freestone,51,4346800,4487326203977389,546,7303104,4363956,0,4363956
8999,George Friend,56,2086500,4109280658493012,337,4135838,570506,0,570506
9000,Kianz Froese,69,2622500,5229119051671671,454,5279251,4998776,0,4998776
9001,Marius Funk,45,4414500,6164665965095808,520,7461973,743259,0,743259
9002,Anton Gaaei,62,1343800,5220518358715187,328,3352641,620769,6208,614561
9003,Joaquín García,31,518100,7806557229255984,99,829591,367289,36729,330560
9004,John García,39,1621800,5485308042622692,212,2702785,331382,0,331382
9005,Jon García,64,4827400,3096710488413095,668,9292899,7171278,718,7170560
9006,Naranjo,47,3236800,3375430538706270,408,5656989,1106643,0,1106643
9007,Aleix Garrido,59,2984500,6627575366109365,403,5092027,48556,4856,43700
9008,Ben Garrity,23,4852900,5157874092412951,430,7326783,3413910,0,3413910
9009,Jules Gaudin,37,4918600,3821863381486951,422,7123383,2053434,20535,2032899
9010,Gianfranco Gazzaniga,51,2293800,9763522176551607,331,4262365,1164698,1164698,0
9011,Mathias Gehrt,49,518500,3612440028187346,201,1759842,1374392,138,1374254
9012,Jader,25,4615300,4755917107905420,417,6644607,6296823,0,6296823
9013,Shamal George,60,4951900,5210399083131587,617,8547006,2004253,0,2004253
9014,Willem Geubbels,43,1258500,9182426297002053,225,2355322,103398,104,103294
9015,Liam Gibson,45,3989800,3250442652108560,476,7228094,7085711,709,7085002
9016,Alex Gilbey,56,3699400,6423270669338674,454,6822499,1241393,0,1241393
9017,Patrick Göbel,52,4947100,7740882510133177,604,9185179,4504340,45044,4459296
9018,Wouter Goes,48,2244600,9968070842570482,358,4731557,3726212,3727,3722485
9019,Robert Gojani,29,3270400,6148568989747544,290,4482007,489926,490,489436
9020,Guilherme Garutti,64,3218500,8207383839207379,492,6469550,3228762,323,3228439
9021,Darwin Gómez,22,2554100,7752245992027588,203,3592061,2351757,2352,2349405
9022,James Gomez,58,2802000,3777195959016348,466,5524826,4169939,0,4169939
9023,Richet Gómez,42,3982700,9920678016820030,438,6425748,5269755,5270,5264485
9024,Johan Arath Gómez,67,3673800,5999473213553756,518,7447594,4241094,4241094,0
9025,Maximiliano González,31,4363100,4562880300743837,443,6631225,5498055,5499,5492556
9026,Jersson González,57,1772700,4905670414077135,361,4074605,168533,1686,166847
9027,Tomás González,35,559200,5906355506313221,125,1170170,850701,0,850701
9028,Alfon,38,2347200,8591203772572710,269,3765241,3516967,3516967,0
9029,Nono,37,3329500,4784837729501851,380,5418735,4909821,490983,4418838
9030,Jacobo,59,2124600,3165571339798425,405,4629393,152856,15286,137570
9031,Zafer Görgen,31,4627500,6475058640437908,413,6683564,4219215,4219215,0
9032,Conor Grant,53,4431400,3095071124146405,528,7475997,6838749,6838749,0
9033,Tayvon Gray,27,4837600,9006177580036046,420,6924828,5098013,0,5098013
9034,Pascal Gregor,29,1394900,6358448645791065,178,2235537,78473,785,77688
9035,Rostyn Griffiths,31,3598000,3718816135883699,315,5046587,656773,656773,0
9036,Jack Grimmer,24,4707200,7561645654443961,441,6652881,636480,636480,0
9037,Thomas Grøgaard,53,4507500,5537853268279847,571,8395690,3106025,3106025,0
9038,Tommy Grupe,44,1989500,8879353382655648,303,3879670,2796341,2796341,0
9039,Jan Grzesik,46,2546200,6355382356526313,364,4670534,1706593,1707,1704886
9040,Mateusz Grzybek,60,2368600,7282850032625650,393,4920071,81955,0,81955
9041,Sveinn Aron Guðjohnsen,30,1875300,6491608805073373,196,2771180,1079538,1080,1078458
9042,Édgar Guerra,70,4554200,5425907855891649,594,8286661,6779316,677932,6101384
9043,David Gugganig,44,4174400,6760527338427225,412,6476977,4704877,0,4704877
9044,Tobias Gulliksen,30,2207600,5962159602044832,249,3355135,2393497,2393497,0
9045,Niklas Gunnarsson,38,331700,7908746501998831,98,689020,237006,0,237006
9046,Ionuț Gurău,54,4091600,4069584251406812,509,7731209,452049,4521,447528
9047,Julian Guttau,38,3390300,8976641065358903,350,5390741,1358207,135821,1222386
9048,Samuel Guzmán,23,2315500,9337622548666064,192,3125514,2603034,2604,2600430
9049,Joseph-Claude Gyau,43,2151300,6120858984289350,300,3955337,3293208,0,3293208
9050,Steffen Hagen,58,700800,4183422595945521,294,2744315,1571778,157178,1414600
9051,Aapo Halme,61,743200,5307590434672787,242,2261366,1510809,1511,1509298
9052,Ilyes Hamache,51,647700,4165313892985199,269,2504250,1611535,16116,1595419
9053,Tom Hamer,66,3510700,6718648853859307,577,7166460,4043839,40439,4003400
9054,Ethan Hamilton,27,1148000,7707802068229116,121,1639736,1518594,1518594,0
9055,Marek Hanousek,30,1138800,3989314013740535,157,1868007,1591739,1591739,0
9056,Sontje Hansen,62,4919200,3931370050366949,549,8926485,3256488,3256488,0
9057,Cameron Harper,66,2858500,6091969613765123,498,6012436,2717381,271739,2445642
9058,Denis Haruț,70,2615200,7749914665305575,535,6460922,1218980,122,1218858
9059,Stefan Haudum,24,4758700,5045554623511867,384,6493829,1480419,149,1480270
9060,Fredrik Haugen,41,1895200,6716071727844564,301,3911243,926296,9263,917033
9061,Sebastian Hausner,31,837600,8864884862111268,111,1342733,845749,84575,761174
9062,Aaron Hayden,68,576700,5736750380385603,345,2778473,1462390,1463,1460927
9063,Conor Hazard,59,3029800,6878285891636760,402,5387034,3920009,3921,3916088
9064,Ali Hazazi,43,4564700,4902098844481717,458,7560751,3032320,0,3032320
9065,Þórir Jóhann Helgason,25,2660500,4799760196737190,241,3931554,336774,3368,333406
9066,Emanuel Hernández,70,327500,4400531247447532,302,2443931,137240,138,137102
9067,Manu Hernando,31,414500,8831651935207702,105,804955,715507,716,714791
9068,Rodrigo Herrera,38,2672000,9658671961517454,316,4233307,2852996,285300,2567696
9069,Santiago Herrera,41,3965200,5181654815261699,432,6384650,3679038,3680,3675358
9070,Borja Herrera,66,877400,6267537975021468,302,2919952,1969307,196931,1772376
9071,Lucas Hey,67,989500,6799564330243248,359,3142514,3079285,30793,3048492
9072,Otto Hindrich,53,4293500,9143007320712875,513,7374095,2142045,0,2142045
9073,Macario Hing-Glover,46,4188500,7330386882906258,436,6675572,1061149,10612,1050537
9074,Koki Hinokio,26,3416800,9844845023923177,295,4732241,1736535,174,1736361
9075,Patrick Hoban,30,2017200,8883388118829226,210,2976885,511605,512,511093
9076,Lukas Hornicek,32,1952300,6782832773438766,247,3532588,614656,0,614656
9077,Fraser Horsfall,65,1033500,7165685184591300,314,3144455,2456714,0,2456714
9078,Ben House,52,1906000,6628890117794774,376,4075766,2799376,279938,2519438
9079,Huang Zichang,33,1113200,9387452162676177,168,1938720,571040,5711,565329
9080,Dean Huiberts,27,4333600,9978666090607198,367,6186958,3037816,0,3037816
9081,Marian Huja,31,1988500,6299244141653063,227,3135839,2090236,20903,2069333
9082,Bashir Humphreys,63,323100,6726960762867326,337,2769228,1712664,172,1712492
9083,Paul Huntington,51,3876500,8234453037518280,521,7431306,1084117,10842,1073275
9084,Paolo Hurtado,40,3238400,4090723090095530,382,5064165,4771920,0,4771920
9085,Hwang Mun Ki,39,1263300,7662418747120202,175,2092533,395253,3953,391300
9086,Alex Iacovitti,60,1524300,3278866948662299,371,3717788,852061,0,852061
9087,Gabriel Iancu,26,1710100,3517717172748980,157,2299369,1346855,0,1346855
9088,Joaquín Ibáñez,37,620500,5789725988079847,143,1374501,522948,0,522948
9089,Sebastien Ibeagha,66,4764800,6639612179242191,686,9237037,3340863,3341,3337522
9090,Dani Iglesias,44,3431300,4552945633267436,448,6253146,2871845,287185,2584660
9091,Luc Ihorst,26,4060000,8120800152592374,376,5676262,5229672,5229672,0
9092,Alexandru Ișfan,68,3145600,7282081533870105,475,6421668,5742287,0,5742287
9093,Masatoshi Ishida,27,1631800,3275812270974778,184,2460142,766063,7661,758402
9094,David Jablonský,31,2235300,3554391898202527,255,3560039,1084048,0,1084048
9095,Jarosław Jach,64,751500,4722312028226340,306,2663328,1565154,15652,1549502
9096,Tomás Jacob,68,806000,5117274760956713,345,3307539,2242162,22422,2219740
9097,Bjarke Jacobsen,35,1516300,9314199448900358,207,2343164,2075130,20752,2054378
9098,Lukas Jäger,26,4594700,8385554608791612,361,6119184,3023952,302396,2721556
9099,Kilian Jakob,33,3518100,5004860783962843,331,4945753,811906,8120,803786
9100,Caspar Jander,39,1052700,7210716817041007,193,1896267,253049,0,253049
9101,Florian Jaritz,53,2637200,7722613576288634,419,5526452,980146,981,979165
9102,Dennis Jastrzembski,36,1654900,5656981389785396,204,2891084,190864,190864,0
9103,Carl Jenkinson,59,2464300,9699315551093780,459,5769988,3989592,399,3989193
9104,Magnus R. Jensen,47,3382600,9408020092547551,392,5752038,412574,413,412161
9105,Richard Jensen,62,3755800,5817435200308030,592,7884138,3558125,0,3558125
9106,Alexander Jensen,56,1670500,4413106976759321,320,3521007,2212588,2213,2210375
9107,Jeong Dong Ho,56,2281400,3546135505427872,398,4962074,3731391,0,3731391
9108,Diego Johannesson,25,3136700,7224113438932720,289,4850123,2018079,201808,1816271
9109,Sondre Solholm Johansen,60,3113400,3634706910246573,478,6607848,5858990,585899,5273091
9110,Andreas Johansson,50,4375700,3777377639053789,536,7279207,219299,0,219299
9111,Gethin Jones,27,1970300,5179283857349932,184,2682314,1276732,127674,1149058
9112,Antonio Jonjić,45,4564500,6934479646631257,452,7221553,5281402,528141,4753261
9113,Lenny Joseph,47,1545000,5544409408594550,261,3055075,10354,10354,0
9114,Jung Ho Yeon,56,766900,5478968011801823,230,2217751,319936,3200,316736
9115,Jan Jurčec,60,3392500,4156098374771111,548,6925271,6010954,6010954,0
9116,Roko Jureškin,57,3726400,5929214329040927,548,7735737,225430,226,225204
9117,Guimer Justiniano,22,2261100,3712203824118326,171,2858942,2629235,2630,2626605
9118,Musa Juwara,41,1869400,7436567666063897,228,3215855,1455917,1456,1454461
9119,Julius Kade,69,1563700,6939433126259481,416,4448309,806516,807,805709
9120,Kristijan Kahlina,61,4449300,9229322467204321,627,7994726,6599724,65998,6533726
9121,Rami Kaib,45,1407200,7843845232357647,250,2932687,10104,1011,9093
9122,Alec Kann,52,904800,6325204216462697,292,2677895,779813,7799,772014
9123,Burak Kapacak,32,1095300,8223141884117569,148,1861092,910329,910329,0
9124,Juan Cruz Kaprof,35,420200,5076326645671174,93,731256,106657,107,106550
9125,Aytaç Kara,36,966600,5332320023288457,150,1710102,213133,214,212919
9126,Lars Kehl,53,2133300,5300396657060654,366,4683507,3829276,382928,3446348
9127,Aboubakar Keita,63,1109700,3519989370180077,338,3410339,3133350,3134,3130216
9128,Sean Kelly,36,2147100,7901294755816506,259,3417511,325163,32517,292646
9129,Kevin Kelsy,53,4878100,8554877156594476,551,8675475,5079269,0,5079269
9130,William Kenndal,35,2023500,3279236248342186,253,3431544,2384306,0,2384306
9131,Richard Keogh,41,570700,7034493326158916,142,1276637,572111,0,572111
9132,Sam Kersten,47,1980000,8788480916322752,321,3707981,3109236,310924,2798312
9133,Kaine Kesler-Hayden,31,3319400,3586380973263490,327,5050516,1780040,0,1780040
9134,Igor Kharatin,55,4364200,6909480565220297,539,8275449,6717700,0,6717700
9135,Jakub Kiełb,35,3502000,8498348717327009,371,5579678,4306392,431,4305961
9136,Niko Kijewski,60,310500,3572178610775330,214,1658670,28543,0,28543
9137,Mads Kikkenborg,53,2998000,7744351941821479,415,5700496,1737665,174,1737491
9138,Gavin Kilkenny,28,1971800,8427939575045703,201,3031784,329436,0,329436
9139,Kim Jong Woo,36,2499900,6640305904965242,262,4089890,1056585,106,1056479
9140,Kim Min Duk,63,1179100,5683329882159968,359,3484984,1569513,1570,1567943
9141,Kim Jeong hoon,34,3097100,3552290858290317,309,5033800,2038539,2039,2036500
9142,Kim Hyun,48,1176600,3488518069772795,241,2567755,2275604,0,2275604
9143,Kim Jin Ho,44,2374300,8752820011804235,340,4496924,3230393,323040,2907353
9144,Étienne Kinkoué,41,4884000,5282887252177823,532,8165597,6354776,63548,6291228
9145,Kristian Kirkegaard,44,4443400,7571716302259522,482,7201522,690511,0,690511
9146,Pål Alexander Kirkevold,48,2013200,7570561931491508,294,3844510,653324,65333,587991
9147,Ryan Kitto,30,584400,4596028418467604,83,837522,45552,0,45552
9148,Arda Kızıldağ,37,3030900,9405708111723645,322,4788967,1318031,0,1318031
9149,Carl Klaus,53,3477600,6831733877823114,520,7028493,6686687,0,6686687
9150,Florian Kleinhansl,34,4915300,3384097535205696,474,7706682,5604196,561,5603635
9151,Thibault Klidje,28,2682600,3504905748675438,245,3890529,986821,987,985834
9152,Tobias Klysner,57,4888300,4986212091003267,540,8058734,7003134,7003134,0
9153,Josh Knight,67,1543400,6090321317202847,409,4334915,73900,0,73900
9154,Jonas Knudsen,58,4903700,9333062125170468,672,9697664,8850981,8850981,0
9155,Magnus Knudsen,46,1580000,5345163036180853,241,2693169,1639872,1639872,0
9156,Erling Knudtzon,47,2629900,9381151908566846,376,4809736,725481,7255,718226
9157,Koffi,51,3416500,8214835307141994,449,5734406,1556516,15566,1540950
9158,Martin Konczkowski,25,4811500,6577460286060387,389,6475761,5081606,5082,5076524
9159,Morten Ågnes Konradsen,62,2256500,7032409553856784,489,5027356,4569540,45696,4523844
9160,Luuk Koopmans,42,4937200,8179187710443556,460,7248155,1166406,0,1166406
9161,David Kopacz,27,759100,3706827090262052,107,1067112,550526,5506,545020
9162,Michał Kopczyński,58,4003700,5292362303018811,514,7141721,2655078,265508,2389570
9163,Pascal Köpke,62,4881600,9055607858530310,581,8137645,3684533,36846,3647687
9164,Mirko Kos,24,3984800,6259945913483297,324,5532089,879755,880,878875
9165,Nebojša Kosović,61,785400,3734569995673927,306,2667696,201125,0,201125
9166,Soichiro Kozuki,61,4523700,5562460531558916,562,7914507,1065851,1066,1064785
9167,Connor Krempicki,49,3192300,3807299185596969,422,5896688,2480726,248073,2232653
9168,Martin Kreuzriegler,40,4909900,4139672889214498,452,7682417,4350602,4350602,0
9169,Kamil Kruk,41,1133200,7151156378784201,213,2327692,2168539,2169,2166370
9170,Kevin Martin Krygård,62,3826900,6499013176816222,568,7337972,5920792,59208,5861584
9171,Dawid Kurminowski,27,2830400,7049959492789499,241,3705687,2058787,0,2058787
9172,Markus Kuster,66,553400,5589193360719593,323,2862342,2550921,25510,2525411
9173,Owusu Kwabena,57,3003400,5057823778699290,434,5616319,5580215,55803,5524412
9174,Brighton Labeau,60,3486300,7331313008572595,493,6810675,2348894,235,2348659
9175,Carlos Labrín,32,1071200,4531081292603507,119,1493494,701636,0,701636
9176,Patrik Karlsson Lagemyr,63,1253500,5227224336658916,341,3332745,3223611,3223611,0
9177,Sami Lahssaini,48,2935800,9485817327433242,337,4530017,3435244,344,3434900
9178,Senne Lammens,33,2344900,5092164501806199,234,3761762,733725,733725,0
9179,Niklas Lang,26,616000,3733478708837835,84,833898,576039,57604,518435
9180,Michael Langer,51,1865200,8200188335416550,285,3520597,3374705,3375,3371330
9181,Javi Lara,27,4057600,9791398556350298,319,5918964,1022348,103,1022245
9182,Gorka Larrucea,43,2232200,4604441504518510,313,3942355,397410,3975,393435
9183,Ariel Lassiter,31,1095300,9864175437426745,171,1901974,1595849,0,1595849
9184,Tobias Lawal,47,4802200,7886021087872622,583,8509348,4988441,499,4987942
9185,Aleks Ławniczak,34,2641700,5264166675817401,279,4275498,686793,0,686793
9186,Marko Lazetić,27,4682000,4616525772057777,368,6600195,3768056,37681,3730375
9187,Miles Leaburn,57,4516900,7507982021631619,607,8609372,6940582,6941,6933641
9188,Migue Leal,68,2966000,3230557168750749,528,6320379,5114526,0,5114526
9189,Adrien Lebeau,28,2585400,3390042356495580,235,3683815,1582610,1582610,0
9190,Lee Min Gi,59,520200,8650364677675012,245,2077877,1085565,108557,977008
9191,Lee Yong,55,924100,3470860036148530,258,2588448,2485473,24855,2460618
9192,Elliot Lee,49,3966000,8298694791782913,436,6807576,3829184,382919,3446265
9193,Lee Jin Yong,25,2785800,7109580686522284,219,3694695,1577691,157770,1419921
9194,Lee Gwang Yeon,68,2483900,9471804031698439,480,5709368,4505172,450518,4054654
9195,Nahuel Leiva,67,4346500,5296756166313605,570,7715934,62658,0,62658
9196,Félix Lemaréchal,63,1790800,3898726843843952,371,4235178,2313927,0,2313927
9197,Geoffrey Lembet,37,3262100,6719159809018006,303,4617220,1321633,1322,1320311
9198,Pierre Lemonnier,44,3225800,4826927881706687,412,5356416,2132478,213248,1919230
9199,Maicol León,52,4797600,8571198136903390,599,8657246,7961142,79612,7881530
9200,Marc Leonard,42,1519800,9113198007692334,228,2844519,469635,4697,464938
9201,Jakob Lewald,60,3237500,4480786825205280,503,6340799,2001584,0,2001584
9202,Dean Lewington,61,1653800,3137685750646606,400,4434149,3925806,3925806,0
9203,Harry Lewis,50,1164000,7320098985881283,226,2436513,196973,1970,195003
9204,Clayton Lewis,63,542300,4944212061380830,314,2815044,1006107,100611,905496
9205,Tobe Leysen,53,2368400,7583398035579282,364,4807675,978174,0,978174
9206,Li Ke,40,310300,6923002632164615,145,1051574,709248,0,709248
9207,Isac Lidberg,60,4532500,7035211821251083,615,8012192,7730979,0,7730979
9208,Victor Lind,70,2883000,6510405997277859,497,6361739,454753,455,454298
9209,Jamie Lindsay,33,4584000,7792511511497717,393,6730763,2057402,0,2057402
9210,Lucas Lingman,41,1641700,3628303303561256,229,2798650,2627736,0,2627736
9211,Allan Linguet,49,1066400,9064719739310458,264,2834138,2644856,2645,2642211
9212,Adrian Lis,46,378300,6863157746492997,200,1515219,1286031,12861,1273170
9213,Liu Yiming,60,3435200,8797468200055297,511,6970040,3286772,0,3286772
9214,Javi Llabrés,53,1603200,5605691163490737,323,3803081,3593473,0,3593473
9215,Enric Llansana,64,1642300,9214666817672604,357,3892600,1751713,17518,1734195
9216,Francesco Lo Celso,55,4067700,4504286548965426,501,7316882,2259027,225903,2033124
9217,Kristoffer Løkberg,45,1246800,6600679567106283,227,2307869,1904147,191,1903956
9218,Lars Lokotsch,66,541400,7723680565663114,324,2694227,256157,0,256157
9219,Flabián Londoño,30,2495500,3257833847576290,266,4089313,3971155,0,3971155
9220,Santiago Londoño,53,885500,5238858412953640,241,2400418,29742,0,29742
9221,Sam Long,62,3546100,8648269084007766,566,7624938,5910350,5911,5904439
9222,Emmanuel Longelo,43,4825300,8459923325280565,562,8722929,5192765,0,5192765
9223,Sergio López,68,1037700,8664159128979441,394,3745227,2634048,0,2634048
9224,López-Pinto,41,2084400,3074127296903405,285,3741553,480860,48086,432774
9225,Jeremias Lorch,59,4938200,6597854283706240,624,8804457,7535621,754,7534867
9226,Marvin Loría,40,2282800,3982195021612791,293,3758661,2386770,238677,2148093
9227,Samuel Loric,52,1475800,5006926402300604,299,3210235,1289293,12893,1276400
9228,Tom Lowery,64,2513500,5908224027243021,421,5444237,3751231,3752,3747479
9229,Lü Wenjun,25,2274800,6861711060337985,203,3122338,1260503,126051,1134452
9230,Martin Luciano,62,3570800,3473024616508154,531,7018356,944987,945,944042
9231,Oier Luengo,64,3212100,3745572162093879,476,6630975,1453784,145379,1308405
9232,Marco Lund,37,444800,8673219849553570,117,971047,630062,0,630062
9233,Marius Lundemo,46,912300,3198453051869235,214,2015450,1933380,0,1933380
9234,Andy Lyons,28,1407600,3569735185760439,141,2031762,1058074,1058074,0
9235,Craig MacGillivray,40,779100,6983701775117820,173,1767520,1696743,170,1696573
9236,Soungoutou Magassa,26,702300,9194343203512011,104,1081170,683722,0,683722
9237,Josh Magennis,25,586600,8376831026241312,59,662838,608630,609,608021
9238,Kyle Magennis,36,1607900,9389309131599380,195,2732708,726224,0,726224
9239,Paris Maghoma,41,4750600,8867227260953679,459,7148360,293025,2931,290094
9240,Gary Magnée,51,1281600,4160202016427545,245,2685922,672068,673,671395
9241,Luca Magnino,43,4070000,3417016725434624,440,6410118,1652663,1652663,0
9242,Magunagoitia,68,2701100,4041748621629088,463,5469653,1757049,176,1756873
9243,Hicham Mahou,64,4540700,3989995347739987,650,8867019,5171186,51712,5119474
9244,Mikkel Maigaard,69,3892700,5699373053766500,638,8186057,897843,898,896945
9245,Curtis Main,36,2030100,8260318368829753,247,3606594,399726,0,399726
9246,Tomasz Makowski,49,2227600,5505562227400257,370,4489046,2456179,0,2456179
9247,Adilson Malanda,49,977300,3487598790599704,254,2578808,680543,0,680543
9248,Mariusz Malec,61,884400,4467131458213403,261,2421870,2108349,211,2108138
9249,Yonas Malede,43,4846600,5166851508512586,465,7613315,2279274,228,2279046
9250,Eros Mancuso,63,4143900,7903434797263719,562,8002191,2734239,27343,2706896
9251,Danny Mândroiu,22,3797900,6589385358806930,260,4947969,1932954,0,1932954
9252,Luca Maniero,57,3249700,3382887726418565,460,6037324,170900,170900,0
9253,Mantilla,36,2944300,8540058866673209,343,5159017,3396886,340,3396546
9254,Jhon Marchán,46,4352800,6817129986110781,510,7516746,2860034,0,2860034
9255,Paul Marie,50,4926100,4637177141648945,504,7695075,4729509,4729509,0
9256,Miguel Luís,59,4978500,5118242249750533,677,10176422,7268483,0,7268483
9257,Luis Miguel Marquines,22,529500,3442760786260098,36,373989,82290,82290,0
9258,Manuel Marras,64,1705300,5162959517991057,404,4466379,3439511,0,3439511
9259,Unai Marrero,41,1627500,4915308274263534,255,3102201,2382566,2383,2380183
9260,Ander Martín,45,2714200,7612542192146734,372,4887614,481926,48193,433733
9261,David Martínez,53,2111300,3175790837694766,340,4135047,2628026,26281,2601745
9262,Gabri Martínez,39,338200,7830681810497397,130,989708,979144,0,979144
9263,Luca Martínez Dupuy,38,4183800,8102058716690245,409,6539018,6090435,609044,5481391
9264,Carlos Martínez,56,3643700,3639433040617864,487,6689558,5665456,567,5664889
9265,Pietro Martino,66,3318400,7608445414732901,536,6379897,4976334,498,4975836
9266,John Mary,38,3899000,7337927092246438,430,6424617,617660,618,617042
9267,Mascarenhas,33,4417600,6539689207098995,432,6472510,5862077,5862077,0
9268,Igor Matanović,47,1757100,8539975454157533,291,3595434,2030398,2031,2028367
9269,Jay Matete,52,2867900,3004775336081676,432,5979290,1681833,168184,1513649
9270,Patricio Matricardi,25,431800,8310911910846764,34,309792,27390,274,27116
9271,Tashreeq Matthews,31,3672500,5781541152972184,336,5066493,1461134,147,1460987
9272,Alan Matturro,31,2207100,7673182496508391,252,3755840,846251,0,846251
9273,Jimmy Maurer,31,4210100,8499407224299181,435,6990851,933703,933703,0
9274,Chris Mavinga,40,1834000,9661015240829564,262,3224612,569954,0,569954
9275,Adam May,56,4005800,8732489428959770,479,6678410,5309816,531,5309285
9276,Dylan Mbayo,32,3357800,6940753578275693,308,5125916,3684237,368424,3315813
9277,Conor McCarthy,49,4983400,5923351404303000,499,7282546,3909956,391,3909565
9278,Robby McCrorie,45,3367900,7136699315160610,382,5388690,4637788,46378,4591410
9279,Aaron McEneff,47,4944200,7000096083220290,521,8309040,7009262,7010,7002252
9280,Michael McGovern,37,3728000,4723648339954078,434,6331867,2307514,0,2307514
9281,Jamie McGrath,50,3342300,7668047285645141,413,5831797,4703569,0,4703569
9282,Marcus McGuane,53,4526900,4106403344153816,575,8703523,4431938,44320,4387618
9283,Tommy McNamara,32,3533200,7954347240002422,377,5748621,1784128,17842,1766286
9284,Shaun McWilliams,30,2336300,8035983209817269,245,3526498,2789686,0,2789686
9285,Mexx Meerdink,58,2055600,5321854421806787,373,4252163,2796959,280,2796679
9286,Nayel Mehssatou,65,1503000,7255952358393383,397,4186186,234098,235,233863
9287,Aaron Meijers,34,3967700,5328277638010013,422,6408319,5582108,0,5582108
9288,Álvaro Meléndez,66,2674800,6366802229827635,477,5716263,3260619,0,3260619
9289,Aleksander Melgalvis,31,2853100,7330817371102015,298,4131190,1822784,182279,1640505
9290,Kyrylo Melichenko,39,3767900,7898054226077066,440,6475974,28716,28716,0
9291,Nacho Méndez,68,4669300,4240049744174001,634,7983216,1356620,135662,1220958
9292,Kevin Mensah,39,4992800,9024080135127823,468,7827928,7290191,0,7290191
9293,Juan Mercado,58,2686600,5229850954994659,434,5391366,1911156,192,1910964
9294,Patrik Mercado,37,4459700,6416279718731268,448,7178376,1718195,1718195,0
9295,George Merloi,31,2751500,5352053477791965,273,4138704,3516845,0,3516845
9296,Andrea Meroni,60,3525600,5643191940947448,490,6286480,5607418,561,5606857
9297,Tayeb Meziani,35,3602400,9686609375133968,342,5334636,4544018,4545,4539473
9298,Benji Michel,63,3565700,3131484995199345,524,6625989,5445403,54455,5390948
9299,Thomas Mikkelsen,59,1300100,8385358410564487,348,3748825,2977141,2977141,0
9300,Tommaso Milanese,64,4842600,3815501378270774,631,8559159,3944339,3945,3940394
9301,Matt Millar,43,4396100,7866186069531364,477,6520318,1519458,151946,1367512
9302,Mato Miloš,66,4949500,4582049627959036,623,9158196,4728708,472871,4255837
9303,Deni Milošević,42,1357200,6252657774842495,213,2514229,487886,0,487886
9304,Alan Minda,26,4263300,7501977902533587,411,6451662,6433333,643334,5789999
9305,Pablo Minissale,56,951500,8626336275530636,293,2756920,2477116,2478,2474638
9306,Yankuba Minteh,56,4197400,5179128561736311,481,7134534,423157,423157,0
9307,Andrei Miron,33,905100,9402850827278765,128,1556395,268630,2687,265943
9308,Alex Mitchell,29,4918200,4660061564347571,460,7737544,6547144,6547144,0
9309,Manny Monthé,52,1718500,8908416738667584,310,3653582,1114152,0,1114152
9310,Lautaro Montoya,25,3894500,4406660278578013,334,5558724,2665771,26658,2639113
9311,Lewis Montsma,63,2655200,9610285588918110,468,5510809,4338705,4339,4334366
9312,Taylor Moore,27,2358200,9689799096550835,232,3406146,1799838,0,1799838
9313,Morelatto,63,3720800,7276515692185122,583,7827548,1705659,1705659,0
9314,Juan Moreno,54,2317000,9507858868707345,359,4905424,4071032,40711,4030321
9315,Alex Moreno Paz,54,4665100,9585633372056276,507,7844078,4662185,0,4662185
9316,Ziv Morgan,68,2573200,7152628012381672,453,5496354,1774704,177471,1597233
9317,Miguel Morro,55,3447300,7070113307715312,485,6282442,765156,0,765156
9318,Mortimer,50,707700,5367038880154714,189,1686211,815189,8152,807037
9319,Vitinho,58,3883100,4965430346426806,498,6673559,5475231,547524,4927707
9320,Chuca,68,3648000,9964233517713125,591,7941480,48589,486,48103
9321,Sebastian Mrowca,29,3397100,5268011996159971,336,5287939,5187844,519,5187325
9322,François Mughe,66,3720000,8211467217082485,594,7670869,5955848,595585,5360263
9323,Paul Omo Mukairu,49,2818500,6624577353099009,420,5552174,539542,539542,0
9324,Romaine Mundle,43,4170500,8061152513272135,465,6660148,6417274,64173,6353101
9325,Andrés Murillo,65,1093800,7651361836846966,365,3334712,2707386,0,2707386
9326,Gonzalo Muscia,54,3170900,5213401419854281,450,5426981,1348510,13486,1335024
9327,Alen Mustafić,39,1306800,9373737622368489,197,2370128,2151994,0,2151994
9328,Marlon Suliman Mustapha,23,4794300,6682982387979614,424,6958781,530830,5309,525521
9329,Gabriel Mutombo,43,1549000,8340412487386801,256,2923078,1454413,0,1454413
9330,Felix Horn Myhre,39,2903100,9179599196869225,321,4778450,4352005,0,4352005
9331,Jean N'Guessan,46,2414600,5719109879258574,318,4268304,1334307,1335,1332972
9332,Nicolai Næss,62,748000,3533186372159980,342,2878784,2490315,2490315,0
9333,Yehor Nazaryna,37,4273700,5230108412196726,446,7130481,2267447,0,2267447
9334,Logan Ndenbe,39,3756100,8978936277439936,436,6890994,2844303,285,2844018
9335,Radu Negru,66,3846200,3923102127088634,617,8004080,5216822,0,5216822
9336,Adam Nemec,48,4795500,5781365013004659,499,7538778,4889003,4889003,0
9337,András Németh,61,4631500,4281078553025418,616,8888064,1123705,1123705,0
9338,Nahom Girmai Netabay,31,4211500,7637222190293766,372,6203122,1574958,0,1574958
9339,Sam Nicholson,59,1501300,7142037712624167,328,3570007,1513426,152,1513274
9340,Moritz Nicolas,52,468600,9606879350202176,241,1989613,495364,0,495364
9341,Hans Nicolussi Caviglia,26,3372800,7001041348075236,326,4678581,3014199,3015,3011184
9342,Jonas Nietfeld,61,4167000,5750190157325810,579,8244241,3123886,0,3123886
9343,Sven Nieuwpoort,51,2539000,6172991127241026,355,4825711,1072701,1073,1071628
9344,David Noboa,48,2214600,6304852345606076,311,4280252,3209860,0,3209860
9345,Will Norris,28,713500,3816300789676301,103,1013037,892273,89228,803045
9346,Michael Novak,39,1216500,4256936247407940,214,2389873,666723,0,666723
9347,Isaac Nuhu,57,2967500,6882971557935902,496,6120543,1743174,175,1742999
9348,George Nurse,52,3736800,9233137568591059,421,6559070,2365794,237,2365557
9349,Eoghan O'Connell,54,4688600,9575252733294229,577,8172794,2147095,0,2147095
9350,Corey O'Keeffe,62,2117700,9127248997355765,413,4948515,767670,768,766902
9351,Brandon O'Neill,44,2465300,8214764338525029,315,4231147,4118206,0,4118206
9352,Răzvan Oaidă,52,1973300,5784437250211158,323,3694164,2078640,0,2078640
9353,Dorinel Oancea,68,430900,4670474853812845,311,2547722,213367,213367,0
9354,Agustín Obando,48,2077200,6543479896483950,281,3770710,856213,0,856213
9355,Obrador,51,1365600,6008539817922027,304,3339795,421271,421271,0
9356,Yutaro Oda,58,401400,3211009443420881,270,2094895,263900,26390,237510
9357,Tim Oermann,54,3108600,3840942439723956,423,5484823,629221,0,629221
9358,Chinonso Offor,52,3637900,9719998455536588,396,5947971,5358043,0,5358043
9359,Connor Ogilvie,59,1825700,4973557102101097,369,4041039,701607,702,700905
9360,Sebastian Ohlsson,68,4554100,4659752380570557,718,8635905,7608731,760874,6847857
9361,Luis Ojeda,66,1529100,3551250367242359,426,4340327,3411052,342,3410710
9362,Sheyi Ojo,29,3247800,6087869223413008,325,4951263,2656023,0,2656023
9363,Davíð Kristján Ólafsson,32,3139200,4191600782089665,304,4918056,2892809,289281,2603528
9364,Stefano Olaya,45,2118800,8523311746892838,260,3564781,4581,4581,0
9365,João Gonçalves,23,1376700,9594305442941416,105,1720284,395659,0,395659
9366,Wenderson,32,704200,9758104922124080,118,1256111,402440,0,402440
9367,Patrick Olsen,58,3178200,6728191018015517,427,5630502,3436272,3437,3432835
9368,Freddy Oncoy,52,1844900,7087242150515388,369,4216660,2216088,221609,1994479
9369,Gaël Ondoua,40,4624300,4005374346967982,475,7687208,6059990,6060,6053930
9370,Nathan Opoku,52,1492400,5680065354107373,325,3532158,2093540,0,2093540
9371,Fredrik Oppegård,70,767200,4998138277239482,380,3235608,1124029,0,1124029
9372,Sakarias Opsahl,29,4985400,3901706614567187,431,7025319,2008503,0,2008503
9373,Dominik Oroz,64,2984000,5716528191694735,515,5895251,5126106,512611,4613495
9374,Alexander Oroz,51,2497000,6221194482195530,381,5001654,3809891,381,3809510
9375,Michael Ortega,52,1859600,9112751129909211,354,3964864,1501716,150172,1351544
9376,Jacob Ortmark,69,2736500,6755159844992851,519,6277141,1144431,1144431,0
9377,Tomáš Ostrák,34,4104900,7776385488050473,386,6334609,1825758,182576,1643182
9378,Anas Ouahim,64,4853000,4981067373241119,631,8330951,2818108,0,2818108
9379,Yassin Oukili,35,4810000,9229018894584188,434,7498788,11506,11506,0
9380,Bryan Oviedo,22,3049000,9941063780795148,289,4343775,3201481,3201481,0
9381,Leonard Owusu,22,2101000,8133776791904442,160,2954236,1395564,1396,1394168
9382,Leeroy Owusu,63,3706500,6777073768903722,577,7652609,4602570,460257,4142313
9383,Deabeas Owusu-Sekyere,48,3408800,4715783399044999,388,5209629,3956709,0,3956709
9384,Yusuf Özdemir,64,2510400,7685142225463226,479,5621047,4261884,42619,4219265
9385,Bahadır Öztürk,67,4394700,9443148067833601,639,9245777,2652479,266,2652213
9386,Guillermo Pacheco,37,2354100,8245970600306659,255,3775310,817008,818,816190
9387,Dani Pacheco,67,318900,9322497619785626,268,2042801,1675572,16756,1658816
9388,Guillermo Paiva,47,1856700,5616477393399266,305,3832884,171226,171226,0
9389,Brahian Palacios,62,1847700,4466052377403967,372,4283242,1790348,179035,1611313
9390,Murat Paluli,31,4263000,9196692069330241,423,6930227,2701879,0,2701879
9391,James Pantemis,51,773200,5064570991453300,250,2418373,2253828,2254,2251574
9392,Paul Papp,40,1389200,9406305745872808,205,2524765,1831619,0,1831619
9393,Marcelo Paredes,66,1456500,8401713451216697,379,4181405,3659603,0,3659603
9394,Vittorio Parigini,34,4180400,3089300431595595,427,6630276,2494499,24945,2469554
9395,Issouf Paro,60,4720400,7147957999242008,578,8126778,3573165,358,3572807
9396,Callum Paterson,59,2447800,8683207728816620,419,5101450,4278193,428,4277765
9397,Jack Payne,30,2931400,4115297661563985,305,4473842,1466237,1466237,0
9398,Halil İbrahim Pehlivan,52,3122100,4786081974034781,437,5757234,2810327,2810327,0
9399,Álvaro Peña,54,1054400,5209818099245954,322,3149498,2696357,0,2696357
9400,Héber Pena,65,1396900,5254851051092326,349,3792297,2014724,2014724,0
9401,James Penrice,41,2435700,7326194982753329,317,4101106,1916413,191642,1724771
9402,Serginho,55,4876500,5329351559513666,552,8669115,7483189,0,7483189
9403,Romário,22,4668300,9164002423612276,347,6118518,1421067,0,1421067
9404,Francisco Perruzzi,63,1386800,9566045385275226,382,3888965,971715,0,971715
9405,Stefano Pettinari,37,4443500,6693429391979626,457,6664245,5953330,0,5953330
9406,Álex Petxa,62,3975500,5155930650075172,584,7792110,263068,263068,0
9407,Franz Pfanne,37,909900,8978145322222524,163,1780450,573785,57379,516406
9408,Luca Philipp,37,2348000,8816330470683400,282,3706239,3608744,360875,3247869
9409,Piao Cheng,34,4887200,8184211358224439,516,7459888,3802140,0,3802140
9410,Balthazar Pierret,42,3213400,4657513229340271,348,5350979,4477466,44775,4432691
9411,Juan Pablo Pignani,45,2603000,4113571994444500,356,4611174,4035701,403571,3632130
9412,Mauricio Pineda,27,3688400,9825678438383449,322,5359474,4842056,484206,4357850
9413,Mitch Pinnock,50,3927800,5120660042319503,439,6954205,3482900,3483,3479417
9414,Damián Pizarro,37,4534900,5337165730951174,422,6973061,1571490,15715,1555775
9415,Peter Pokorný,45,2333500,5625204677995093,294,3889708,1607103,16072,1591031
9416,Dennis Politic,38,1584400,4869128124614477,215,2695001,653444,653444,0
9417,Joaquín Pombo,48,428400,5873880853547240,202,1624592,807194,808,806386
9418,Facundo Pons,62,422100,7760736218094707,317,2512037,673459,6735,666724
9419,Simone Pontisso,44,4483800,9551146831173042,507,7611469,5363984,0,5363984
9420,Rareș Pop,51,3005000,3607518094241236,424,5411921,1686364,16864,1669500
9421,Daniel Popa,54,1419900,5873128137467151,362,3636583,265950,26595,239355
9422,Doru Popadiuc,40,642000,8970562267983869,176,1699605,279854,0,279854
9423,Danny Post,50,4610500,9358556505590113,543,7911624,7425603,743,7424860
9424,Rico Preißinger,42,1554400,6877537155183364,242,2827899,1475520,147552,1327968
9425,Dominik Prokop,42,1735000,8280900011533309,225,3142869,84208,84208,0
9426,Rubén Pulido,46,502200,8859151237217574,171,1532317,188334,188334,0
9427,Arkadiusz Pyrka,37,4347600,4142851096893391,460,6839192,3254742,325475,2929267
9428,Mergim Qarri,69,3103900,3142570939133798,491,6353150,2878317,2878317,0
9429,Joshué Quiñonez,66,4163500,6255258804446555,655,8089967,2426536,2426536,0
9430,Hugo Quintana,68,3542500,6610339598886143,554,7115381,2383528,23836,2359692
9431,Jairo Quinteros,48,772300,7086709649122020,245,2196306,318083,318083,0
9432,Máximo Rabines,53,1898200,6222670229366872,341,3760120,16801,1681,15120
9433,Haris Radetinac,27,2622700,7166649628383468,277,4377915,2425684,242569,2183115
9434,Lorenzo Rajot,25,2662400,9088984106653917,193,3554015,1452438,145244,1307194
9435,Mileta Rajovic,28,4135100,6822160872880416,349,5961278,5491985,54920,5437065
9436,Alejandro Ramírez,53,2473600,3941746705011370,376,4557958,2254288,225429,2028859
9437,Samir Ramizi,57,3571500,9364864791269145,516,6804066,2453290,24533,2428757
9438,Moha Ramos,43,3371100,3699111372181161,350,5690396,754269,75427,678842
9439,Calvin Ramsay,43,653200,9906872032518171,175,1549898,1504967,1505,1503462
9440,Lars Mogstad Ranger,66,2356600,7927898617500851,408,4773856,4147953,4148,4143805
9441,Federico Ravaglia,40,2817100,5875501691501836,312,4502032,4400542,441,4400101
9442,Henrich Ravas,26,1081400,5437848089340124,116,1553178,1279223,0,1279223
9443,Daniel Rebollo,65,3536400,6834296947185042,461,6494984,678916,0,678916
9444,Martin Regáli,59,411300,3476185342614590,255,1924328,1772143,1772143,0
9445,Max Reinthaler,31,2127300,9103660125899404,229,3138712,1321185,133,1321052
9446,Rocco Reitz,55,1881900,9480657860335752,372,4236305,4042722,405,4042317
9447,Martin Remacle,28,1387800,8882972404283343,147,1979232,143635,144,143491
9448,Gabriel Brazão,27,1538900,9766593985017415,185,2394923,359272,35928,323344
9449,Torben Rhein,40,4171300,6550345758903467,463,6888390,3895890,3896,3891994
9450,Julian Riedel,45,4797800,5569582845849085,524,7993116,1328945,1329,1327616
9451,Dante Rigo,55,1212600,6528759114172489,276,3026760,2809580,2810,2806770
9452,Rim Chang Woo,27,2135000,5530063528557045,209,3119978,1953403,195341,1758062
9453,Lautaro Ríos,60,931800,6614306150831753,299,2786452,2280208,2281,2277927
9454,Marvin Rittmüller,55,1892500,3074311323850856,355,4281566,2717003,0,2717003
9455,Juan Daniel Roa,46,4771300,6360275538282322,496,8288026,5861239,58613,5802626
9456,Liam Roberts,70,3127900,5585534997962386,586,7023479,1063245,10633,1052612
9457,Haydon Roberts,55,4966400,3491082733907706,625,9098764,888413,0,888413
9458,Yohan Roche,57,2437300,3247765090413451,431,4940762,187213,188,187025
9459,Gabriel,44,4045000,6912945875280652,485,6405125,1761046,1761046,0
9460,Facundo Rodríguez,61,3737000,4589496333981187,532,7290327,5770717,57708,5713009
9461,Gregorio Rodríguez,65,1528500,3828785332774521,400,4044474,3652227,366,3651861
9462,Memo Rodriguez,48,3573400,9108018895407696,453,6638373,5661475,5662,5655813
9463,Martín Rodríguez,62,4252800,6512247115904582,549,7753681,3254904,32550,3222354
9464,Godfried Roemeratoe,52,1731200,6270048425536779,321,3852122,3156506,0,3156506
9465,Merlin Röhl,43,1040300,5717626537048545,230,2432293,264961,264961,0
9466,Tito Rojas,43,1269800,7424937468809668,218,2579504,578894,5789,573105
9467,Marcel Rømer,50,4429800,8323097940471059,534,7719916,1981130,1981130,0
9468,Luis Romero,67,4822300,8207159486350987,662,9331474,9066625,906663,8159962
9469,Matías Romero,25,1195800,7887308814899854,112,1447017,477045,4771,472274
9470,Manuel Romero,25,1213100,3066201646756877,119,1521407,470234,4703,465531
9471,Carlos Romero,70,960000,4963379605236979,381,3644992,500156,500156,0
9472,Tim Rönning,55,3159600,3559551059116439,403,5493423,58899,589,58310
9473,Maurides,30,3002800,6591670730512899,258,4132325,2840015,28401,2811614
9474,Lindsay Rose,48,1603900,9437892223361971,264,3170173,1852772,185278,1667494
9475,Anthony Rosell,70,3102900,7918689980903975,529,6339050,1667555,1667555,0
9476,Oriol Rosell,22,2680100,8567629104306470,228,3554823,263249,0,263249
9477,Maciej Rosołek,55,4749500,9560819197415555,605,8137514,4389832,438984,3950848
9478,Jean Pierre Rosso,48,3394500,8997202383497190,485,6775062,700143,7002,693141
9479,Sigurd Rosted,70,2373700,8192529417489181,543,6576322,5688783,568879,5119904
9480,Neluț Roșu,44,1996100,5842555532682691,273,3569803,787884,7879,780005
9481,Tom Rothe,32,2954200,3214433747404170,300,4633148,4130272,413028,3717244
9482,Paolo Rozzio,41,1265200,5602920992395345,178,2098499,1913214,192,1913022
9483,Jack Rudoni,33,2534600,6331557409085348,280,3991731,2329296,233,2329063
9484,Josh Ruffels,60,3392500,7023051529672853,517,7138413,1317381,131739,1185642
9485,Gabrijel Rukavina,26,2464100,9676163208469386,224,3436298,1619468,161947,1457521
9486,Besard Sabovic,37,4092000,7251854027786923,385,6422356,6315564,0,6315564
9487,Malkolm Nilsson Säfqvist,67,4341100,7498262210756638,635,8772516,6987337,699,6986638
9488,Pavol Šafranko,31,2037700,8438334049404578,206,2989778,851510,8516,842994
9489,Kike Salas,24,2602800,9764982686355110,228,3544686,3247119,3248,3243871
9490,Andrés Salazar,49,2857700,5994556627118553,342,4797031,1662247,1662247,0
9491,Alan Saldivia,57,3946300,4114398021234137,521,7495467,6824053,68241,6755812
9492,Esteban Salles,53,3005000,9460135466965794,409,5658835,4678286,0,4678286
9493,David Sambissa,53,1177700,8531051154487168,263,2685798,1786560,1787,1784773
9494,Edi Semedo,32,4173900,6961066846291595,419,6195105,4957706,49578,4908128
9495,Renzo Sanchez,67,4748100,4794931278181833,663,8968528,1727753,173,1727580
9496,Jordi Sánchez,60,545100,4852280432023297,240,2062867,773716,774,772942
9497,Marcus Sandberg,23,1506700,6832383033682066,136,2051383,26182,26182,0
9498,Rafael Santos,52,3597100,4090660341334553,485,6535624,1761284,177,1761107
9499,Bruno Leite,34,1607100,4365827888467918,231,2955322,1493180,14932,1478248
9500,Álvaro Sanz,24,4476000,5250250730076428,366,6469239,6378643,6378643,0
9501,Anthony Sauthier,41,3934900,5969817401258180,445,6635437,1672150,1672150,0
9502,Dominik Schad,40,4464200,7062148566548589,477,7287872,433199,4332,428867
9503,Manuel Schäffler,38,1367000,8091707233823837,224,2511369,1966304,19664,1946640
9504,Anthony Schmid,24,4807900,3475090563193219,367,6751711,1171876,118,1171758
9505,Isaac Schmidt,69,3315000,4761140587683160,574,7218406,3695427,36955,3658472
9506,Sam Schreck,46,1343400,3725539418942831,266,3017200,1625573,162558,1463015
9507,Tim Schreiber,51,2065900,3131558471921040,372,4206016,3190123,319013,2871110
9508,Eduardo Brock,69,1803100,8190727403393597,405,4148741,693289,0,693289
9509,Markus Schubert,39,4385700,3590820385560336,473,7048975,3237945,3237945,0
9510,Crivellaro,61,3771100,3284785347404038,567,7256197,855553,856,854697
9511,Kofi Schulz,62,4616400,7446755987707668,634,9089134,209282,2093,207189
9512,Maximilian Schulze Niehues,35,1255400,5188707485281335,181,2275029,1351852,135186,1216666
9513,Pascal Schürpf,27,3665500,7438428506502766,351,6039905,2960118,296012,2664106
9514,Anthony Scully,36,4858700,3053774346040639,424,7483480,3804945,0,3804945
9515,Edson Seidou,55,538500,3975583850399813,245,2159043,439262,0,439262
9516,Egil Selvik,47,1165800,6975472821123665,225,2343378,2233704,2233704,0
9517,Marvin Senaya,56,1675400,4278451131790671,355,3787084,2645658,0,2645658
9518,Kaly Sène,35,4366000,9541770603451289,413,6733938,435859,436,435423
9519,Mateo Seoane,37,4741500,8149588930271478,449,6625133,3914328,0,3914328
9520,Nelson Sepúlveda,32,2210200,6520454773440844,207,3069789,365433,365433,0
9521,Liam Sercombe,51,4507500,9007262334566387,477,7835106,1895094,190,1894904
9522,Josh Sheehan,36,4279100,9334080019368803,487,6867886,718317,719,717598
9523,Andrew Shinnie,24,1054200,5769443493591101,62,1006829,583488,0,583488
9524,Louie Sibley,24,3854000,3459501944298685,328,5902860,1582150,1582150,0
9525,Arne Sicker,36,4530500,4951216087497613,413,6832561,3173625,3173625,0
9526,Niko Sigur,22,3254900,8865688697086745,259,4284491,4264511,42646,4221865
9527,Sebastián Silva,67,642100,6082893124394268,331,2999086,1366509,1367,1365142
9528,Fábio Nunes,45,3708200,5046582520227228,482,6491893,3022587,3022587,0
9529,Samuel Silvera,47,2045200,6319006771335375,314,4167924,2948363,294837,2653526
9530,Gabriel Simion,49,1245900,8998661150479730,272,2878258,1990243,1990243,0
9531,Tyreece Simpson,53,4800700,6136853992284854,532,8438014,3783546,0,3783546
9532,Mario Šitum,61,3872000,8232940194142069,470,6711013,5612748,0,5612748
9533,Maxime Sivis,41,2918300,6384524154907055,311,4591537,294149,0,294149
9534,Simon Skrabb,53,4803900,9862049671893432,560,7932197,2457810,2457810,0
9535,Callum Slattery,47,4035500,5449451296990876,444,6811150,1090745,1091,1089654
9536,Petar Slišković,38,4718500,8896845601657891,479,8237446,4022134,4023,4018111
9537,Richard Smallwood,58,3752400,9822740724454943,548,7070110,6162293,617,6161676
9538,Nathan Smith,55,391400,5323001990050797,218,1797072,357647,3577,354070
9539,Brad Smith,27,2612700,9392556350100062,270,4039418,2417168,241717,2175451
9540,Magrão,50,2680700,8853169586792098,396,5194387,2378448,0,2378448
9541,Artur Sobiech,49,574300,5421073532022846,245,2164241,1773294,17733,1755561
9542,Alexander Søderlund,51,418300,6582863867203990,195,1697022,1562019,0,1562019
9543,Simon Sohm,39,344300,9921348725566766,107,758639,432856,0,432856
9544,Markus Solbakken,26,3815800,9228419829674436,347,5868322,1598431,1598431,0
9545,Sven Sonnenberg,47,4872500,5919737812262906,589,9207454,4762675,0,4762675
9546,Oliver Sørensen,40,4156400,6594391451224930,434,7088484,3598701,3599,3595102
9547,Bent Sørmo,22,3964200,9680320848239227,309,5793089,1277983,127799,1150184
9548,Andrés Souper,28,4765600,9366223898689096,389,6466207,5494929,5495,5489434
9549,Samuel Souprayen,67,1144500,3160012534901736,317,3250655,227489,2275,225214
9550,Verdasca,29,4585000,6978064694098568,412,6795515,252723,2528,250195
9551,Agostino Spina,50,1515700,9499607914448605,320,3638140,1952562,195257,1757305
9552,Blair Spittal,39,2618400,9776535900266655,324,4591585,2567474,256748,2310726
9553,Florin Ștefan,31,1372900,5023591898567821,167,2200435,1485883,14859,1471024
9554,Phillipp Steinhart,47,508800,6631706737142007,181,1521252,572957,0,572957
9555,Michael Steinwender,49,3527100,4468186330422280,452,6828693,6517137,652,6516485
9556,Lewis Stevenson,47,3978300,4209462789883035,485,6977124,4488134,0,4488134
9557,Cole Stockton,64,4168300,4556739546377810,619,7647361,5841522,5841522,0
9558,Ionuț Stoica,38,3780200,7795594193743986,375,6372086,1738071,1738071,0
9559,Paweł Stolarski,49,974200,5117194272347767,235,2363281,2145546,215,2145331
9560,Florian Stritzel,31,2050400,9891075576597596,205,2935592,2428326,243,2428083
9561,Petar Sučić,27,2339800,8072576373586881,223,3450535,2487827,2488,2485339
9562,Lukas Sulzbacher,66,2637600,4826202800454787,471,5598065,3208241,32083,3176158
9563,Patrick Sutter,31,1009000,7755091413038795,125,1541420,13346,1335,12011
9564,Tobias Svendsen,68,3099300,4903391883564641,470,6017192,5781469,0,5781469
9565,Marin Šverko,63,4577900,4276151387494456,636,8759070,3604581,0,3604581
9566,Martin Šviderský,65,4217300,6558217910835951,596,8032849,3777081,3778,3773303
9567,Dan Sweeney,28,3642600,3834859926683234,371,5471772,4146156,0,4146156
9568,Kajetan Szmyt,33,2327300,4273559598833263,257,3539764,480452,48046,432406
9569,Przemysław Szymiński,66,1747900,7445157629553334,411,4288894,1399057,13991,1385066
9570,Ulrich Taffertshofer,70,453600,4719114452570030,278,2173020,833840,0,833840
9571,Waniss Taïbi,65,1325500,4747222908769340,369,3912081,2699795,2699795,0
9572,Atomu Tanaka,39,3264100,3692562874969442,319,5275784,3031771,0,3031771
9573,Harald Nilsen Tangen,26,3046400,6772749426633365,276,4586648,465322,466,464856
9574,Scott Tanser,22,1178300,3812902655470633,77,1320272,272167,273,271894
9575,Varol Tasar,25,2020600,5341847568541522,179,2817611,34058,3406,30652
9576,Jair,67,3806700,5002329772176445,620,8232111,2928336,2929,2925407
9577,Connor Taylor,33,4419600,8161577616591776,464,7290177,3237659,3237659,0
9578,Berkan Taz,42,4477100,6756075210874624,545,8010725,168087,16809,151278
9579,Enzo Tchato,27,979000,8581813964432222,90,1248383,1142973,114298,1028675
9580,Warren Tchimbembé,46,1632500,4686202139178536,274,3097383,2675396,267540,2407856
9581,Ernest Terpiłowski,26,3017200,7300042468774564,287,4508628,2384211,2385,2381826
9582,Dimitrios Theodorou,44,2596400,7869054052465909,360,4703975,1323562,132357,1191205
9583,Maximilian Thiel,31,4882400,3643407237346070,457,7791795,6701428,671,6700757
9584,Terell Thomas,58,1644300,5802169098440567,312,3478103,1776183,17762,1758421
9585,Ben Thompson,65,1943900,9479536126528595,467,5224487,3013911,3014,3010897
9586,Nathan Thompson,32,1907300,3294343769998178,183,2725133,359722,360,359362
9587,Simon Tibbling,51,4921000,3150532770860584,612,9371090,5928661,5929,5922732
9588,Dániel Tiefenbach,46,4451200,3715724229805795,515,7561457,3632210,0,3632210
9589,Bogdan Țîru,60,951800,8306281861111747,329,2931138,439233,43924,395309
9590,Eoin Toal,30,3925800,4538956904289037,392,6006166,4501150,450115,4051035
9591,Kristoffer Tønnessen,38,3163900,6636130957518434,356,4825600,4328967,4329,4324638
9592,Victor Torp,69,4596000,8306260776856521,588,8353742,1654643,1655,1652988
9593,Jhojan Torres,52,513300,6214199537295693,203,1790350,1249933,12500,1237433
9594,Mamadou Tounkara,67,1386300,4507553924917035,355,3594541,1186717,118672,1068045
9595,Ibou Touray,67,4985500,5128255952406484,639,9336835,896410,896410,0
9596,Ryley Towler,22,4111200,7884673827553122,369,6076408,2476142,0,2476142
9597,Mason Toye,29,3196300,8290656524909869,271,4396989,433940,434,433506
9598,Kai Trewin,31,873700,5212643588998171,101,1175752,602566,602566,0
9599,Nectarios Triantis,50,2029700,8361474735141690,326,4166557,2655969,2655969,0
9600,Nathan Trott,69,4954600,7411376200538288,703,9681132,2937904,2937904,0
9601,Connal Trueman,61,4565500,8949246200176517,590,8503035,2481846,0,2481846
9602,Keigo Tsunemoto,56,3020600,6692155364924372,466,5954178,5737044,0,5737044
9603,Aldin Turkeš,22,509100,8913428803341303,45,447966,165381,0,165381
9604,Jordan Turnbull,38,4061300,6253711979487646,387,6342837,1061358,1062,1060296
9605,Alexander Ruud Tveter,58,1053600,6093180071964629,279,2602755,1819044,18191,1800853
9606,Calvin Twigt,48,3746100,5067941251762047,523,7392674,2603524,0,2603524
9607,Nahuel Ulariaga,59,1157000,6800961253623642,359,3271744,1977403,0,1977403
9608,Braulio Uraezaña,50,1614400,9852977288946524,259,3024429,1593854,159386,1434468
9609,Bjørn Inge Utvik,32,1387200,4872539699286926,160,2204494,713337,0,713337
9610,Jhojan Valencia,26,1978800,8046219218090580,176,2728943,2022619,0,2022619
9611,Zarek Valentin,49,3548300,6677826029107434,471,6817830,4656429,4656429,0
9612,Gabriel Valverde,44,484200,9701372542307844,159,1358654,869410,0,869410
9613,Amourricho van Axel Dongen,59,3722300,5627445495472190,489,6991327,1704651,17047,1687604
9614,Damian van Bruggen,45,3753200,4550261153022665,465,6382162,2218894,221890,1997004
9615,Davy van den Berg,48,1898700,9005671122652643,321,3802456,1092096,0,1092096
9616,Mike van Duinen,66,1767000,8487840355094679,446,4534827,4102617,4103,4098514
9617,Jannes Van Hecke,60,4786600,5812074103992576,639,8762651,6439682,6440,6433242
9618,Koen Van Langendonck,43,4984700,6754736943265401,541,7878826,996611,99662,896949
9619,Syb van Ottele,42,1995900,7423836896298479,266,3527854,235827,0,235827
9620,Igor Vekič,49,947400,9397828242893274,243,2389326,2080446,209,2080237
9621,Apostolos Vellios,45,444200,5634675301321377,144,1237042,893006,0,893006
9622,Calvin Verdonk,35,1587900,9619771554547414,225,2775474,403212,403212,0
9623,Wilder Viera,26,2396800,6020623779313228,191,3160815,3057273,0,3057273
9624,Christian Viet,69,933100,4067910601663479,352,3395413,1066989,107,1066882
9625,Samuele Vignato,42,3464600,3976528501118988,417,5981236,1279565,1280,1278285
9626,Lawrence Vigouroux,41,2632000,8595669319381342,285,3974290,3724334,3724334,0
9627,Vilarrasa,55,3535700,7636389574042296,470,6255257,6182239,6183,6176056
9628,Gabriel Villamíl,69,4009500,7792922544651386,598,7618318,2352925,236,2352689
9629,Guido Villar,48,2189000,7463367022957109,325,4206122,4033846,40339,3993507
9630,Matty Virtue,55,2054700,9998940111025342,372,4421373,1699057,16991,1682066
9631,Rémy Vita,39,4165400,6003085127290448,470,7015977,1896612,1897,1894715
9632,Dario Vizinger,45,1720100,6842579726510577,270,3149606,2335509,2336,2333173
9633,Andrei Vlad,24,864600,5536527256696745,97,1113445,1025372,10254,1015118
9634,Shkelqim Vladi,59,3710400,5385023119040860,513,7052565,1961991,1961991,0
9635,Thibault Vlietinck,46,1629900,3717995661261630,294,3341262,117411,118,117293
9636,Sam Vokes,58,3348300,6052540550032744,499,6587811,464376,464376,0
9637,Davide Voltan,37,4648700,6658812063030957,433,7104566,5979995,598,5979397
9638,Julian von Moos,69,2830500,7816474222792102,459,5825720,1694691,1694691,0
9639,Modestas Vorobjovas,26,3875900,7117398131596951,311,5473207,2593068,260,2592808
9640,Silvano Vos,61,4535500,4612271545500193,609,7890748,2856748,2856748,0
9641,Nicolas Vouilloz,30,3236600,7776164819409320,312,4919525,956862,0,956862
9642,Georgios Vrakas,40,3969400,3677589141951794,401,6060400,1412323,1412323,0
9643,Conrad Wallem,44,1242800,4083456737873423,227,2497321,2464141,247,2463894
9644,Wang Gang,26,353700,8078131497805775,81,603628,582556,583,581973
9645,Masaki Watai,47,1558100,6993794129213216,292,3384684,1050450,10505,1039945
9646,Ben Whitfield,29,4894800,9423539538419120,446,7710695,2047394,204740,1842654
9647,Gavin Whyte,34,4033900,7834770172535729,377,5780771,458223,0,458223
9648,Casper Widell,46,3346200,3249661074585240,426,6293688,2104623,0,2104623
9649,Andreas Wiegel,23,4980400,6955671382942044,404,7018484,6087168,609,6086559
9650,Rhys Williams,51,1028500,3106081162907335,239,2468438,105736,0,105736
9651,Jonny Williams,48,1077600,7371736582438822,247,2685994,693798,0,693798
9652,Ryan Williams,64,4983500,4741988934010863,701,9920313,7306674,0,7306674
9653,Carl Winchester,46,4030300,9916443072575043,458,6972646,427536,42754,384782
9654,Brendan Wiredu,62,435700,5719760049345398,277,2269730,1783485,179,1783306
9655,Christian Witzig,68,776400,4126866035026959,369,3251487,1828674,1829,1826845
9656,Piotr Wlazło,24,4984300,3711791766801497,425,7444611,3720028,0,3720028
9657,David Møller Wolfe,65,3753400,9107046530698688,548,7183724,5879030,588,5878442
9658,Maximilian Wolfram,32,4485700,5760820318664514,361,6680181,3333326,3334,3329992
9659,Kyle Wootton,39,1720900,3645765144886634,233,2951760,493747,4938,488809
9660,Joe Wright,34,2077500,9094146347716090,220,2946794,1660170,1660170,0
9661,Wu Yake,55,1653500,3930246445439539,361,3969446,144873,1449,143424
9662,Wu Yan,26,4539300,6787195499129675,392,6688854,6461646,0,6461646
9663,Yan Dinghao,22,3455700,5403470760235348,219,4305873,2776893,277690,2499203
9664,Yu Kang Hyun,45,2985000,7714442901829610,393,5764973,3181952,3182,3178770
9665,Yu Dabao,68,2139800,4608038150441466,480,5653414,4817521,4818,4812703
9666,Yu In Soo,55,455400,9031407299442913,197,1674961,349619,0,349619
9667,Arthur Zagré,39,1534800,7512365720798603,264,2854941,800389,80039,720350
9668,Mattia Zanotti,40,399300,4958886729312733,145,1112270,29626,297,29329
9669,Yorman Zapata,52,2676700,6458164665746440,372,4757984,1780860,17809,1763051
9670,Zhang Chengdong,34,668700,3549535242782888,143,1381607,723548,0,723548
9671,Georgiy Zhukov,32,2629900,5839270656552747,309,4529697,1569431,15695,1553736
9672,Tom Zimmerschied,48,332400,4095356259837596,168,1181224,136670,1367,135303
9673,Budu Zivzivadze,69,841000,5545510180446911,343,3367378,116528,117,116411
9674,Gideon Zuma,62,3211400,4539855749068201,542,6618754,521144,5212,515932
9675,Žan Žužek,59,1525400,3427825479220225,385,3941885,2043285,2043285,0
9676,Jan Zwischenbrugger,25,341500,3182860664807434,63,470529,288604,2887,285717
9677,Mateusz Żyro,46,3737800,5394586842017533,476,6542304,1795722,1795722,0
9678,Thelo Aasgaard,64,1037500,8013181415281133,313,2990639,394610,394610,0
9679,Freddy Abastoflor,37,2981500,6777676466822957,354,4793958,2280298,0,2280298
9680,Suleiman Abdullahi,56,2481400,3337091689221105,426,5229014,1304125,131,1303994
9681,Diyaeddine Abzi,55,4585100,3848250842183585,539,7616934,7012833,70129,6942704
9682,Abdulfatah Adam,31,1136700,9513793312055597,136,1663999,214984,0,214984
9683,Sergio Adrián,65,1069400,9946684909820996,338,3519685,2973578,298,2973280
9684,Nikolas Agrafiotis,53,1151600,4719517739259687,338,3412329,2164075,0,2164075
9685,Dan Agyei,60,3210500,8529873325049602,457,5879257,1918289,0,1918289
9686,Erik Ahlstrand,44,3961000,5362745523273165,503,7384006,1278755,12788,1265967
9687,Murat Akça,31,1825500,9469480387157755,221,3145017,1257559,125756,1131803
9688,Edmond Akichi,30,1868900,6423658077227849,201,2835503,1235839,1236,1234603
9689,Ayo Akinola,46,1297900,8983981856561693,222,2616803,1918668,1918668,0
9690,Hamdi Akujobi,65,2117400,8546889725203268,422,4758447,1759970,0,1759970
9691,Mohammed Al Dawsari,27,3999400,5353342462358065,376,5498144,4373799,437380,3936419
9692,Khaled Al Hashmi,45,4988800,5680025405017875,562,7936586,3832645,0,3832645
9693,Musab Al Juwair,43,3424700,5159245268629153,387,5275310,2756675,27567,2729108
9694,Ahmed Al Kassar,36,2588500,9858019972613440,286,4381075,41010,0,41010
9695,Fahad Al Muwallad,65,3123400,4358806159184402,495,5969795,3997179,399718,3597461
9696,Fahad Al Rashidi,49,2632100,9909187426160155,346,4452859,1539763,1539763,0
9697,Mohammed Al Rubaie,46,1111100,8340934199301931,241,2700523,947353,947353,0
9698,Alcedo,33,585700,8168529590462520,89,893087,528310,52831,475479
9699,Tony Alfaro,37,795900,5364625439487745,147,1419605,54167,54167,0
9700,Franco Alfonso,25,890200,5580833210286075,66,921138,87520,8752,78768
9701,Naser Aliji,52,467500,3655009478823517,238,1827956,1012352,1012352,0
9702,Altube,57,4346900,6043765989147241,591,8267443,7344801,0,7344801
9703,Sebastián Álvarez,25,2541200,4859784743271409,216,3483613,1864913,1864913,0
9704,Max,31,911500,5878166818915511,131,1504856,1031341,103135,928206
9705,Xavier Amaechi,59,1020800,4211730070106782,331,3005605,2042052,204206,1837846
9706,Kevin Amaro,28,3042000,4172310607039352,302,4751519,1627156,16272,1610884
9707,Aurèle Amenda,54,3389300,7224847826766268,457,6339707,928149,929,927220
9708,Mustafa Amini,35,4030100,6344601793195867,397,6329032,2734575,27346,2707229
9709,Jonathan Amon,26,920600,4937851099094419,111,1253351,737692,0,737692
9710,Isak Helstad Amundsen,25,2016900,8924484657463720,210,3017774,84694,0,84694
9711,Costin Amzar,41,510200,6176928487811932,132,1200657,815305,8154,807151
9712,Joseph Anang,38,437900,5475267116726690,114,914896,240140,240140,0
9713,Eirik Ulland Andersen,53,2273800,9497786203631730,374,4761623,2459949,246,2459703
9714,Alexander Juel Andersen,62,4617500,5597316773365982,639,8519640,4912967,4912967,0
9715,Danny Andrew,31,2385100,8072203634979931,281,3890412,3392086,3392086,0
9716,Chuks Aneke,26,3511700,3553796351274685,306,4859696,2528556,2529,2526027
9717,Matteo Angeli,31,4916900,6525977831989834,395,6803741,670603,671,669932
9718,Tobias Anselm,61,1772300,9875857765186967,392,4285677,2808973,2809,2806164
9719,Irwin Antón,23,2553900,6600841973430886,173,3441789,855546,855546,0
9720,Mateo Antoni,36,2347000,5916355022199910,274,3761392,3670991,36710,3634281
9721,Nico Antonitsch,43,3140800,9418347011019952,357,5357366,2497391,2498,2494893
9722,Arvin Appiah,61,1609400,7279140567489082,372,3997101,3206757,32068,3174689
9723,Elder Arauz,25,819600,5841199733664639,89,1009672,269648,2697,266951
9724,Cristian Arce,53,4362100,6614770660906427,490,7526065,6874171,687418,6186753
9725,Luis Arce,24,4704900,5101960225832713,395,6387469,5429802,5429802,0
9726,Jack Armer,27,1391300,3232999101108921,128,1913013,307577,307577,0
9727,Luke Armstrong,59,3557900,9479399423676421,468,6572431,3280944,32810,3248134
9728,Abdiel Arroyo,54,2582900,5357846623213631,368,4502796,3737657,373766,3363891
9729,Juan Artola,44,3118600,6506624351160598,408,5740999,1064223,0,1064223
9730,Jonas Arweiler,26,2033600,4458795078678946,165,2719528,1394147,1395,1392752
9731,Rocco Ascone,32,1015400,5625351286502747,170,1848315,281030,281030,0
9732,Abdulfatah Aseri,65,1119500,6542792744959207,348,3280272,3124552,312456,2812096
9733,Taye Ashby-Hammond,46,1681800,9685288403691832,282,3274729,163391,0,163391
9734,Valentin Atangana Edoa,51,1744700,7233696210421806,316,3613644,1764791,1764791,0
9735,Jonathan Augustinsson,30,4848200,4793968660253140,391,7189344,4852416,4853,4847563
9736,Brandon Austin,31,1745500,7309399916949478,214,2856567,608488,60849,547639
9737,George Ayimbire Ayine,28,2194200,7308038028071027,232,3320815,194193,19420,174773
9738,Ayman Azhil,60,2901400,4114741154231157,518,6538076,6252707,6252707,0
9739,Abdoullah Ba,24,3724900,5428207057539321,319,5548607,1138836,113884,1024952
9740,Pape Ibnou Ba,36,714100,4540277663798392,122,1237692,940401,0,940401
9741,Ahmed Ba Masoud,49,4832300,9324943244949188,545,8001785,2334341,23344,2310997
9742,Tom Baack,51,964200,3979742327020666,237,2491559,154310,154310,0
9743,Julian Baas,43,1425900,9057362803776137,254,2796150,689435,0,689435
9744,Boris Babić,45,2484900,5388242702882083,331,4336419,92247,92247,0
9745,Baek Jong Beom,70,2789800,8499134968678579,456,5952645,2170032,21701,2148331
9746,Corey Baird,41,3290800,8841273810519025,369,4996509,1887104,1888,1885216
9747,Abdoulaye Bakayoko,31,940200,9856118660443659,125,1552296,791331,791331,0
9748,Navajo Bakboord,38,1249800,6776870233433151,203,2315326,1645716,164572,1481144
9749,Tyreeq Bakinson,54,1472100,3908821661529705,295,3231189,505243,5053,500190
9750,Silviu Balaure,54,1173700,7554685728183370,280,2872381,2236519,224,2236295
9751,David Ball,29,933000,4370935432270856,133,1597436,1183164,0,1183164
9752,Yusuf Barası,54,4631000,9263605826261916,547,7488604,2179582,0,2179582
9753,Cristi Bărbuț,65,1200400,7662188283347447,363,3870615,761293,761293,0
9754,Sergio Bareiro,32,320500,7326962232775019,95,733792,157419,1575,155844
9755,Francisco Bareiro,65,449500,7238990790221392,284,2268476,279515,0,279515
9756,Luis Barraza,52,2426000,3121397755883181,387,4970344,3379362,3379362,0
9757,Enzo Barrenechea,45,2517500,9278418269736318,335,4573243,1029439,102944,926495
9758,Abdourahmane Barry,39,3256700,3966635216022008,332,5158141,3615867,3615867,0
9759,Louie Barry,22,1544800,6638604058244524,132,2035605,113538,113538,0
9760,Anthony Barylla,64,1327400,3459480031122287,367,3497054,3374216,3374216,0
9761,Fernando Basante,47,1815600,4288217909443635,310,3724116,935579,0,935579
9762,Alex Bass,59,3894700,5485164056983108,566,7647051,2290868,0,2290868
9763,Roko Baturina,38,4242000,8188438817155405,452,7128704,1754107,1754107,0
9764,Mika Baur,67,1754300,5249205756365337,385,4374679,230058,23006,207052
9765,André Becker,27,539900,9286245362075174,69,681655,553776,553776,0
9766,Jake Beesley,56,2775100,3245010902242526,444,5778226,3535315,0,3535315
9767,Marcel Beifus,33,3227600,3569055071456043,304,4991376,4138344,413835,3724509
9768,Florin Bejan,38,1312200,7083274183856613,190,2481411,234089,235,233854
9769,Claudiu Belu-Iordache,69,3728700,9442905206725338,552,7302921,1354456,136,1354320
9770,Ben Bender,27,1898300,6645475245702470,185,2770962,746048,747,745301
9771,Romeo Benítez,26,1879700,4815094665156193,172,2688130,2618038,262,2617776
9772,Iker Benito,27,3396600,9842375976189918,307,5045367,3361306,336131,3025175
9773,Liam Bennett,50,1146500,4763189943392796,238,2527461,517516,51752,465764
9774,Josh Benson,30,2954200,4339644843471226,283,4438735,1179854,1180,1178674
9775,Tobias Berger,37,2591000,5566946664574115,298,3936028,3279524,3279524,0
9776,Erich Berko,64,3428900,7212002328904582,532,6589721,3794689,0,3794689
9777,Facundo Bernal,37,1009400,8425990290840410,191,2115363,1428399,14284,1414115
9778,Brian Beyer,54,4910100,5950170491546959,544,7681617,4342059,4343,4337716
9779,Julius Biada,23,2711800,6999167039383389,244,3849337,187161,18717,168444
9780,Daniel Bielica,40,2518800,4885436921278155,308,4158922,3877707,0,3877707
9781,Kacper Bieszczad,25,1501500,6463436467995653,133,2097421,1411474,1411474,0
9782,Hayrullah Bilazer,33,3478300,5885081496645000,358,5863335,3489992,349,3489643
9783,Nathan Bishop,69,2273400,3048123443623483,502,5380913,4093436,410,4093026
9784,Uran Bislimi,58,3618100,8487771002037379,480,6255021,109144,0,109144
9785,Joshua Bitter,61,4083400,3066986246504709,525,6863922,6106252,6106252,0
9786,Brynjar Ingi Bjarnason,51,1358400,4789837597975794,270,3084928,445224,0,445224
9787,Peter Bjur,51,4872100,3162731747911254,536,8778301,3592864,360,3592504
9788,Frazer Blake-Tracy,31,3394000,7004688878809375,325,5540650,817818,81782,736036
9789,Lewin Blum,25,569200,7979751807231706,62,633440,563165,56317,506848
9790,Oscar Bobb,38,3055500,8737387109251529,335,5123199,4530157,4530157,0
9791,Mateusz Bochnak,58,2572200,3486896507539445,483,5748268,22066,0,22066
9792,Pelle Boevink,61,3102000,4956059758813942,483,6120947,3742663,0,3742663
9793,Omar Bogle,36,4173800,5114716128373685,405,6972020,429291,0,429291
9794,Mateusz Bogusz,27,3212600,7623931443360108,262,4566172,1858148,185815,1672333
9795,Leminger Bolívar,44,2561900,8566823943233024,370,4660886,1619733,0,1619733
9796,James Bolton,32,4455800,9156914823450878,458,6788194,4399422,43995,4355427
9797,André Boman,32,337400,8245280057507627,89,623202,327076,32708,294368
9798,Tarsis Bonga,30,2851900,5647297255497802,308,4328659,1429475,0,1429475
9799,Solomon Bonnah,45,1493500,8955424359190766,247,2799377,2192821,2193,2190628
9800,Rivaldinho,41,3712800,6743919076878043,420,6591447,6308111,6308111,0
9801,Christian Dahle Borchgrevink,55,4921700,3209451577231456,581,8541116,357263,0,357263
9802,Yvandro Borges Sanches,64,3730400,8554147167867180,570,7674974,5384834,538484,4846350
9803,Filip Borowski,48,3134000,9682800006003581,369,5341284,2349970,0,2349970
9804,Florin Borța,61,548700,7929726381168692,294,2429153,372760,372760,0
9805,Tim Boss,30,3495100,3332551767957008,291,4643645,2755815,275582,2480233
9806,Nawaf Boushal,51,2943700,3808521495989940,433,5613453,5313223,532,5312691
9807,Calvin Brackelmann,40,2747700,3372038196149052,328,4629130,1146697,1147,1145550
9808,Cohen Bramall,38,4195600,5370581326609716,385,6496672,5953375,595338,5358037
9809,Michael Brandner,42,782900,5616195350798960,182,1861935,356821,35683,321138
9810,John Brayford,60,4926300,8002295849614798,666,9013469,7744072,0,7744072
9811,Volodymyr Brazhko,40,2873900,5883552687180075,345,4542349,1965502,197,1965305
9812,Sebastian Breza,50,4230100,6842316977249797,463,6606648,1612490,0,1612490
9813,Enrico Brignola,57,4149800,3883337050153891,545,7684377,1647257,0,1647257
9814,Ronald Briones,70,3385100,6108358543123154,546,6829658,3637717,363772,3273945
9815,Ryan Broom,47,2843200,5743606109916400,388,5343211,4579768,0,4579768
9816,James Brophy,34,3448600,6059730450996570,358,5185914,484073,4841,479232
9817,Eamonn Brophy,32,3831700,9697827172422164,333,5919217,4165267,4166,4161101
9818,Nathaniel Brown,59,303700,4606066174111078,230,1611709,1135985,1136,1134849
9819,Reece Brown,24,1331400,6998017662603359,124,1815487,1027805,103,1027702
9820,Will Bruin,46,3779200,5286710583551938,477,6540936,5765838,5766,5760072
9821,Sol Brynn,29,944800,3300038786526367,147,1699552,299364,0,299364
9822,Tawfiq Bu Haymid,28,3165600,3419586761336897,279,4769933,2421960,243,2421717
9823,Guille Bueno,23,3717900,6538627366845586,352,5754913,4486554,449,4486105
9824,Lee Burge,25,2203600,4535293051874586,201,3065054,1165627,1166,1164461
9825,Korbinian Burger,46,3828300,3483002318138527,442,6638857,2339416,2340,2337076
9826,Jack Burroughs,54,1654200,7885741146537419,334,3429349,3348498,3348498,0
9827,Karlo Butić,62,4807400,5174198546058258,712,9073581,6323912,633,6323279
9828,Dan Butler,48,3492000,8730888819125953,407,5916527,491238,492,490746
9829,Zico Buurmeester,57,1095900,8259353967750050,288,2782014,1703843,0,1703843
9830,Alexandru Buzbuchi,52,4861100,8770684779774089,620,8920518,4029894,402990,3626904
9831,Lanchi,26,2729400,7163232788533866,231,3655185,616380,61638,554742
9832,Raúl Cáceres,26,1800600,3038956890937462,175,2602681,825144,825144,0
9833,Jefferson Cáceres,62,4527000,6791357966691803,582,8411680,3008573,300858,2707715
9834,Andreias Calcan,37,2923700,8054267824151173,363,5259030,5213783,52138,5161645
9835,Diego Calcaterra,48,4121500,9162831171214431,436,7109822,4029893,0,4029893
9836,Ross Callachan,37,1564200,6646938047951355,193,2522565,812387,8124,804263
9837,Lyall Cameron,31,1376400,4948823778700524,137,1926929,1779828,1779828,0
9838,George Campbell,54,2071200,5677942329865612,409,4335546,1123446,1124,1122322
9839,Chem Campbell,32,2257000,8231570650651796,235,3296059,3143611,0,3143611
9840,Alfred Canales,36,529900,8251794930873183,135,1204746,1105973,1106,1104867
9841,Andy Cannon,41,2313900,6034629141377683,338,4427022,3284336,3284336,0
9842,Àlex Carbonell,50,4257800,7723902293473853,483,7096006,5475068,5476,5469592
9843,Franco Carboni,27,4481000,4644330840499765,446,7028968,3099022,0,3099022
9844,Facundo Cardozo,62,2118800,8149993053695725,459,5019218,383242,3833,379409
9845,Jesús Careaga,58,4085000,6015830257786458,543,7293606,3515905,3515905,0
9846,Hussein Carneil,25,2038200,4591904269264808,195,3088018,2153483,216,2153267
9847,Cătălin Carp,38,1132500,4577416103795892,190,2154136,1071547,107155,964392
9848,Lucas Carrizo,22,339000,4706256522539874,21,120512,55101,0,55101
9849,Tom Carroll,68,1924400,9774071825725120,416,4857014,1760538,0,1760538
9850,Marc Casadó,29,323400,5546641090055985,62,404098,222987,2230,220757
9851,Olly Casey,69,1745900,3514727904452338,416,4262544,3417941,0,3417941
9852,Francesco Cassata,44,3609600,7206378755459244,427,6271032,1816168,0,1816168
9853,Luís Santos,65,4248200,3080763342259573,586,7573397,3574608,3575,3571033
9854,Niklas Castro,51,3012200,4010347937742578,384,5051437,4152774,416,4152358
9855,Tomás Castro Ponce,57,2122900,4888956908851000,383,4828702,4035887,4036,4031851
9856,Bruno Jordão,66,4825500,8608430794951352,568,7890715,2391329,2391329,0
9857,Sebastián Cavero,58,4364500,7954374404533505,492,6771493,6162444,0,6162444
9858,Osman Çelik,44,4260700,3787693219213798,520,7890549,7822087,0,7822087
9859,Diego Céspedes,45,3454700,3569315164910456,425,6146628,1750620,176,1750444
9860,Moutir Chajia,39,4499500,5063967973175802,490,7543602,7112896,712,7112184
9861,Felipe Chamorro,43,4285600,4038906443471622,424,6676944,6422727,0,6422727
9862,Chen Binbin,60,4984100,3154550316359400,664,9179503,7444222,0,7444222
9863,Cheon Seong Hoon,62,1006200,5284671325170441,319,3018841,51648,517,51131
9864,Lallianzuala Chhangte,68,1469500,4249532346083036,436,4169673,3404158,34042,3370116
9865,Chi Zhongguo,60,3983900,4754886170248687,503,7113275,2945941,0,2945941
9866,Noah Chilvers,27,1855100,6604119517338087,166,2396754,2105735,0,2105735
9867,Daniel Chima Chukwu,26,4947500,5655838627320589,487,8178098,4155796,0,4155796
9868,Ethan Chislett,43,4257800,8897920677368445,476,6786310,4407085,441,4406644
9869,Aurelian Chițu,56,2823900,5357426502867467,455,5751114,2628933,0,2628933
9870,Carlos Chore,47,936000,5845098244354662,218,2346288,1200121,0,1200121
9871,Magnus Christensen,34,3246200,5643075534204239,344,4831283,549636,0,549636
9872,Tochi Chukwuani,25,325800,7685115926412962,59,410024,39573,39573,0
9873,Luciano Cingolani,27,716500,4443765499747180,101,1086914,496025,0,496025
9874,Nicky Clark,35,1197900,9574948232638250,175,2213385,485430,486,484944
9875,Stefan Cleveland,57,3332600,8905671971980301,433,6041098,5426679,0,5426679
9876,Angelo Cocian,54,3818600,5445943626698235,532,7170998,2391307,0,2391307
9877,Juan Colina,39,3793200,7592056798741728,470,6870575,2280367,229,2280138
9878,Thuram,30,1639800,6874635088170853,199,2680420,2628881,0,2628881
9879,Godberg Cooper,53,1121800,9755644085149620,283,2747758,2727825,2727825,0
9880,Jo Coppens,30,3089500,7078776264590758,269,4341733,520650,52065,468585
9881,Thibault Corbaz,49,1951200,9915285308881393,307,3739385,2249388,224939,2024449
9882,Rezan Corlu,28,1069700,3170014902159441,144,1770711,484,0,484
9883,David Cornell,44,1631100,4125186258074294,259,2843433,2671130,0,2671130
9884,Leo Cornic,68,4608000,3381888328966680,605,8807081,1377803,0,1377803
9885,Ali Crawford,55,4048200,8418408181584862,506,7238659,6770568,67706,6702862
9886,Svenn Crone,39,996900,5383071996420768,173,1827410,13109,1311,11798
9887,Josué Cuero,39,3134900,6405032735192522,309,4436259,1049213,1050,1048163
9888,Jack Currie,68,2663000,7245381537590110,521,5895790,2967331,296734,2670597
9889,Mateusz Czyżycki,39,3575900,3976161152846256,391,5810683,1467320,146732,1320588
9890,Kristopher da Graca,56,4297400,3226090590965159,502,6969047,2973022,297303,2675719
9891,Jefté,47,2410100,6436461313455049,390,4581049,1141946,1141946,0
9892,Owen Dale,32,2316500,5246680992328874,264,3772640,3386616,3387,3383229
9893,Muhammed Damar,30,4121400,7897595952626572,387,6432497,2116831,211684,1905147
9894,Florian Thomas Danho,47,3820500,9878726047342882,452,6916044,596364,59637,536727
9895,Tim Danhof,47,3423300,4178843575023845,436,5880085,5781739,578174,5203565
9896,Bence Dárdai,35,403700,9035847891718588,108,908691,368318,0,368318
9897,Nicolás Dávila,50,1677300,9749213502073610,299,3439479,1469012,146902,1322110
9898,Gonçalo Gregório,37,627200,4835797768280838,120,1128295,1074060,108,1073952
9899,Marcelo Freitas,66,1029900,4082582664489304,378,3373519,401556,4016,397540
9900,Mathías De Ritis,37,2580900,9006965928761645,297,4431332,2272917,228,2272689
9901,Eguinaldo,66,1375900,3457765452481307,348,3588556,2520480,252048,2268432
9902,Mateo Del Blanco,34,2272100,8461845198618489,248,3378049,40681,0,40681
9903,Abraham,25,3217400,4525121172901152,294,4332603,1307622,0,1307622
9904,Kahraman Demirtaş,36,3945200,9993811952513522,407,6098941,4403149,441,4402708
9905,Tunay Deniz,52,2283700,5456945879225276,349,4545790,3826773,3827,3822946
9906,Nick DePuy,22,2203500,9320300618327012,190,3098724,137939,13794,124145
9907,Alfie Devine,66,3648700,8319705627779055,539,6971747,935726,9358,926368
9908,Francisco Di Franco,33,4785700,9445187187412505,507,7849185,5609507,0,5609507
9909,Assane Diao Diaoune,33,426200,5010929754852947,114,914071,872571,87258,785313
9910,Brahima Diarra,27,3562500,6953832882313135,343,5677824,3694008,370,3693638
9911,Timothée Dieng,49,1958000,9460461787084096,358,4187313,3708339,3709,3704630
9912,Florian Dietz,66,2168900,6616209419767172,420,4491677,3620773,0,3620773
9913,El Hadji Dieye,65,4268800,7008884184260008,559,7658218,6592385,0,6592385
9914,Radoslav Dimitrov,50,4038400,4256927667800416,524,7674577,495086,0,495086
9915,Kapit Djoco,40,2194700,7991755703960461,288,3791780,3469940,0,3469940
9916,Wiktor Długosz,49,2745700,5589608674513215,350,4802827,4352083,435209,3916874
9917,Alexis Domínguez,66,2703200,7743718782064506,415,5329117,3815411,38155,3777256
9918,Liam Donnelly,52,1860900,8383466343585213,301,3609011,1495521,149553,1345968
9919,Marc-Olivier Doué,54,3926800,7255772908706241,528,7479499,4446673,445,4446228
9920,Moussa Doumbouya,26,1112700,4881422524088089,111,1414683,815058,816,814242
9921,Oliver Dovin,52,3758800,5793513937930125,484,6369381,73295,0,73295
9922,Felix Drinkuth,39,3549100,5409183741666753,333,5050572,3700340,0,3700340
9923,Denis Dumitrașcu,62,2743300,5071426706791649,434,5394591,169503,0,169503
9924,Charles Dunne,70,3609300,5396003010197975,543,6933460,6920111,6920111,0
9925,Salih Dursun,45,1075600,8373058770533204,217,2378370,1453622,146,1453476
9926,Damien Dussaut,70,850300,7669868022239444,349,3251358,417937,418,417519
9927,Pierre Dwomoh,57,3737300,3520737702438879,544,7019782,5360000,53600,5306400
9928,Craig Eastmond,49,3768800,6204366299994650,529,7145551,344721,0,344721
9929,Simon Eastwood,44,2500400,9360610790379050,360,4295322,554429,555,553874
9930,Eskil Edh,53,3982200,9378834567876518,492,7646830,5761539,576154,5185385
9931,Kyle Edwards,59,4191400,7952136214181628,535,7503394,6877610,6878,6870732
9932,Florian Egerer,48,4191800,3380264066346114,505,6992133,276620,2767,273853
9933,Max Ehmer,69,2221700,8915384647761471,471,5127807,4009287,400929,3608358
9934,Thomas Eisfeld,28,3029500,7868649040634332,262,4544908,35193,0,35193
9935,Mourad Daoudi El Ghezouani,32,2264300,7554282365144703,242,3644606,1850975,1850975,0
9936,Amine El Ouazzani,31,813300,8549238809586252,123,1353994,587130,588,586542
9937,Dimitrios Emmanouilidis,30,1505000,5881563429117801,178,2245390,777419,7775,769644
9938,Marcel Engelhardt,23,4516300,3370999094566435,380,7191112,5118894,0,5118894
9939,Anton Eriksson,55,1449400,3501069939636663,327,3703973,1795856,0,1795856
9940,Carljohan Eriksson,59,4954100,7574868421988954,555,8348935,6507494,0,6507494
9941,Tiri,29,3918500,5830217779032536,352,6046836,1411957,1412,1410545
9942,Joseph Espinoza,27,2913600,6339188299090499,263,4061596,3126365,31264,3095101
9943,Maxime Etuin,34,3816800,7082530291666444,378,5538193,2106188,0,2106188
9944,Franck Evina,38,4412600,6720913528370679,421,6728278,538163,53817,484346
9945,Omar Faraj,44,1061500,8278084086992869,221,2326888,497773,0,497773
9946,Hugo Fargues,44,4156700,7011916036217922,504,7310844,5724167,572417,5151750
9947,Gonçalo Costa,32,1154300,8677215418623508,143,1794272,225125,2252,222873
9948,Jacob Farrell,39,2704100,6056552988865618,306,4540525,2077006,0,2077006
9949,Mohamed Farsi,41,690700,4481166515279625,166,1594217,428898,0,428898
9950,Kehinde Fatai,25,2275500,3005031221945979,210,3120126,2876082,0,2876082
9951,Mikayil Faye,56,2546500,5047371960950491,370,4821394,188029,18803,169226
9952,Morgan Feeney,68,1835800,9189391088161274,406,4448669,1753602,1753602,0
9953,Rolf Feltscher,53,1804400,5362833143239930,313,3745572,3055705,0,3055705
9954,Rashaan Fernandes,69,4771200,9079248125851145,588,8102028,6682692,6682692,0
9955,Roger Fernandes,32,1331800,6465312947686282,197,2465980,2435063,0,2435063
9956,Omir Fernandez,58,1289700,3504147334899360,342,3567534,2235220,0,2235220
9957,Thiago Fernández,52,978500,9127307276359637,236,2280050,1774856,178,1774678
9958,Luciano Ferreyra,33,1173900,8637981065771173,168,1962705,1773389,0,1773389
9959,Stuart Findlay,64,1058400,4353195144368911,368,3674554,3026600,0,3026600
9960,Bradley Fink,62,3107200,9003873931064389,532,6444063,2906914,290692,2616222
9961,Sam Finley,33,3676900,9699538801900763,348,5744373,507176,5072,502104
9962,Brandon Fleming,39,3276300,8950100943835928,386,5538570,4405765,440577,3965188
9963,Daniel Florea,55,4271800,3596052767674790,562,7379916,5054425,5055,5049370
9964,Christian Flores,34,1383400,7501963150579521,160,2002054,1297401,1297401,0
9965,Sadik Fofana,50,420300,9999765538412932,224,1705016,1483303,0,1483303
9966,Kortne Ford,35,3639900,7551108004587874,385,5824686,3805723,0,3805723
9967,Mariusz Fornalczyk,67,1747500,6646546508846069,444,4412633,2501530,251,2501279
9968,Will Forrester,25,698300,5195021252957981,59,743348,335276,0,335276
9969,Sander Moen Foss,56,2377800,9546413466787448,403,4821213,3264666,0,3264666
9970,Ulrik Fredriksen,34,510700,7567415973815296,134,1088819,747066,0,747066
9971,Marlon Frey,30,4002000,8739814653791828,366,6127334,3395295,3395295,0
9972,Moritz Fritz,58,4138100,8533016386351783,605,7956476,3435910,34360,3401550
9973,Alexander Fuchs,32,816000,8203329914491616,132,1428744,97018,0,97018
9974,Toni Fuidias,62,3915000,7324047609412493,569,7580425,1504055,151,1503904
9975,Alessandro Gabrielloni,25,4903900,8375019278999016,446,7629750,4062483,0,4062483
9976,Jon Gallagher,26,2794600,3079722331025689,254,4173431,1576951,157696,1419255
9977,Brendan Galloway,61,437900,7209543995256462,250,2126276,1969240,197,1969043
9978,Braian Galván,39,4397000,9475674814249318,463,7680077,6375643,6376,6369267
9979,Hugo Gambor,38,3783200,5072613728248387,376,5814582,3292186,330,3291856
9980,Diego García,34,2686300,6335453293804842,275,4260495,2677631,0,2677631
9981,Naim García,43,481100,7650922815371950,165,1491469,1367877,136788,1231089
9982,Gary Gardner,67,723500,8052499444145935,314,2958486,2157871,2158,2155713
9983,Ignacio Gariglio,46,4287100,8133990358884476,435,6828536,6359988,635999,5723989
9984,Jordon Garrick,40,3565300,3615953487334373,388,5789504,1032581,1032581,0
9985,Chase Gasper,34,4029800,3806826573443245,425,6238211,920783,92079,828704
9986,Stavros Gavriel,23,2316800,8089585813624392,181,3169876,2493865,2494,2491371
9987,Roy Gelmi,37,3801600,4274447133698775,381,6044335,5172741,518,5172223
9988,Luca Gemello,37,4938100,3314248615671713,513,7745897,186471,186471,0
9989,Owen Gene,50,3952900,4680494325521557,532,6685288,5894426,58945,5835481
9990,Jason Geria,66,1005900,9582918054661554,304,2957308,1462297,1462297,0
9991,Alex Gersbach,34,3215300,7065395316214807,310,4717794,526445,5265,521180
9992,Niklas Geyrhofer,23,4838400,3889783548118544,454,6748019,6335122,0,6335122
9993,Luca Ghiringhelli,29,2271600,3825906969634238,221,3364342,1875545,0,1875545
9994,Lewis Gibson,63,795700,5499373800087352,268,2616350,2325505,232551,2092954
9995,Raoul Giger,53,2282800,5936841729198159,319,4016724,1358981,135899,1223082
9996,Mario Gila,38,4370100,5866524886878197,431,6710145,2159620,0,2159620
9997,Néstor Giménez,61,4950800,5248247607354327,565,8677404,2826867,283,2826584
9998,Benjamin Girth,41,4402200,7816487596055710,432,7101836,6245928,624593,5621335
9999,Anthony Glennon,36,3799000,4259034984210691,408,6596615,730074,73008,657066
10000,Tom Glover,51,3587500,4646244987734429,463,6521334,2704345,0,2704345
10001,Fabian Gmeiner,39,4685600,3784476716922886,510,7476420,2190486,219049,1971437
10002,Armand Gnanduillet,43,3237800,6596706192716855,387,5207884,1178954,1179,1177775
10003,Alex Gogić,60,1524900,7711748333898369,369,3665889,118719,1188,117531
10004,Manfred Gollner,52,1080800,7518117507902799,254,2589264,2077175,207718,1869457
10005,Adnan Golubović,47,3199800,3502062062551960,460,6094937,1721247,173,1721074
10006,Jakob Golz,24,1218400,8353714494760701,109,1519962,553409,553409,0
10007,Antonio Gomis,45,2622900,7447472604752578,357,4700464,11766,11766,0
10008,Omar Gonzalez,33,2731600,5402648005728675,261,3930777,1765443,1766,1763677
10009,Clementino González,31,1998800,3387945007765508,228,3422237,3044871,305,3044566
10010,Ethyan,48,1351300,3337147984372300,294,3174031,2081299,2081299,0
10011,Yayo,33,4481000,3061432155640860,419,6255106,5198484,5199,5193285
10012,Borja González,45,3192100,7041767331447689,344,5298297,2271849,2272,2269577
10013,Josh Gordon,31,4398200,5414295337086723,437,6916623,1223702,1224,1222478
10014,Alexander Gorgon,70,935200,4459876531327993,360,3481272,1877086,18771,1858315
10015,Minos Gouras,47,4207100,3445316837313815,551,7550853,3847282,0,3847282
10016,Gori,68,1547400,4760249567557029,430,4731369,483355,483355,0
10017,Viktor Granath,57,1481700,8624802053060769,294,3229607,994224,0,994224
10018,Christos Gravius,70,3623500,8327601275354666,606,7567949,7545639,755,7544884
10019,Archie Gray,32,4835700,3971108597211024,428,7678402,1284361,129,1284232
10020,Christoph Greger,29,536700,4710083525695736,98,913946,699464,6995,692469
10021,Fabian Greilinger,69,1773700,6234995869426309,468,4918406,193340,19334,174006
10022,Josh Griffiths,48,3048900,8042081134467404,397,5432847,3021845,0,3021845
10023,Dragoș Grigore,54,4703800,6754863765766160,557,7808595,6611055,0,6611055
10024,Gu Cao,46,440300,4407042776120935,179,1519048,414648,0,414648
10025,Lukas Gugganig,28,2977400,6912343292155326,290,4600217,4177272,4178,4173094
10026,Matthew Guillaumier,53,3449100,9000610802466593,474,6333700,2878364,288,2878076
10027,Luis Gutiérrez,67,2612900,8746678327125279,413,5199533,3238636,3238636,0
10028,Cristian Gutiérrez,35,934500,9114542326388504,140,1542810,360828,0,360828
10029,Brian Gutiérrez,44,4609700,3775009416595149,457,7206478,6531733,0,6531733
10030,Jhohan Gutíerrez,55,4094100,7434335987236086,509,7179576,1950779,196,1950583
10031,Lukas Gütlbauer,43,2725700,4896438649740210,389,4917805,232009,232009,0
10032,Callum Guy,61,1303400,9271879056059689,363,3680980,824625,0,824625
10033,Piero Guzmán,30,1848000,3323092587727785,202,2894872,895751,896,894855
10034,Jetmir Haliti,24,4058600,7792733506782078,301,5223463,1535323,1536,1533787
10035,Daniel Hall,61,894800,7822678159264072,287,2569385,2004955,200496,1804459
10036,Connor Hall,34,1250900,4688428705539892,171,2059855,1394411,0,1394411
10037,Bradley Halliday,42,4550800,3129036341928564,497,7490595,5017846,502,5017344
10038,Ben Halloran,67,1503700,8466875805649145,372,3729845,1423311,0,1423311
10039,Ahmed Hamdi,70,1550600,3933053950768127,401,4215718,955017,0,955017
10040,Brendan Hamill,57,2926000,7153446772885030,430,5644254,15766,158,15608
10041,Mansour Hamzi,45,3960900,6518617540480277,474,6919659,82102,8211,73891
10042,Han Kyo Won,52,2589700,8073855682316286,361,4726374,1436910,144,1436766
10043,Dan Happe,50,3571700,3501110956825128,497,6499131,4804006,0,4804006
10044,Ian Harkes,43,2272700,8830206959603650,318,4130723,2173381,217339,1956042
10045,Lennard Hartjes,26,315800,4481307823680621,36,221656,79552,7956,71596
10046,Alex Hartridge,28,2582400,4112584688503474,236,3474593,776238,777,775461
10047,Daniel Harvie,60,729800,8525612319660580,301,2552874,579150,579150,0
10048,Jakob Haugaard,23,630600,4290502002258652,71,769213,9576,958,8618
10049,Marius Hauptmann,43,2641400,3578617031571260,325,4411169,2393901,240,2393661
10050,Zakaria Hawsawi,31,1490000,3431795750361069,178,2364298,2099871,209988,1889883
10051,He Chao,62,1008100,6914809427902446,340,3387792,2896844,2897,2893947
10052,Florian Heister,51,4785300,7678115425368593,599,8608745,2823305,2824,2820481
10053,Ammar Helac,23,2633300,8280093693480602,233,4137380,1213672,121368,1092304
10054,Zach Hemming,37,4385800,7847236930310756,494,7866753,2057611,0,2057611
10055,Fabian Herbers,40,461500,6672573781768394,147,1287952,234232,0,234232
10056,Ronald Hernández,50,3802700,5947168639802358,438,6486130,2400669,2400669,0
10057,David Herold,24,4565500,7452413200204318,366,6686680,4622435,4622435,0
10058,Julian Hettwer,37,2037400,4807016980083015,254,3353297,803604,0,803604
10059,Robin Heußer,24,3238000,6910084964962790,233,4398745,4020845,4020845,0
10060,Elliott Hewitt,46,3297000,6298857972569091,377,5593716,1209901,0,1209901
10061,Scott High,61,4225200,9428218674882988,566,7511931,3721492,372150,3349342
10062,Ben Hinchliffe,35,3765600,6296811178739911,378,6198584,1154315,1155,1153160
10063,Brendan Hines-Ike,36,4762100,6834028886173932,423,6894114,4326261,432627,3893634
10064,Patrick Hobsch,41,3041700,8294511051038871,349,5199412,38477,0,38477
10065,Raphael Hofer,26,4696000,8136206785167360,445,7664577,870786,0,870786
10066,Odin Thiago Holm,44,1245200,7952880767424801,213,2406251,563157,0,563157
10067,Jakub Holúbek,43,2796600,7535070552630871,346,4820431,3579465,3580,3575885
10068,Josué Homawoo,25,2321800,4958061675816227,223,3611320,1532233,153224,1379009
10069,Arttu Hoskonen,31,2673200,5058012394645467,258,3833723,3595022,359503,3235519
10070,Santeri Hostikka,52,4343600,3831297731589295,466,7374754,6921266,0,6921266
10071,Huang Zhengyu,60,4933900,5431209834312965,643,9297346,1308407,1308407,0
10072,Nico Hug,39,3356200,6074980385269011,355,5404460,2881927,2881927,0
10073,Tomáš Huk,42,4215100,6425209673083523,494,7191593,1414698,14147,1400551
10074,Deniz Hümmet,60,677500,6465270631151095,255,2163585,660175,661,659514
10075,Luis Enrique Hurtado,23,1470600,4916020764355714,100,1668732,831345,0,831345
10076,Omari Hutchinson,52,2777200,8998234981145907,414,5236105,4402042,4403,4397639
10077,Remeao Hutton,40,3343300,9696558754234535,396,5864943,5127647,0,5127647
10078,Florin Iacob,35,899600,6131525076615954,149,1544288,93521,0,93521
10079,Pedro Ibáñez,37,807200,7149379135735320,140,1518739,1389169,1389169,0
10080,Christopher Ikonomidis,40,2283600,4134876710105940,269,3723264,3516679,0,3516679
10081,Christian Ilić,48,3284900,5030359331460565,449,6512863,1923334,1923334,0
10082,Emirhan İlkhan,69,4242400,9618966857582324,646,8602361,7377180,73772,7303408
10083,Mikael Norø Ingebrigtsen,30,4055500,3557754937423366,380,6016823,863957,8640,855317
10084,Ryan Inniss,50,701100,9256283301098210,241,2108171,1996847,19969,1976878
10085,Jack Iredale,55,924600,6733818060763482,253,2326632,357896,358,357538
10086,Joe Ironside,30,722900,3958766448735627,122,1204155,950607,95061,855546
10087,Rareș Ispas,65,2197900,3561709191217894,453,5192457,1794685,180,1794505
10088,Cătălin Itu,38,4998300,9619541203679983,460,7695107,3431222,343123,3088099
10089,Mihajlo Ivančević,27,4983300,4428650853908444,433,7780735,4422437,44225,4378212
10090,Nosa Iyobosa Edokpolor,57,3322100,6166867110410830,461,6049953,5859688,5859688,0
10091,Adam Jackson,58,820500,9272992306391183,261,2233921,303710,0,303710
10092,Kayden Jackson,45,4217000,6261233380198389,459,7074872,7063619,7064,7056555
10093,Ben Jackson,36,1954200,3366847711281843,228,3048645,77514,0,77514
10094,Mohammed Jahfali,25,4215900,9433040525406967,339,5463993,610698,61070,549628
10095,Diallang Jaiyesimi,56,4586500,4520080031801277,581,8420350,1751749,175175,1576574
10096,Damian Jakubik,32,1536400,6018150442774661,171,2214223,1343666,1343666,0
10097,Jeremías James,55,2908200,4673990136016567,402,4956686,1214849,121485,1093364
10098,Tom James,48,2479400,8237807428799733,384,4802236,2643449,2644,2640805
10099,Patryk Janasik,22,862900,6330145243456772,89,1009425,473831,0,473831
10100,Budimir Janošević,26,2595300,9103468923617130,281,4164776,1703069,1703069,0
10101,Mehdi Jeannin,43,1277300,7777199346581668,246,2801297,1849917,18500,1831417
10102,Jekob Abiezer Jeno,37,4737200,7478999740251630,461,7355573,4522256,0,4522256
10103,Kevin Jensen,58,2514500,5364246321517612,420,4813608,3841285,3841285,0
10104,Anders Finjord Jenssen,45,2305000,4034716586145707,356,4521687,3381165,339,3380826
10105,Jeong Jae Yong,46,4630100,5301093725388374,544,8589914,171968,0,171968
10106,Jeong Sang Bin,52,794500,8963794752855300,237,2263973,621825,622,621203
10107,Sandesh Jhingan,28,1281600,7172672820987362,130,1849147,1536820,153682,1383138
10108,Hector Jimenez,24,2491700,3670486193244698,182,3044607,1103588,0,1103588
10109,Declan John,36,1867600,3838792365409366,267,3190275,2245457,22455,2223002
10110,Tyreece John-Jules,24,1592800,6161922785257103,120,1838360,443338,4434,438904
10111,Danny Johnson,60,1965200,7148161115784493,386,4326816,1487597,1487597,0
10112,Jamie Jones,45,530400,8930617048397821,162,1415960,94278,94278,0
10113,Jordan Jones,68,1408400,5204720614192635,407,4037327,2923972,0,2923972
10114,Jodi Jones,27,2547500,7759858069351235,264,3779496,3288233,328824,2959409
10115,Filip Jørgensen,25,2257100,9958008612494870,227,3676296,1197689,119769,1077920
10116,Kyle Joseph,32,568300,7795119323638730,101,924565,301975,0,301975
10117,Antoine Joujou,43,2404200,5686765924098554,278,4291541,1777915,177792,1600123
10118,Aleksandar Jovanović,22,548200,3673182564671973,42,462996,315417,31542,283875
10119,Ramón Juan,43,2323700,3358663985575671,283,3848431,3303059,3303059,0
10120,Brent Kallman,24,3383100,5588303950286565,277,4436671,888906,88891,800015
10121,Benjamin Källman,43,848900,5462389255537587,209,2194039,1572028,15721,1556307
10122,Jakub Kałuziński,40,2051000,5112360160884908,245,3268413,1239641,12397,1227244
10123,Kang Seong Jin,49,3174800,9325845329807173,418,6175911,5517099,55171,5461928
10124,Michał Kaput,51,4617800,9468923571827001,532,7782677,5572812,5573,5567239
10125,Ayman Kari,50,2219700,7335708949863602,375,4237858,640296,0,640296
10126,Gregory Karlen,69,338300,8544106602411846,309,2414813,1187375,0,1187375
10127,Sander Erik Kartum,68,3981200,5316327774492108,623,8216809,1433597,144,1433453
10128,Sinan Karweina,33,2652400,6019481083453534,265,4055721,1151698,1151698,0
10129,Dennis Kaygin,55,4706700,4422243052581824,597,8423875,466554,46656,419898
10130,Aidan Keena,70,1054900,6420969876567977,336,3180922,3014623,30147,2984476
10131,Davis Keillor-Dunn,29,2461500,7778344448505741,284,4244591,3664358,3664358,0
10132,Tidiane Keita,37,3261900,6216441991902344,320,4791203,2133372,213338,1920034
10133,Aboubacar Keita,29,4313800,5203200370630143,419,6373920,2093712,2094,2091618
10134,Can Keleş,28,1239800,7629973139161098,150,1782922,830977,0,830977
10135,Matty Kennedy,50,1701300,4736389440667988,325,3725659,1843112,1844,1841268
10136,Jonas Kersken,70,4445000,4360787246771872,606,7911898,1506148,15062,1491086
10137,Hugo Keto,44,1374600,6587351783346227,288,3010697,1932393,193240,1739153
10138,Awadh Khamis,70,2894100,9398957066601660,550,6606468,3076694,30767,3045927
10139,Mohammed Khubrani,67,3323400,8487549063860783,540,6468521,6406625,6406625,0
10140,Greg Kiltie,23,1109700,9691784914498954,96,1317853,427880,0,427880
10141,Kim In Sung,67,4322000,3114229508755274,623,7994377,3616914,0,3616914
10142,Kim Jun Yub,33,4114300,4036112260997337,380,6086916,809061,810,808251
10143,Kim Kyung Jung,29,4595900,6954593794265285,417,6571608,4993169,4994,4988175
10144,Kim Min Hyeok,47,4598500,3669175357004090,469,7694528,208659,20866,187793
10145,Kim Bong Soo,59,2388800,7695692710253183,388,4793183,3701518,3702,3697816
10146,Tom King,68,4426000,8295119452229688,655,8811052,2944007,2945,2941062
10147,Charlie Kirk,51,495100,5421242779846813,218,1945496,74591,7460,67131
10148,Harry Kite,61,4791100,9282756967226543,630,8770747,3170270,318,3169952
10149,Jonathan Klinsmann,56,2222100,7417809859083775,406,4993124,4605822,4606,4601216
10150,Marco Knaller,26,2994100,8907248634212879,256,4125427,2092522,0,2092522
10151,Karol Knap,49,3901200,7503380947381391,479,7147603,1144961,0,1144961
10152,Kyle Knoyle,31,3751900,9936512897787209,394,5761550,1560062,156007,1404055
10153,Fredrik P. Knudsen,67,2174400,6464028444993631,403,4836179,2067525,2067525,0
10154,Gabriel Kobylak,44,1353100,4026428000443092,235,2602067,2166856,21669,2145187
10155,Alberk Koç,22,4257400,6719127868259736,400,6403286,4581795,4581795,0
10156,Ali Koiki,43,2134200,9309440233069864,306,4243910,1027701,10278,1017423
10157,Niklas Kölle,24,1224000,9841585598965537,126,1752364,1635390,1636,1633754
10158,Žan Kolmanič,54,3189700,8038001174152139,453,6310155,5610937,5610937,0
10159,Ben Lhassine Kone,44,4858200,6348554048783742,517,8375272,515770,51577,464193
10160,Koo Ja Cheol,51,1664600,3358156743690068,283,3406242,1824655,0,1824655
10161,Dominik Kother,36,1999500,5319722419112575,234,3187534,2798761,2798761,0
10162,Giorgos Koutsias,60,389300,7227364626544171,249,2114320,73053,731,72322
10163,Franko Kovačević,58,2727200,9228282249338879,392,5235137,3736956,3737,3733219
10164,Julian Krahl,56,3736000,4163630706021781,487,6089576,548075,0,548075
10165,Filip Krastev,22,3119200,9368399835259794,294,4704249,2907385,0,2907385
10166,Tobias Kraulich,41,4255000,8333451246450518,462,6985579,1337346,133735,1203611
10167,Luca Kronberger,66,729100,8301349950908804,321,2669747,2437214,243722,2193492
10168,Mykola Kuharevych,64,2342000,3804296373495614,456,5433470,2223260,222326,2000934
10169,Dominik Kun,48,3362600,9247837481537664,427,5909407,2847345,0,2847345
10170,Mateusz Kupczak,35,3496100,9619535769039113,383,5674708,4519389,0,4519389
10171,Hector Kyprianou,32,1505300,6193564378599937,156,2132395,609942,610,609332
10172,Achraf Laâziri,37,768800,3831441178387438,142,1469644,1358029,1359,1356670
10173,Mathis Lachuer,29,2038000,9931237445057166,202,3100506,2282348,228235,2054113
10174,Sonny Laiton,29,2538200,7410744297501030,241,3751122,2310103,231011,2079092
10175,Niklas Landgraf,35,3981200,5750211121327575,391,5919785,4110619,412,4110207
10176,Paddy Lane,62,3791000,4681019204043408,608,7705112,3728704,0,3728704
10177,Christoph Lang,39,391500,9270295478648767,130,982218,132564,1326,131238
10178,Christopher Lannert,24,1702400,7139220511973613,142,2294947,62079,0,62079
10179,André Ricardo,26,2931100,3932317276560856,240,4113359,1084748,1084748,0
10180,Edgar Lastre,31,1048000,5411275563344135,150,1847364,183763,18377,165386
10181,Sam Lavelle,64,3497700,8762561101305284,522,6487765,2635172,2636,2632536
10182,Lee Yong Rae,31,4004500,8418273341378045,335,5883661,545177,545177,0
10183,Lee Hee Kyun,48,3429300,8765233975222962,398,5645906,1606769,160677,1446092
10184,Lee Si Young,35,315100,3277361634515244,100,711385,500696,0,500696
10185,Lee Woong Hee,53,2661900,7613542751687181,434,5082298,29576,0,29576
10186,Lee Seung Woo,27,4827400,4750664024191112,432,7207444,4415578,441558,3974020
10187,Adam Legzdins,70,2036800,9460241206111773,447,4616163,477254,4773,472481
10188,Ari Leifsson,62,3660000,9417686033903701,564,6968908,1457639,14577,1443062
10189,Greg Leigh,50,3980100,4464072057946622,436,6954190,480234,481,479753
10190,Tommy Leigh,45,3943500,8238555625648139,511,6424657,1317980,0,1317980
10191,Jonathan Leko,67,1425300,7149927652902463,402,3888395,2580118,259,2579859
10192,Stav Lemkin,30,980000,5132618639155713,149,1540639,696650,0,696650
10193,Théo Leoni,51,4265100,9502415671961199,508,7417626,6603689,66037,6537652
10194,Rafał Leszczyński,58,2942800,6754894656086036,416,5454057,2147937,2148,2145789
10195,Aaron Lewis,36,2779900,6494500774576375,336,4782566,3942048,0,3942048
10196,Danny Leyva,53,1520000,8714479302088737,282,3151021,320445,0,320445
10197,Anton Liljenbäck,50,4926800,4254098376138964,543,8245443,6525740,65258,6460482
10198,Jonathan Lima,33,4158900,8366100211842241,403,6147054,509691,510,509181
10199,Marcus Lindberg,31,4567200,9537229604533620,390,6912666,1929434,19295,1910139
10200,Joakim Lindner,41,904600,9062314680735665,186,1959213,976063,976063,0
10201,Lucas Lissens,46,4391200,4460650760376793,496,7632243,7459593,0,7459593
10202,Krisztián Lisztes,33,4121400,8227568093275874,425,6529405,4539751,4540,4535211
10203,Liu Junshuai,58,1417400,4920193760113101,320,3541081,1535311,0,1535311
10204,Liu Yun,28,1247500,6478777613389233,151,1792614,348130,0,348130
10205,Ulysses Llanez Jr.,69,4967000,9013505328279479,712,10069396,8918951,8919,8910032
10206,Seàn Long,45,3220700,3847188513801376,331,4964989,2800926,0,2800926
10207,Iago López,44,3647600,5045201368614793,380,5855939,4104201,41043,4063158
10208,Florian Loshaj,63,4588700,6993269635526359,601,8135344,5511703,5511703,0
10209,Victor Loturi,45,1793800,6403005320722741,271,3344344,501042,0,501042
10210,Alex Lowry,51,1560600,9390020339872345,338,3736928,2065507,207,2065300
10211,Kilian Ludewig,62,886300,6163219466574762,345,3103197,1596122,159613,1436509
10212,Leonardo Lukacevic,69,3204800,9357671037388111,496,6029383,1699194,170,1699024
10213,Andreas Lukse,30,3246800,6433509652208918,310,4821293,3308185,0,3308185
10214,Gabriel Lunetta,39,1678300,7574804656771061,215,2575858,968166,969,967197
10215,Steven Luštica,27,4315400,3730612876238306,383,6302681,3370324,33704,3336620
10216,Arthur Lyska,24,4224200,7943709491359150,338,6085536,5191576,0,5191576
10217,Paddy Madden,33,3239800,7366684207604419,331,4955190,2876013,2877,2873136
10218,Niilo Mäenpää,59,834700,5908106212828822,278,2778295,755192,75520,679672
10219,Maestre,50,2613600,3451248052847439,351,4843648,497198,497198,0
10220,Sævar Atli Magnússon,54,833200,8448371301056058,238,2392744,1928569,193,1928376
10221,Patryk Makuch,37,3386700,5497657184509984,387,5500064,5027241,50273,4976968
10222,Adrian Małachowski,43,4712300,7092490836165865,489,7344269,5435865,5436,5430429
10223,Mustafa Malaeka,33,3255300,3594287278589148,342,5374952,973465,0,973465
10224,Stevie Mallan,46,1766400,4007416545037389,289,3166944,836154,8362,827792
10225,Sultan Mandash,27,2928200,7885417247191968,258,4147480,2054016,0,2054016
10226,Alan Mannus,26,1695700,7179292269135561,144,2133144,2023679,2023679,0
10227,Rai Marchán,23,984300,5076219658545022,96,1257233,742608,74261,668347
10228,Adrian Mariappa,32,3493400,9779873933596497,340,5032876,268354,269,268085
10229,Alan Marinelli,30,2312700,3747250116547927,261,3591437,170661,0,170661
10230,Unai Marino,38,639000,5320574274850256,149,1428950,314190,315,313875
10231,Eman Marković,62,3625600,3595817951551909,507,6786033,6003291,60033,5943258
10232,Herald Marku,47,1530100,5254729275820993,249,3001159,2863843,2864,2860979
10233,Félix,28,4650100,4591983171094037,390,6732311,3780321,379,3779942
10234,Kevin Martin,24,2916300,4738248402114613,221,3785977,3385432,339,3385093
10235,Ariel Martínez,49,4375400,3089309184391529,543,7579934,3029505,30296,2999209
10236,Julio Martínez,60,3137300,7249054395470019,533,6739008,3368794,3369,3365425
10237,Newerton,50,3837800,4008251129476742,449,6518086,5677698,5678,5672020
10238,Remi Matthews,53,4903400,9554017294056705,597,7811699,1468951,1469,1467482
10239,Miłosz Matysik,29,1477100,8634678303839176,147,2182989,578873,0,578873
10240,Aïman Maurer,55,3181400,3287153832254541,470,6201627,1719388,0,1719388
10241,Moses Mawa,50,4701100,9370248055147137,572,8447812,3318028,332,3317696
10242,Niklas May,49,3335700,8741706033973034,423,5431686,1235319,123532,1111787
10243,Ashley Maynard-Brewer,69,3516800,3055169881022655,582,7940014,1685823,1686,1684137
10244,Lewis Mayo,25,4188000,6088690952155376,313,6042343,3094550,0,3094550
10245,Fally Mayulu,59,366000,8625286499559373,256,2080471,1616640,161664,1454976
10246,Noah Mbamba,68,1688000,5470160578558064,426,4562951,3874637,388,3874249
10247,Pathé Mboup,30,2391700,4109641069867516,204,3363990,2785051,2785051,0
10248,Conor McAleny,26,694600,8642040167149955,70,810447,225404,225404,0
10249,Jamie McCart,40,3010000,4892057643260973,390,5121213,290322,291,290031
10250,Jason McCarthy,64,2342800,8631117054065731,394,5140490,370993,371,370622
10251,Sean McConville,39,2621000,9795763977235367,315,4344384,1609383,161,1609222
10252,Callum McCowatt,62,2698000,7518741790682049,467,5305852,900845,0,900845
10253,Rod McDonald,46,1236700,5723612450932909,252,2821328,975829,97583,878246
10254,Kevin McDonald,51,1642300,8817468362715550,286,3328202,2508670,2509,2506161
10255,Patrick McEleney,41,3847600,9898207757089508,475,6571396,816798,817,815981
10256,James McGarry,56,1674000,6705517715836739,336,3560453,948372,949,947423
10257,Dylan McGeouch,38,4750400,7069319781434485,500,8116310,676032,0,676032
10258,Conor McGrandles,61,4452200,9585976388976241,570,7966354,76543,0,76543
10259,Kendall McIntosh,35,777900,3771426750109620,114,1251712,208637,0,208637
10260,Harry McKirdy,66,2829000,7597419565300294,477,6302274,161279,16128,145151
10261,Paul McMullan,68,1345600,4684437899503101,345,3498083,1634925,1635,1633290
10262,Christopher McVey,50,1452900,3743259730882615,271,3021973,1620051,0,1620051
10263,Ryan Meara,45,831400,6132408280279535,212,1991903,1219424,0,1219424
10264,Paolo Medina,65,3721900,8119533341755707,574,7706912,5528463,55285,5473178
10265,Jimmy Medranda,56,1828700,8324494097392613,320,3797565,3789407,378941,3410466
10266,Medrano,33,3167300,9649166604033461,291,5046836,3211757,0,3211757
10267,Bart Meijers,36,3248200,3763005512775128,362,5268581,4552235,0,4552235
10268,Alejandro Meleán,57,1847900,7037553486173001,346,4344237,2987455,298746,2688709
10269,Yair Mena,66,3856300,8562469492386661,543,6945660,1324334,133,1324201
10270,César Menacho,26,1484300,9851953545661011,173,2316039,1986602,19867,1966735
10271,Cristopher Mesías,27,1169400,3218056212578258,135,1652040,1388531,13886,1374645
10272,William Mikelbrencis,60,1464500,3211900423209338,377,3840647,1018587,1018587,0
10273,Lewis Miller,45,2268900,7615741605176411,337,4302791,206486,2065,204421
10274,Eric Miller,22,1988200,9414332732338469,162,2475353,1159767,0,1159767
10275,Vincenzo Millico,57,4473700,6507949439698405,533,7509532,6874935,6874935,0
10276,Johan Mina,59,832700,3400436187923382,305,2827975,2179332,0,2179332
10277,Sixto Mina,30,1732500,3832063320588809,197,2706035,2234469,2235,2232234
10278,Muzepper Mirahmetjan,28,3124600,8000704042358406,309,4743879,3844265,3845,3840420
10279,David Mitov Nilsson,61,2715200,6181142389819928,421,5681021,188013,188013,0
10280,Guillem Molina,24,408700,4567582314356587,18,158675,45574,45574,0
10281,George Moncur,60,2337900,5885958560768335,453,5073456,566125,56613,509512
10282,Cristian Montaño,24,4569700,9801470342329350,391,6688168,6554185,655419,5898766
10283,Joël Monteiro,70,1581500,6330764093577484,374,4041774,3512653,35127,3477526
10284,Adam Montgomery,33,4171500,8251116849443152,455,6729015,2487783,0,2487783
10285,Moon Seon Min,34,936200,7959419142121743,175,1926524,1854438,18545,1835893
10286,Jordan Moore-Taylor,50,4072900,7625394716682568,450,7001108,847564,0,847564
10287,Gonzalo Morales,40,1226600,4497489168843208,202,2261935,34056,3406,30650
10288,Iván Morante,70,3679800,3611140147231349,523,7305536,3188664,3188664,0
10289,Valtteri Moren,25,3540700,6715073464286123,294,4714427,2678626,26787,2651839
10290,Kliver Moreno,48,1269800,9791543667188330,254,2549951,345340,345340,0
10291,Morillas,35,327500,5937018308000138,86,668600,180793,0,180793
10292,Ebiye Moses,53,949600,9776073980068400,260,2633778,2154641,216,2154425
10293,Joaquín Mosqueira,38,3574200,9070590012368498,380,6096412,420848,42085,378763
10294,Bevis Mugabi,50,1205800,8831507505138430,268,2832091,2300034,23001,2277033
10295,Liridon Mulaj,43,4755800,6087252979727379,499,7314013,7106729,71068,7035661
10296,Sven Müller,24,2086700,7884311197444711,177,2671129,2562858,25629,2537229
10297,Josh Murphy,70,3934000,9041019411054492,573,7214921,2609913,2609913,0
10298,Sebastian Musiolik,47,4165700,7643303753684328,495,7154963,6008812,600882,5407930
10299,Valdrin Mustafa,52,4638400,4079004163882040,593,7914324,2508431,0,2508431
10300,Jakub Myszor,57,3410100,7482203834352087,514,6357006,2174262,0,2174262
10301,Niclas Nadj,63,875900,4012824966736799,318,3088706,2995700,29957,2965743
10302,Michał Nalepa,24,3317000,6759044449150208,268,4600436,3762151,0,3762151
10303,Mickaël Nanizayamo,24,4450100,8489202387911497,365,5939107,811514,0,811514
10304,Johannes Naschberger,65,1260700,6498142923624903,326,3524289,609197,6092,603105
10305,Bojan Nastić,65,4928500,8126108040074870,624,9113387,6739901,6739901,0
10306,Miguel Angel Navarro,29,2310100,6486082737996989,244,3499078,1266739,127,1266612
10307,Massamba Ndiaye,48,4301500,4494767080904582,466,7272786,3864938,0,3864938
10308,Noha Ndombasi,39,2702600,7069330953620912,364,4783057,4485311,4485311,0
10309,Camiel Neghli,56,2879200,7317435824148123,432,6024642,4235376,0,4235376
10310,Aaron Nemane,60,3471800,3401653393002070,543,7182040,2222483,223,2222260
10311,Scott Neville,56,3822700,7053683863547914,503,6672485,5316371,0,5316371
10312,Tom Nichols,64,3086300,9721151943488465,521,6477599,3115936,3115936,0
10313,Karol Niemczycki,61,2388600,9249616173794305,407,5124413,1823934,1824,1822110
10314,Jona Niemiec,42,2978400,9982973801259805,375,5504575,2565380,0,2565380
10315,Lasse Nilsen,35,3472200,8364128820509291,308,4925424,3616018,362,3615656
10316,Ilmari Niskanen,28,4575200,6338664394730009,369,6225892,1404081,1405,1402676
10317,Steffen Nkansah,25,1635700,9543208743511493,153,2303986,830068,831,829237
10318,No Dong Geon,56,750700,7770554006007981,288,2767329,2628385,262839,2365546
10319,Gustaf Norlin,41,2839500,5356152156363368,342,4725002,2939111,29392,2909719
10320,Cameron Norman,40,1289600,5851124100529046,236,2775807,1674513,1675,1672838
10321,Michael Nottingham,58,1732600,5595073167264286,393,4305509,460390,0,460390
10322,Luizão,46,4553500,8887348522364070,481,7596931,3278384,327839,2950545
10323,Nachon Nsingi,39,2512300,8958484467548109,303,4205977,1276354,1276354,0
10324,Ayo Obileye,35,829200,8696005771253547,138,1362789,364958,0,364958
10325,Nico Ochojski,52,4509200,5124517167777358,533,7667972,1345325,13454,1331871
10326,Magnar Ødegaard,64,2474600,9092346479546295,469,5315595,501259,0,501259
10327,Phil Ofosu-Ayeh,66,3293700,5478342982469864,518,6675984,5843110,0,5843110
10328,Sebastian Ohlsson,51,4691800,6029614764859520,538,7865879,4727685,472769,4254916
10329,Osarenren Okungbowa,51,1116100,9839807977624375,282,2860755,1467663,1468,1466195
10330,Kazeem Olaigbe,28,2842800,3654472474459868,285,4160033,2718407,2718407,0
10331,Fabrice Olinga,34,2774300,5132060194892464,304,4375137,4364245,436425,3927820
10332,Paweł Olkowski,45,3124600,3056183482163365,407,5464375,4297539,430,4297109
10333,Ervin Omić,29,2635200,4668471588997309,235,3659432,155259,1553,153706
10334,Kristian Onsrud,45,1093000,9329786930669439,208,2261543,1489051,1490,1487561
10335,Jandro Orellana,34,4666100,9695990814869765,437,7500376,3023501,302351,2721150
10336,Rasmus Örqvist,51,2457500,9117085980474564,362,4891517,3180241,0,3180241
10337,Christian Ortag,35,4059700,9922886602262665,405,6136432,934294,0,934294
10338,Franco Ortellado,50,3040300,3634369190731324,435,5595716,4560695,457,4560238
10339,Tomás Ortíz,32,1918200,4862489943869061,186,2667605,2460210,247,2459963
10340,Deji Oshilaja,70,2607800,6982500710327616,454,5540124,2409870,241,2409629
10341,Sebastian Osigwe,47,3643400,5795740048984677,440,6459335,771228,77123,694105
10342,Diego Osio,47,1550800,5989439548063269,233,2660364,902021,903,901118
10343,Patricio Ostachuk,34,2259100,4496836135483147,249,3514804,269736,2698,267038
10344,Zinédine Ould Khaled,70,4854400,4991039032140505,741,9830590,6469484,64695,6404789
10345,Bilal Ould-Chikh,61,1754100,9269991861174990,356,3795681,1317747,1318,1316429
10346,Fabricio Oviedo,59,4781000,5218218358713366,658,9512449,7697879,7698,7690181
10347,Owono,22,4525400,4431151382845560,384,6359288,4876686,488,4876198
10348,Valentine Ozornwafor,68,1063600,5687842711943813,417,3899507,2245338,2246,2243092
10349,Aleksi Paananen,70,2982900,3859118801947593,522,6298586,464840,0,464840
10350,Steven Pabón,58,4592700,6174817521558438,627,8537390,5950161,0,5950161
10351,Rune Paeshuyse,46,4471800,6051605619233111,517,7440771,6189629,61897,6127732
10352,Tomás Palacios,44,1560900,8586968762642808,226,2958923,1684506,169,1684337
10353,Matt Palmer,56,990500,4619690512263185,264,2426192,1466978,0,1466978
10354,Aleksander Paluszek,54,1529600,4435640305999879,338,3487106,3119759,312,3119447
10355,Simone Panada,44,2556700,5863934395596206,352,4660265,465802,4659,461143
10356,Ștefan Pănoiu,56,3815900,6011486763152348,507,7228870,782801,7829,774972
10357,Park Han Bin,43,1185900,7665956304697953,248,2797423,2198469,0,2198469
10358,Will Patching,60,3377900,3060340182929974,477,6654919,6254257,62543,6191714
10359,Tom Pearce,67,4694900,7773838156209983,697,9814385,2166860,216686,1950174
10360,Kasper Pedersen,22,3949300,4388804879141742,340,5806631,3748554,374856,3373698
10361,Thore Pedersen,64,3089200,5667443373014168,491,6164992,5376855,53769,5323086
10362,Rodney Pedrozo,69,4908000,8837434879941419,718,9069694,5462550,546255,4916295
10363,Andy Pembélé,27,3236100,9193993743231095,284,4847164,571325,572,570753
10364,Jason Pendant,62,3568200,7546674054944717,531,7304061,62444,0,62444
10365,Oscar Perea,41,369600,7246713821247575,139,1057628,264600,0,264600
10366,Diego Perea,64,3184100,5686512678158726,514,6744359,5524465,0,5524465
10367,Guillermo Pereira,53,4578800,5863624019745346,583,8163151,1615662,0,1615662
10368,Adrian Petre,47,2167500,3092495272721011,351,4269850,577904,0,577904
10369,Petrișor Petrescu,49,2765100,9504357836793568,444,5418118,1532492,1533,1530959
10370,Charles Petro,22,1941600,5642414287782237,136,2202597,1629,1629,0
10371,Kyrylo Petrov,24,351300,4662347820176476,54,415912,385184,3852,381332
10372,Oscar Pettersson,42,4904100,4400730210399037,520,8272223,7488786,749,7488037
10373,David Philipp,39,3772000,3261819850435796,435,6037735,5332794,534,5332260
10374,Rayan Philippe,38,507900,5873799301769888,117,1032621,212200,0,212200
10375,Kieran Phillips,32,1757600,6882210990799671,181,2398156,721141,722,720419
10376,Daniel Phillips,28,300500,8517795497349147,58,384728,379853,0,379853
10377,Piao Shihao,22,3394400,8374426123404461,281,4867305,1840118,0,1840118
10378,Nicholas Pierini,45,2301300,5671465186360589,353,4488378,648388,649,647739
10379,Joe Pigott,54,4219800,8749430492067352,542,7798147,2100286,0,2100286
10380,Fernando Piñero,31,3617200,5221765147598678,323,5095316,5071038,0,5071038
10381,Andrei Pițian,50,4350700,4029763442253491,535,7470425,7466748,7466748,0
10382,Scott Pittman,35,1770800,3989601470880141,213,2695696,207840,20784,187056
10383,Patricio Pizarro,70,1933200,7869926533857888,442,4756870,2375339,0,2375339
10384,Brian Plat,44,4624500,5119721898249582,496,7180091,2903672,290368,2613304
10385,Marko Poletanović,66,1069500,9586166120691403,362,3564173,1866829,1866829,0
10386,Liam Polworth,30,4948900,3465704368509426,489,8216479,5176541,5176541,0
10387,André Anderson,49,1579500,4140152166448142,273,3045654,1830769,0,1830769
10388,Fabio Ponsi,41,2994500,9481647682390807,328,4610688,3312830,0,3312830
10389,Konrad Poprawa,58,1120800,3366449404032223,339,3070642,1291326,1291326,0
10390,Lucas Pos,63,3765600,5893524922079011,579,7350147,745039,746,744293
10391,Joe Powell,57,1864600,7926311279624031,351,4083497,2837057,0,2837057
10392,Fernando Prado,28,4122600,3414264691917365,368,5992803,5319462,53195,5266267
10393,John Pulskamp,30,3768200,3373279279799736,392,6013548,2245244,0,2245244
10394,Kolja Pusch,66,3862300,8322074518884442,577,7373384,2935612,2936,2932676
10395,Danilo Quaranta,42,3271800,5274845291310197,339,5112936,1478633,14787,1463846
10396,Ronald Quinteros,36,4014300,6388571223836208,404,6194418,2045816,20459,2025357
10397,Maico Quiroz,48,1156000,5568461398022098,252,2583602,1122927,1122927,0
10398,Vedad Radonja,30,836100,8008057493639261,129,1344626,1134904,114,1134790
10399,Mihai Răduț,45,1428000,5633587559884204,261,2938914,468000,468000,0
10400,Toon Raemaekers,34,1371600,6386292897900570,203,2454918,1586288,0,1586288
10401,David Ramírez Picsiotti,52,1858400,8380372354032595,337,4006409,2612312,2613,2609699
10402,Joel Randall,64,648300,9854371100832469,326,2626843,917260,91726,825534
10403,Will Randall,63,2770400,8763261046464082,474,5740250,1024106,0,1024106
10404,Ryan Raposo,67,4792300,7539255716966356,658,9001750,8967973,0,8967973
10405,Serge-Philippe Raux-Yao,30,1893900,5160949500636578,195,2933385,2790629,280,2790349
10406,Matt Real,58,1155300,3598973848306937,316,3153885,1115312,0,1115312
10407,Rodney Redes,24,1012200,5973059994761992,80,1173245,732408,0,732408
10408,Andrew Redmayne,68,2049000,3928609322461015,472,5264400,4584826,459,4584367
10409,Joe Redmond,68,3159600,3977894191947252,447,5761569,403285,0,403285
10410,Louis Reed,28,4234300,8352529374462436,404,6838556,5582418,5583,5576835
10411,Jake Reeves,40,638500,8224917973966012,146,1377222,1254737,125474,1129263
10412,Johannes Reichert,45,1162700,9246412516030447,228,2623245,1262372,12624,1249748
10413,Eliano Reijnders,42,3869500,6388162263889424,417,6330808,4276507,427651,3848856
10414,Nicolai Remberg,56,4856800,4508752483163692,581,9028899,8198112,0,8198112
10415,Jorge Rengifo,70,683900,8302860709880920,363,3140883,3001611,0,3001611
10416,Spencer Richey,65,2849800,6164713330032725,533,6056791,544772,544772,0
10417,Charles,37,3357800,4218489622260150,363,5195019,3316115,3316115,0
10418,Gonzalo Ríos,25,4996700,7468112493442049,475,8430290,2950539,0,2950539
10419,Andrés Ríos,51,699100,6166859569227780,205,1823681,1347759,1347759,0
10420,José-Enrique Ríos Alonso,58,4015400,4312490989137531,540,7659767,2241138,0,2241138
10421,Matthis Riou,61,1936800,8975619193884156,381,4184790,2160555,217,2160338
10422,Daniel Rivas,63,553100,3509066511958775,270,2199879,145832,145832,0
10423,Maxence Rivera,70,4128500,8669060082796100,673,8474699,7702396,0,7702396
10424,Nigel Robertha,31,534500,9308941608236148,112,937790,709336,0,709336
10425,Jordan Roberts,44,1275000,5981542797681965,224,2473260,300049,301,299748
10426,Brian Araújo,70,459300,4776038053205921,384,3350889,296855,0,296855
10427,Jamie Roche,63,4970500,4105580173420212,692,10034656,6563643,657,6562986
10428,Bruno Rodrigues,37,735900,9782657436148607,142,1460866,866988,867,866121
10429,Rúben Rodrigues,23,1646800,9741344350172232,137,2221192,1524673,1525,1523148
10430,Mauro Rodrigues,59,4855600,7202654486883836,535,7239494,3210819,321082,2889737
10431,Francisco Rodríguez,23,4101800,9782792287695304,321,5690716,1319907,131991,1187916
10432,Jonathan Rodríguez,69,4394900,6871498438326002,680,8447840,3709887,371,3709516
10433,Omar Rodríguez,34,1367500,5594513853270147,185,2236280,808270,8083,800187
10434,Randall Rodríguez,45,1065200,8408687897518537,212,2345292,1516021,152,1515869
10435,Derlis Rodríguez,37,4650300,8290784627485029,443,7289783,881685,882,880803
10436,Marko Roganović,28,4211700,5821165110213110,395,6022820,3747103,0,3747103
10437,Jeyson Rojas,30,1427600,3070575302152239,139,1946134,1038943,0,1038943
10438,Alin Roman,49,4681300,3245389734213683,571,8273955,558912,559,558353
10439,Mario Rondón,52,1623100,8880738321471441,315,3383932,1480754,148076,1332678
10440,Ricardo Rosales,27,1658700,4598319146024388,167,2592546,786100,78610,707490
10441,Linus Rosenlöcher,52,2093500,3186389414614462,364,4083216,3764914,3764914,0
10442,Sondre Rossbach,44,3498100,5301757999972190,392,5837444,1768195,0,1768195
10443,Alessandro Rossi,64,3958100,5775811231353943,584,7290471,463177,464,462713
10444,Björn Rother,67,4521500,5421913145117685,662,8776243,5823007,583,5822424
10445,Thomas Rotter,34,3519400,4118373561686800,307,4860158,2573896,0,2573896
10446,Manel Royo,36,1481700,9761854287510805,195,2515887,1628036,163,1627873
10447,Francesco Ruberto,57,1725600,3110599370631229,309,3506117,234940,0,234940
10448,Fabian Rüdlin,27,957700,5632719842179340,94,1285311,496967,0,496967
10449,Jon Russell,41,4331200,7142740406651760,410,6554137,5603747,0,5603747
10450,Stefano Russo,59,1328400,9329656102932624,318,3295908,3157893,3158,3154735
10451,Michał Rzuchowski,24,3971700,3757888732685088,307,5912576,3174829,3175,3171654
10452,Kyriani Sabbe,55,2580700,7850589299921361,426,5592913,441332,0,441332
10453,Jesús Sagredo,50,1805600,4026223719139166,292,3400210,349004,34901,314103
10454,Ibrahim Salah,30,4886900,6050821336406076,401,7019624,714800,715,714085
10455,Ronivaldo,59,2143600,9405072568639551,369,4728139,363475,3635,359840
10456,Zakaria Sami,42,4728700,5722221969084735,500,7056300,6340084,6341,6333743
10457,Mateo Sanabria,60,3285500,8975740236653434,480,6001274,380916,0,380916
10458,Florent Sanchez,39,4501800,7264442836179858,516,7880914,6208730,0,6208730
10459,Alejandro Sánchez,37,2267800,8385155519752335,233,3377686,2340915,0,2340915
10460,Andrés Sánchez Duque,32,4502300,4891204780762192,377,6484302,431402,0,431402
10461,Mads Sande,45,1305000,9125895486458377,220,2649510,721542,722,720820
10462,Cisse Sandra,23,4971800,3031999532859561,382,6534565,5907367,590737,5316630
10463,Opa Sangante,48,1033300,4623320549504707,262,2566342,1630140,164,1629976
10464,Mamadou Sangare,55,3254300,6902321477429204,445,6062732,5721116,573,5720543
10465,Mohamed Sankoh,22,4250800,4080608915787992,389,6795321,1619299,16193,1603106
10466,Rodrigo Henrique,38,4183800,3697813110502024,420,6414258,4796817,0,4796817
10467,Jonatas Santos,26,3460000,5741157734572730,300,5311034,3927088,0,3927088
10468,Facundo Saravia,46,1579400,7466403508363584,299,3326994,51666,5167,46499
10469,Jannenson Sarmiento,67,2775700,9353425520331763,518,6361856,351456,0,351456
10470,Giannis Satsias,66,2233300,9370953309602845,513,5835683,2785743,278575,2507168
10471,Marco Sau,22,2543900,9813430497564417,198,3514657,128691,0,128691
10472,Răzvan Sava,34,1518900,7031012176393137,172,2333625,1419528,142,1419386
10473,Stefan Savić,23,2727100,6186424409597745,256,4130928,2215175,222,2214953
10474,Christian Saydee,27,1277100,7300868784743466,108,1635523,1597563,15976,1581587
10475,Simon Scherder,50,1594000,3430945150964382,295,3170553,2791053,280,2790773
10476,Derry Scherhant,64,2044400,8219947080579079,419,4755881,4180387,41804,4138583
10477,Jonathan Scherzer,46,380200,6066457406921035,150,1161965,198883,19889,178994
10478,Marco Schikora,37,1124400,6138908663709606,188,2086939,2066428,206643,1859785
10479,Rodrigo Schlegel,56,4266900,8893320248097562,535,7493905,4576737,4576737,0
10480,Till Schumacher,45,550600,7804252391904772,221,1851602,1727317,17274,1710043
10481,Tobias Schützenauer,60,627400,4857956947211469,283,2296286,1941497,194150,1747347
10482,Dominik Schwizer,42,2927300,4462641396786358,385,5369655,2489894,0,2489894
10483,Tim Sechelmann,49,592200,7987471033627000,206,1789240,1494515,1494515,0
10484,Demba Seck,62,4438200,4131261078981290,608,8174536,791459,0,791459
10485,Amar Sejdič,22,469600,8772417336637998,20,218743,26625,2663,23962
10486,Nikola Sekulov,23,1906900,5952877655760204,138,2277252,482109,482109,0
10487,Maic Sema,66,3334700,6388047888614518,483,6600072,1595976,0,1595976
10488,Marvin Senger,23,2028300,5719688056138863,186,3029366,2085691,208570,1877121
10489,Brandon Servania,45,3829000,9266513036025652,491,6626685,1752862,1753,1751109
10490,Nicolás Sessa,45,1020100,7366907130439950,256,2570770,633678,0,633678
10491,Conor Shaughnessy,23,3170800,8389969639668581,233,3839188,1519405,1520,1517885
10492,Nick Shinton,57,1183800,5332959867247816,296,3130495,384920,38492,346428
10493,Carlo Sickinger,51,1445700,9071808963307706,271,3151386,318146,31815,286331
10494,Samuel Teles,37,441100,9614126486887606,126,1011543,544554,5446,539108
10495,Santiago Silva,50,1929200,8292318115019628,296,3672427,201344,202,201142
10496,Miguel Reisinho,34,3132100,7385100456958143,284,4421323,1357294,136,1357158
10497,Xavier Simons,34,1268500,6384117814687186,180,2252817,450026,0,450026
10498,Lassine Sinayoko,38,2124000,5317213670095773,273,3710198,3012209,3012209,0
10499,Gurpreet Singh Sandhu,35,1902700,3015826652579814,241,3003238,643509,644,642865
10500,Michal Sipľak,48,3179000,8048948465356992,396,5414557,815426,816,814610
10501,Dan Sîrbu,24,3797400,5524938290742556,320,4917679,3031966,303197,2728769
10502,Ayanda Sishuba,45,961400,3230088941005460,211,2073615,1027437,0,1027437
10503,Pablo Sisniega,54,4619400,8038060848325551,606,8613990,1831335,1831335,0
10504,Pione Sisto,25,1501300,9976722880004365,117,1857276,733928,734,733194
10505,Javi Siverio,25,1457600,5720094417185455,145,2008682,417216,418,416798
10506,Magnus Sjøeng,22,946700,8882865659888002,66,907216,312765,313,312452
10507,Fredrik Sjølstad,31,2598500,7411766421371195,230,3913190,406654,0,406654
10508,Rasmus Sjöstedt,67,4809800,6267062833628689,684,9486623,9290869,9291,9281578
10509,Andreas Skovgaard,59,2484900,6208066013451889,466,5502703,2030046,0,2030046
10510,Jonny Smith,37,2123000,4579908465417140,277,3497726,2198184,21982,2176202
10511,Matthew Smith,56,1000100,7246161574637955,284,2686727,2033565,2033565,0
10512,Amadeus Sögaard,28,1139500,4709850125992330,107,1437097,496098,4961,491137
10513,Pascal Sohm,58,1318500,9357282091370275,314,3408606,2027157,2028,2025129
10514,Pyry Soiri,58,680600,9870237444058971,263,2473686,1064354,106436,957918
10515,Lasse Sørensen,56,4621000,5635238678651985,519,7690388,6508722,0,6508722
10516,Matthew Sorinola,29,1589600,4561073653352847,198,2616245,1582072,159,1581913
10517,Diego Soto,41,2466900,6213831640435152,325,4312638,752024,0,752024
10518,Gabriel Sotomayor,28,1941600,7176615126330373,160,2595641,640859,640859,0
10519,Edoardo Sottini,60,1806700,7367637915956763,375,4248003,250318,0,250318
10520,Rafael Brito,40,1440700,7127000129186146,199,2501926,1308944,1308944,0
10521,Noé Sow,58,1393800,7246670672962172,345,3778510,293465,0,293465
10522,Avdo Spahić,61,4197200,5682470008759442,595,8056745,4547511,455,4547056
10523,Jack Sparkes,43,4699400,3424299421817159,430,7331217,3835720,3835720,0
10524,Raphael Spiegel,50,2770800,4445776804927233,379,5260392,283491,283491,0
10525,Isak Ssewankambo,44,2701100,7372640871599476,394,4786768,3517779,0,3517779
10526,Albert Stahl,54,3605600,7881886515600906,497,7127093,5085848,50859,5034989
10527,Adam Ståhl,23,4349500,7205926456556589,392,6805061,836611,0,836611
10528,Jay Stansfield,51,3087300,7485458775618193,417,5369855,4857754,48578,4809176
10529,Manfred Starke,32,974300,9022457283808621,118,1330170,984632,984632,0
10530,Filip Starzyński,57,1840900,8669121888493180,366,4234417,3775393,3775393,0
10531,Lucas Stassin,28,1061600,4450073567881580,104,1453865,603885,60389,543496
10532,Daniel Stensson,31,4049300,4123345692257345,412,6561838,5201667,52017,5149650
10533,Daniel Steres,64,4844300,9974324163521793,641,9379394,2913190,291319,2621871
10534,Ben Stevenson,55,4153900,6111311987443595,467,7076982,509811,509811,0
10535,Niclas Stierlin,45,3471900,6043899649711402,412,5735954,1881422,188143,1693279
10536,Jacob Storevik,37,671900,5347969515074617,160,1453334,353815,35382,318433
10537,Felix Strauss,64,4397100,7071535648584029,597,8494182,4080281,0,4080281
10538,Sam Stubbs,34,3229600,8743918924802017,354,5573926,5258646,0,5258646
10539,Dominik Stumberger,48,4785500,7353254392052292,568,8082375,1214586,1215,1213371
10540,Álex Cardero,55,1250100,8867346588046539,290,2951215,1922627,193,1922434
10541,Marco Suárez,49,1407600,3658003360196225,267,3001973,1720021,1721,1718300
10542,Valmir Sulejmani,45,3984600,3150074231694616,435,6512877,498496,4985,493511
10543,Stefano Surdanović,46,1898600,7305734784239142,281,3541143,3223131,3224,3219907
10544,Joaquín Susvielles,29,2669700,7285715852334791,280,3971079,1309974,13100,1296874
10545,Zak Swanson,33,4138200,5696968991075538,416,6619413,4576286,0,4576286
10546,Pierce Sweeney,69,1094400,7897566760214234,345,3227829,2150195,0,2150195
10547,Ryan Sweeney,69,4173100,7385223186178498,617,7459252,6721869,6722,6715147
10548,Dembo Sylla,70,4595300,5469336373766538,618,8638408,7905320,0,7905320
10549,Bartosz Szeliga,40,4462000,8053372396947163,448,7016862,2496249,249625,2246624
10550,Jesper Taaje,53,1881200,7281594342693517,361,4193365,1837755,1837755,0
10551,Nkosi Tafari,59,1226000,6000080798216792,331,3388104,1713970,1714,1712256
10552,Emanuel Taffertshofer,52,355000,3758542349424363,204,1485896,1452267,146,1452121
10553,Chemsdine Talbi,27,3874000,7567917903396248,352,5967142,3760401,377,3760024
10554,Kevin Tapoko,56,887800,6637322177938546,228,2202334,2184867,218487,1966380
10555,Niklas Tarnat,66,1402500,9637087623789238,356,3640967,1263407,0,1263407
10556,Borys Tashchy,35,3947600,9062247171862370,436,6414020,1671282,168,1671114
10557,David Justin Taylor,48,897300,5452285389447777,252,2344444,2198220,2198220,0
10558,Ash Taylor,66,3026200,7471530867880240,545,6863542,4842337,0,4842337
10559,Matty Taylor,25,2147000,6329785194410739,203,2971209,2478892,247890,2231002
10560,Junior Tchamadeu,63,3777000,8825724829089176,536,7128075,4097941,0,4097941
10561,Kay Tejan,47,853700,5292591864007821,224,2208924,1500767,1500767,0
10562,Carlos Terán,44,3657000,8269458387496543,446,6540190,5882804,58829,5823975
10563,Casper Terho,45,2407600,7815467970880207,288,3926200,3544887,0,3544887
10564,Peter Therkildsen,69,3064800,4131286804361887,486,6445255,2740972,275,2740697
10565,Jens Jakob Thomasen,64,1009900,8219559466630628,337,3040082,674107,0,674107
10566,Joachim Thomassen,53,3860300,5832678358612231,486,6973193,2036704,0,2036704
10567,Louis Thompson,44,2932800,6158184981518816,333,4689972,3606011,0,3606011
10568,Dominic Thompson,60,2245800,8569567029278911,391,4650445,1088058,108806,979252
10569,Curtis Thompson,22,1813200,3067013883096895,121,2320887,165760,0,165760
10570,Tommy Thompson,59,2851900,7116563286903079,478,6135578,6045699,6045699,0
10571,Ísak Þorvaldsson,44,1329500,5158487219776751,213,2563472,283177,2832,280345
10572,Tian Yinong,25,3832300,9382430340181736,329,5610986,4730555,4730555,0
10573,Samson Okikiola Tijani,33,4740700,7927022768383414,464,7559973,2719235,2719235,0
10574,Nathan Tjoe-A-On,45,4461500,6714604052230175,440,7226137,2075247,0,2075247
10575,Kristers Tobers,52,4423400,6718069399911386,564,7971845,3111955,312,3111643
10576,Umut Tohumcu,26,3448000,5698165955925363,284,5278239,4440117,0,4440117
10577,Pablo Tomeo,40,3124100,5852748351471617,321,4917788,84088,0,84088
10578,Dmytro Topalov,55,3398200,3587624061104340,429,6054447,880130,0,880130
10579,Emirhan Topçu,49,2466600,4691646030790079,373,4927103,4659937,0,4659937
10580,Juan Pablo Torres,24,3239300,3151218450408660,279,4774598,4131039,413104,3717935
10581,Tomas Totland,67,3831400,9365595270387433,622,7834377,455010,0,455010
10582,Saikou Touray,65,3127600,8928895443961423,477,6509294,184416,184416,0
10583,Ben Tozer,69,1144500,4763009994744395,408,3752674,3196434,320,3196114
10584,Adama Traoré,61,3730000,5507957628320206,522,7109273,3794604,380,3794224
10585,Gaoussou Traoré,22,3021300,6196007613658219,193,4048846,3724181,37242,3686939
10586,Miłosz Trojak,66,3435200,9307075839386992,584,7225235,6646026,6646026,0
10587,Jack Tucker,48,1109800,8180306772035642,209,2190475,1550166,155017,1395149
10588,Jesse Tugbenyo,24,4682300,5628479772602806,387,6742608,372167,37217,334950
10589,Cem Türkmen,39,2425000,7716176660418639,253,3632154,2570973,2571,2568402
10590,Ema Twumasi,55,1377700,8522976428382220,306,3022862,1160790,116079,1044711
10591,Stefanos Tzimas,38,4250800,5264915980698604,390,6233054,2132228,0,2132228
10592,Henrik Udahl,44,1307800,3823577249071877,219,2694184,2503118,251,2502867
10593,Adnan Uğur,29,4277900,8426116783906025,438,6283975,311846,0,311846
10594,Alper Uludağ,67,2848400,5880575130369053,468,5903147,1734528,0,1734528
10595,Luca Unbehaun,37,805300,7144624418348059,146,1546543,1279394,12794,1266600
10596,Iker Unzueta,31,4451300,3901713328723199,354,5980109,5871781,0,5871781
10597,Osaze Urhoghide,63,4105200,9652180645390409,604,7768886,2860096,2861,2857235
10598,Tomislav Uskok,48,1286400,5086911046301354,254,2843213,846355,846355,0
10599,Santeri Väänänen,45,1222300,3431490756441516,195,2264051,1044061,1045,1043016
10600,Pilip Vaitsiakhovich,60,986700,4998007888229489,284,2883589,2794999,280,2794719
10601,Pol Valentín,59,3042900,4382160462751290,442,5538779,2333307,0,2333307
10602,Benjamin Van Durmen,41,951400,7112733194163969,190,1947098,660986,6610,654376
10603,Yentl Van Genechten,27,2431700,5923623793925810,191,3241262,944853,94486,850367
10604,Terence Vancooten,45,3478300,9012977772977144,396,5823610,3598556,3598556,0
10605,Ádám Varga,40,1610600,9717645047174878,203,2755091,1351041,1351041,0
10606,Obed Vargas,42,2085600,6540811417087567,301,3813994,1483678,14837,1468841
10607,José Vargas,32,336500,4525841365640047,96,738011,619244,0,619244
10608,Iván Vásquez,38,4622200,5229731986943804,446,6886780,2707356,0,2707356
10609,Matías Vásquez,60,476400,5962996276690146,281,2285357,580710,5808,574902
10610,Theo Vassell,23,4186000,6452136094551619,292,5579908,4222595,0,4222595
10611,Kyle Vassell,24,4411400,9834035407103765,374,6803396,6373512,63736,6309776
10612,Gabriel Vașvari,41,439200,5949579888586333,153,1309556,156035,15604,140431
10613,Rocco Vata,43,3698800,4299403162864170,441,5947950,1904385,1905,1902480
10614,Harry Vaughan,60,601100,8601035197527244,265,2158574,1817281,18173,1799108
10615,Keziah Veendorp,52,4990500,4523211321612664,546,8369474,5690798,0,5690798
10616,Jhon Vélez,33,4198200,5109530129408854,434,6830279,5183271,519,5182752
10617,Michael Venturi,61,2996200,5849639629338551,481,5979429,5499220,0,5499220
10618,José Vera,46,2695600,6516929573494875,359,4723566,1804717,18048,1786669
10619,Matías Verdún,24,4086100,7370551046564764,340,5734839,24712,24712,0
10620,Kenneth Vermeer,40,1314500,9416031433703681,247,2882527,1218526,1218526,0
10621,Niklas Vesterlund,32,3598000,3671017662700596,335,5211885,4288470,428847,3859623
10622,Manuel Vicentini,50,4758200,3243273709224491,524,8031466,6891713,68918,6822795
10623,Martí Vilà,70,3286100,7416219075383191,581,6989174,464031,0,464031
10624,Ionuț Vînă,40,3837200,9739852167204809,452,6508809,1037501,10376,1027125
10625,Panagiotis Vlachodimos,22,2785000,7925329679693446,222,3905856,710933,0,710933
10626,René Vollath,62,2293700,8434839330484457,414,4707094,4631648,46317,4585331
10627,Patrick Vroegh,35,1331600,8011734405259647,181,2202412,993631,994,992637
10628,Ben Waine,69,4974900,3442260466581668,752,9969848,5830544,0,5830544
10629,Jamie Walker,51,775900,3881004354269657,241,2183220,1910511,0,1910511
10630,Michał Walski,42,4163500,9242808808937556,435,7027007,6278788,62788,6216000
10631,Nikolas Walstad,40,774100,6453927086122215,179,1740600,1006090,101,1005989
10632,Wang Ziming,64,4864900,5434857261266751,624,8587705,562065,0,562065
10633,Grant Ward,36,1196300,3347788928731586,156,1926635,1746924,17470,1729454
10634,Magnus Warming,44,2663600,7846967699541653,298,4126010,2845313,2846,2842467
10635,Lewis Warrington,24,4439200,9975536528197242,361,6645616,3910754,3910754,0
10636,Taylor Washington,69,739900,7436992553577571,386,3630077,125728,0,125728
10637,Marley Watkins,62,2308600,9241486388418473,440,5128668,1841791,184180,1657611
10638,Nicolás Watson,23,999600,9851911100499331,84,1185746,1037349,1037349,0
10639,Max Watters,30,1328700,3178316457396962,167,2168612,929599,0,929599
10640,Wei Zhen,43,1660400,7801319142565772,296,3515148,2520670,0,2520670
10641,Maximilian Welzmüller,38,3944600,5377128619537745,402,5780158,4331382,433139,3898243
10642,Sem Westerveld,27,3195600,7356461730981391,244,4512895,3204014,320402,2883612
10643,David Wheeler,38,751700,3084369365017196,130,1318125,559653,560,559093
10644,Jordan White,57,1562000,5425173126781454,308,3393832,2832935,2833,2830102
10645,Eirik Wichne,61,4606200,9979160454201016,550,8349820,2340707,0,2340707
10646,David Williams,48,3207100,8269039651726444,420,6112300,1265467,1266,1264201
10647,Randell Williams,52,3853900,9757210749500041,527,7102008,2983143,2983143,0
10648,Frederik Winther,30,2993200,9797752110084745,297,4521844,4133604,41337,4092267
10649,Szymon Włodarczyk,34,1129900,8044265218155561,149,1670439,228211,2283,225928
10650,Owen Wolff,54,2779500,5543046438852780,363,4688223,4166445,4167,4162278
10651,Krzysztof Wołkowicz,51,694800,4707595066841406,224,1964205,1923051,193,1922858
10652,Jojo Wollacott,24,4139900,6685355263018500,378,5854124,1628080,1629,1626451
10653,Andrew Wooten,53,3235400,3727236847516558,414,5620057,5026558,0,5026558
10654,Scott Wootton,67,4133600,8958455797467841,621,8218477,7483565,0,7483565
10655,Marius Wörl,35,2085100,7866670381857139,232,3266776,988603,98861,889742
10656,David Worrall,48,3504700,3900585197331818,405,5490357,2038995,0,2038995
10657,Drey Wright,36,3523200,8385654744881004,419,6551375,5441063,0,5441063
10658,Jannes Wulff,41,1177400,4257263731107603,225,2565027,720420,721,719699
10659,Vasilios Xenopoulos,50,4749300,7209358929042315,594,7806414,3961118,3962,3957156
10660,Ayman Yahya,41,925700,6939238121279887,175,1814589,263628,2637,260991
10661,Yang Shuai,68,3934100,7386229439381271,647,8072572,3792258,37923,3754335
10662,Joshua Yaro,67,4365000,5578970693033869,636,8129733,5356372,0,5356372
10663,Patrick Yazbek,63,4729200,3591600002711797,602,8454139,7837712,783772,7053940
10664,Uğurcan Yazğılı,63,4013100,5450494259545218,539,7418378,2867059,2868,2864191
10665,Muammer Yıldırım,27,609600,7560206757154072,86,823196,573381,574,572807
10666,İbrahim Yılmaz,40,3327600,8495070244109864,439,6115016,1076563,0,1076563
10667,Saku Ylätupa,26,4163800,3519132118181366,395,6630254,1544509,15446,1529063
10668,Wilitty Younoussa,28,3205000,3645800522846975,270,4336975,2251362,0,2251362
10669,Yu Hanchao,43,3288500,4745479157857498,383,5325976,634860,0,634860
10670,Míchel Zabaco,69,656100,9693403754032457,326,2578079,1565407,156541,1408866
10671,Cristian Zabala,68,4381100,3063339650662189,546,7492934,2476694,247670,2229024
10672,Danijel Zagorac,46,2881700,9317576980850806,383,5455927,2797841,0,2797841
10673,Oliver Zandén,32,3824300,3785128299976355,374,5926257,2730833,273084,2457749
10674,Eroll Zejnullahu,51,2878100,3707646504266925,388,4926979,4571768,458,4571310
10675,Rafik Zekhnini,50,2057500,3308995848526046,347,3912724,2133224,2134,2131090
10676,Héctor Zeta,46,1400800,5549507879265242,252,2869639,347811,347811,0
10677,Zhao Honglue,68,3174200,7432344331030331,520,6843709,6542127,6542127,0
10678,Robin Ziegele,43,4756800,9588266256423674,527,7507771,2980113,298012,2682101
10679,Paweł Zieliński,25,3574600,7154829066273666,295,4763306,4602355,4603,4597752
10680,Carlos Mateo Abastoflor,43,1239500,6899909395949037,219,2316531,2214606,221461,1993145
10681,Ahmed Abdu,39,3865700,4843986676674002,394,5956537,1058550,1058550,0
10682,Olivier Aertssen,62,4101700,3701830941503134,564,7792482,6908534,0,6908534
10683,Lucas Agazzi,65,1824900,7664572197891680,390,4615221,4140780,415,4140365
10684,Gassan Ahadme,66,2624600,4595070258022295,526,6439580,858370,85837,772533
10685,Ahn Tae Hyun,36,3757500,3460842219044514,376,5446605,101635,102,101533
10686,Hosam Aiesh,31,4367200,8432122532621721,414,6779050,6138609,6139,6132470
10687,Will Aimson,70,2422400,4214764814386992,447,5158852,1858844,0,1858844
10688,İbrahim Akdağ,46,692200,6448868407118103,191,1787259,1092269,10923,1081346
10689,Cyrill Akono,48,1812800,9276651872866356,292,3404619,2149223,0,2149223
10690,Michael Akoto,26,1554300,9689306892800832,165,2252479,2112735,0,2112735
10691,Talal Al Absi,61,432100,4128402103948713,262,2143679,1193490,1194,1192296
10692,Ali Al Asmari,48,3345200,7706409060621404,460,6435188,1146345,115,1146230
10693,Abdullah Al Fahad,36,2634900,3274937638794970,274,3856870,1883299,0,1883299
10694,Mohammed Al Fehaid,41,351500,6613690452724120,140,1083280,957589,0,957589
10695,Abdullah Al Hafith,41,2365100,3088413486949133,283,4090769,2779265,2779265,0
10696,Abdullah Al Khatib,42,4181400,4144790322058063,456,6725099,1902088,190209,1711879
10697,Nouh Al Mousa,40,4482200,4905792237551494,421,7013492,6962751,0,6962751
10698,Rayan Al Mousa,25,3618200,8310992760991601,316,5432062,2845993,0,2845993
10699,Ziyad Al Sahafi,65,4436500,8308428663397544,619,8229797,403191,40320,362871
10700,Hamad Al Yami,51,2815700,7619592096094977,364,4797913,3553291,355330,3197961
10701,Ibrahim Al Zubaidi,28,3273300,9098271937931157,280,4415721,2912659,2913,2909746
10702,Pascu,40,3312300,6614082494210082,394,5726117,23263,0,23263
10703,Néstor Albiach,57,2904900,9854662252780510,392,5256882,4754340,47544,4706796
10704,Dani Albiar,68,2665400,6218818212000107,498,5777644,4683005,468301,4214704
10705,Joel Allansson,33,4317900,7786260453236875,423,6095194,3816588,3817,3812771
10706,Pedro Justiniano,34,4035700,8771924618095975,394,6012918,4554690,45547,4509143
10707,Agustin Alonso,37,2758000,3703108292841153,324,4557008,3373793,337380,3036413
10708,Gonzalo Álvarez,22,3442800,8434847381727351,278,4638180,4079824,407983,3671841
10709,Frederik Alves,47,3602400,4452820700759311,411,5949107,3744258,375,3743883
10710,Gonzalo Álvez,35,4486200,8697044588229494,412,6650474,2413103,0,2413103
10711,Salomon Patrick Amougou Nkoa,33,1895300,9106561626407706,221,2863087,2538119,2538119,0
10712,An Byong Jun,54,2030700,6011564643066741,345,4257063,602008,602008,0
10713,Tom Anderson,42,4899300,7317502792619386,557,7976420,6533396,653340,5880056
10714,Jökull Andrésson,63,2077300,9538678719042438,412,4767151,868642,8687,859955
10715,Agustín Anello,58,878900,5491547248775835,295,2732866,2659983,2660,2657323
10716,Nick Ansell,39,4053200,5914658972252849,375,6263518,1744855,175,1744680
10717,Marvel,32,4896200,7686674235844634,451,7263463,2741228,0,2741228
10718,João Silva,54,1495600,7674472180257736,341,3926956,2019597,2019597,0
10719,Daniel Anyembe,28,1032100,6640353111517738,140,1530022,1499696,14997,1484699
10720,Cristhian Árabe,32,4992200,9538137622566774,425,6880574,1304415,131,1304284
10721,Alex Arancibia,23,2695600,4002491396249753,178,3226541,1360242,137,1360105
10722,Paul Arano,65,3333300,3612390891639420,502,6727271,2168617,0,2168617
10723,Allan Arigoni,42,3557100,3046837533796844,365,5372875,3276985,328,3276657
10724,Fernando Arismendi,37,1016000,3642724766772297,155,1712744,1115566,11156,1104410
10725,Remo Arnold,54,4351100,4965893645317645,524,7967807,852949,8530,844419
10726,Ricard Artero,50,982900,7225395332502868,268,2596873,467302,46731,420571
10727,Harrison Ashby,58,3538200,3357747265623625,501,6917045,837569,0,837569
10728,Lee Ashcroft,44,3668200,5174389997192292,411,5790580,4008886,0,4008886
10729,Ahmed Asiri,53,3254800,4088114804921542,446,5857685,3584468,35845,3548623
10730,Jaider Asprilla,36,3992700,5728067668060299,392,6076674,5298756,529876,4768880
10731,Samuel Asprilla,70,3985500,3100742193275054,610,8559214,6011670,6012,6005658
10732,Lynnt Audoor,51,766400,9419593065312210,231,2248167,1395008,13951,1381057
10733,Ayesa,25,2972200,5319849021310511,259,4300776,4130191,0,4130191
10734,Yavuz Aygün,40,597200,4999271433460140,140,1285425,369683,369683,0
10735,Anders Bærtelsen,32,2027400,7640616678787832,233,3162761,1649316,0,1649316
10736,Dylan Bahamboula,28,3663500,6953617841989239,355,5295138,790903,0,790903
10737,Florian Bähr,24,2609600,5629072617331454,225,3372408,2916090,292,2915798
10738,Yohan Baï,65,3174300,8767157035251201,471,6382552,2265926,0,2265926
10739,Brandon Baiye,58,4624800,7745667538591545,553,7986165,6018189,0,6018189
10740,Amadou Bakayoko,54,3735200,9974458332600970,512,7018410,891385,891385,0
10741,Courtney Baker-Richardson,44,2632600,6010534934910610,313,4371894,2290697,2290697,0
10742,Alaa Bakir,49,1547300,7537841401735978,301,3169205,1771487,177149,1594338
10743,Nordin Bakker,41,1756100,8506150394930372,243,3284094,2101509,21016,2080493
10744,Maximilien Balard,35,3022000,9042949200999808,345,4840889,279315,0,279315
10745,Álex Balboa,50,711900,6389992719188480,248,2202204,1717130,172,1716958
10746,Ibrahima Baldé,63,586200,9462762036279263,275,2368485,225741,22575,203166
10747,Agustín Baldi,58,3405900,8112113787523006,492,6551820,2658494,0,2658494
10748,Michael Baldisimo,64,3989100,4094922165334018,570,7253823,4404380,44044,4360336
10749,Andri Fannar Baldursson,39,345000,8677718482207245,124,903346,699716,69972,629744
10750,Jack Baldwin,68,2773000,9722984199127093,478,6202687,4457910,446,4457464
10751,Cristian Bălgrădean,40,3980400,7561426155858513,425,5995496,1925970,1926,1924044
10752,Arnaud Balijon,25,1608400,5770191180008747,138,2190099,1378582,13786,1364796
10753,Saad Balobaid,53,2602500,9252706269458154,346,4616235,1214126,12142,1201984
10754,Botond Balogh,63,1734300,5136294791218065,424,4296060,1458733,14588,1444145
10755,Ahmed Bani,52,3183600,8899117329319397,374,5064827,4703350,4703350,0
10756,Scott Banks,43,3602500,4102846529376007,389,5790279,2225438,2225438,0
10757,Théo Barbet,43,796100,4484002123978809,208,2043700,848754,8488,840266
10758,Gabriel Barès,45,3882700,5948242423614907,446,6682073,4882935,4882935,0
10759,Daniel Barrea,34,1354500,9988474052301257,164,2086820,700197,701,699496
10760,Ethan Bartlow,38,2939700,8911684975013208,348,4964971,2909323,0,2909323
10761,Mateusz Bartolewski,26,3533800,8378576471864447,296,4825975,2177179,0,2177179
10762,Rodrigo Bassani,38,3885700,6236325781293795,420,6582985,1640107,0,1640107
10763,Maxime Bastian,36,4615800,7145755094905403,460,7414671,715324,0,715324
10764,Oliver Batista Meier,40,2883300,4856420424048592,355,5308090,17308,17308,0
10765,Tom Baumgart,24,4706300,5388654965587863,382,7132899,494888,0,494888
10766,James Beadle,36,3858700,8879273563092686,441,6734852,2506493,2507,2503986
10767,Tom Beadling,38,2608000,9305636850542879,279,3957029,890877,8909,881968
10768,Dominik Becker,29,859000,4158344908480073,141,1524123,991962,0,991962
10769,Jacob Bedeau,50,3667200,3356529796344434,451,6342385,1836513,18366,1818147
10770,Rafik Belghali,38,1687400,8334894227822720,193,2726271,575927,0,575927
10771,Sam Bell,64,1512400,9653784080431633,412,4466885,504809,0,504809
10772,Jon Bell,46,4509300,6878027682424980,533,7377923,6817770,0,6817770
10773,Jobe Bellingham,55,912700,6892499848093651,278,2530403,731211,73122,658089
10774,James Belshaw,33,3648400,9123213016904557,333,5009158,2721734,2722,2719012
10775,Joe Bendik,66,2748600,8985426285358328,483,6072954,3088060,30881,3057179
10776,Pierre Neurath Bengtsson,65,2158100,9555719130577098,390,4925339,4563620,0,4563620
10777,Mimeirhel Benita,46,2508700,3890337086749164,367,4719576,3988195,0,3988195
10778,Marcos Benítez,61,441100,7472686391314719,272,2189267,2185538,0,2185538
10779,Hugo Benítez,61,2980300,5681812400673141,485,5882497,1801406,1801406,0
10780,Elliott Bennett,46,521000,5803716337138135,168,1422823,170790,0,170790
10781,Keanan Bennetts,45,2021700,8006736181409844,297,3709358,2433827,243383,2190444
10782,Jacob Bergström,68,3603000,9248796553761275,589,7561871,5899429,589943,5309486
10783,Sebastian Berhalter,41,1909300,3105837498211407,257,3124986,3027839,302784,2725055
10784,Álex Bernal,38,1821100,5794263494205547,245,3088881,2650292,26503,2623789
10785,Paul-Philipp Besong,64,1252900,4924344997547890,405,3727071,298022,2981,295041
10786,Octavio Bianchi,43,3368100,5071770271082207,408,5650267,1170328,118,1170210
10787,Ionuț Biceanu,35,3067200,6929904616778301,327,4648111,2097631,2097631,0
10788,Yohan Bilingi,48,3316900,4130294438420996,379,5733741,2520983,0,2520983
10789,Ted Bishop,23,4436800,9623238360165038,327,5773140,2850611,286,2850325
10790,Aron Bjarnason,37,3268100,9914821630338970,347,5219257,4143845,4143845,0
10791,Dawid Błanik,32,2991000,3069260490792585,287,4455109,1361219,136122,1225097
10792,Álex Blesa,36,4049400,9276685125757271,398,6293432,2295430,22955,2272475
10793,Jón Daði Böðvarsson,37,4209500,9410618151793370,379,5863008,4353637,0,4353637
10794,Mirko Boland,23,951500,7232102199859156,73,1039332,920760,9208,911552
10795,Charles Boli,43,1271300,9503108685284054,253,2760126,1346340,0,1346340
10796,Andor Bolyki,56,3503100,4788393465074126,480,6773396,5811049,582,5810467
10797,Kévin Boma,68,4864200,9987759660966181,676,9521813,8306388,0,8306388
10798,Warren Bondo,39,1688100,5400533354400773,235,3074904,2516004,252,2515752
10799,Callum Booth,28,4481300,9053072664953828,357,6401697,94555,946,93609
10800,Dennis Borkowski,62,1634400,5418258561702568,384,4289401,273373,274,273099
10801,John Bostock,29,2153400,5378742624400571,219,3130540,237230,238,236992
10802,Yassine Bouchama,41,4085300,5952358547750110,446,6366153,2592386,2592386,0
10803,Teddy Boulhendi,43,3132600,4590601372111218,386,5776262,1066197,106620,959577
10804,Elyas Bouzaiene,45,2193700,4256887084103845,320,4050733,3625667,3625667,0
10805,Dean Bouzanis,41,2724900,5296112242950616,339,5075082,3416008,0,3416008
10806,Steven Bradley,56,4336000,4378623682119287,530,7589947,6354353,63544,6290809
10807,Sandrino Braun-Schumacher,61,4876100,5976493832616768,606,8253330,3116387,31164,3085223
10808,Jonatan Braut-Brunes,51,778700,3202251783164386,222,1938112,1006994,100700,906294
10809,Maximilian Breunig,57,4993600,4041811505191289,621,8736301,3668560,0,3668560
10810,Manuel Brondo,25,1677900,4581790303963962,159,2216093,1386150,138615,1247535
10811,Arvid Brorsson,39,4050400,3430338126532367,440,6555386,6000353,0,6000353
10812,Jaden Brown,32,4809500,5448512296655404,407,6979544,2459230,0,2459230
10813,James Brown,68,2393200,9568637344656061,439,4974607,1821730,1821730,0
10814,Archie Brown,38,940900,6658981381156082,165,1727513,1445083,144509,1300574
10815,Leigh Broxham,35,2466000,8432623300185635,243,3453135,2955248,29553,2925695
10816,Lucas Brumme,53,820300,7527345506626006,211,1958234,1022371,102238,920133
10817,Kai Brünker,44,4265700,7626962912972200,476,6974228,4394405,43945,4350460
10818,Kevin Bukusu,63,1139200,3191092766359430,362,3527282,2491870,2492,2489378
10819,Filip Bundgaard,70,4633600,5182344141337744,710,8770217,831808,0,831808
10820,Jasmin Burić,38,2020700,7389763906151426,280,3488796,1121197,1122,1120075
10821,Nishan Burkart,70,1308800,9692362973994193,389,3886154,299268,300,298968
10822,Mauro Burruchaga,39,2705400,5086633140047551,322,4458225,3214162,322,3213840
10823,Callum Burton,35,4291600,5603917487235349,449,7099314,2902591,0,2902591
10824,Sergiu Buș,63,2523900,9758064381833519,399,4767841,1664702,1664702,0
10825,Evan Bush,24,4597500,5469030489967183,424,7153937,1138653,0,1138653
10826,Justin Butler,22,2702500,5064987176829264,220,3489844,2786759,0,2786759
10827,Oskar Buur,32,3429800,4152645523265389,331,4972648,1255419,1255419,0
10828,Jorge Cabezas,58,2384100,7354202974132656,393,4909988,374977,37498,337479
10829,Kévin Cabral,67,3335000,9050456815778473,527,6858463,3640472,364048,3276424
10830,Mauricio Cabral,28,3259200,5679447856282130,278,4480782,3666738,3666738,0
10831,Abraham Cabrera,42,1274400,8137156620731959,241,2747836,1822882,183,1822699
10832,Walter Cabrera,37,3485200,6280863763939252,367,5758741,4760401,4760401,0
10833,Andrea Cagnano,45,3267700,7407269220910846,392,5536516,3565510,3566,3561944
10834,Alex Cairns,28,3212500,7765923172165444,244,3957803,2949150,2950,2946200
10835,Scott Caldwell,70,3400600,7468145531170083,579,7154689,3347901,3348,3344553
10836,André Calisir,31,2311500,3700430299741297,234,3476069,1201686,1201686,0
10837,Aaron Calver,28,4250600,4854964100052838,390,6295096,713349,0,713349
10838,Etienne Camara,29,4114000,7797537798636421,378,6526608,5412835,541284,4871551
10839,Sekou Camara,69,1081100,3489909341129332,325,2891887,510014,5101,504913
10840,Thibault Campanini,30,1029400,9770998271586770,133,1567080,625887,6259,619628
10841,Samuele Campo,39,4792700,9190256964995088,541,8557091,4040305,0,4040305
10842,Simone Canestrelli,63,3336700,5080400930176603,474,6006826,3898562,3899,3894663
10843,Alexis Cantero,50,2180500,8363453870952917,350,4069401,2921110,292111,2628999
10844,Jake Caprice,41,2572900,5464327293911864,328,4501691,3847099,3848,3843251
10845,Sonny Carey,56,3229200,5114673936414375,410,6241302,6014661,0,6014661
10846,Baily Cargill,40,1025200,6961513758153774,174,1831201,536889,0,536889
10847,Wikelman Carmona,63,4076900,7932450817452683,639,8276047,8220334,0,8220334
10848,Jony Álamo,65,2494000,3629919501325111,469,5058988,3652307,0,3652307
10849,Nicolae Carnat,28,570000,4388707934240772,90,906151,22097,0,22097
10850,Martim Tavares,45,3205200,6294758881248548,400,5457353,536286,536286,0
10851,Pau Casadesús,51,2944900,3603739262729132,368,5149443,852915,853,852062
10852,Dan Casey,23,358200,3318591490257564,36,248098,133126,134,132992
10853,Henrik Castegren,43,2128900,9924551001463763,293,3809535,3567844,3567844,0
10854,Denil Castillo,49,3569700,3703923960020605,480,6446351,3775064,378,3774686
10855,Dumitru Celeadnic,70,932900,4421833319427900,412,3873288,2651960,26520,2625440
10856,Jurgen Çelhaka,42,2007800,5177942997444085,275,3503073,2370621,0,2370621
10857,Michele Cerofolini,32,696700,7212310664636903,121,1131302,601558,6016,595542
10858,Nassim Chadli,29,4401400,4907415801228200,362,6530630,2713836,2714,2711122
10859,Alfie Chang,53,3390000,8663900491708100,466,5878315,850428,850428,0
10860,Connor Chapman,39,4002400,7453010851715571,391,6513629,1558633,15587,1543046
10861,Shea Charles,68,3835400,5680955830246251,604,7226548,3120476,0,3120476
10862,Gabriel Charpentier,39,1121800,8335968689294656,211,2237200,1286677,1286677,0
10863,Paterson Chato,51,2451100,4335660649847739,328,4528639,718910,719,718191
10864,Lucas Chávez,23,1580000,8589937971671660,142,2313872,157925,15793,142132
10865,Chen Pu,50,1575900,4227582413101318,290,3302936,797847,798,797049
10866,Ben Chrisene,22,3518000,8628116075104337,334,5043554,1347807,1348,1346459
10867,Sander Christiansen,59,4767000,7582117018194517,551,8189091,2169615,2169615,0
10868,Sébastien Cibois,48,4614300,3683110748623567,478,6837878,4739772,47398,4692374
10869,Andrejs Cigaņiks,28,1196300,9872388493149475,141,1820403,1808065,1809,1806256
10870,Tim Civeja,63,2868700,8148831651002752,451,5815654,3758140,37582,3720558
10871,Max Clark,44,3898000,8395897131662795,412,6052487,3342686,3342686,0
10872,Trevor Clarke,29,2847700,6485956193398613,251,3962274,3912231,392,3911839
10873,Dan Cleary,51,1327200,3820055673632336,254,2829984,134418,13442,120976
10874,Gabriel Cléùr,63,3287400,4254141234195206,484,6141544,5664893,0,5664893
10875,Ben Close,54,4722000,9537149574736093,542,8087967,7315455,731546,6583909
10876,Zach Clough,38,2096700,5482301160856280,274,3396414,1825155,1826,1823329
10877,Grégory Coelho,48,3175800,9019612668217603,393,4988730,2954326,295433,2658893
10878,Nnamdi Collins,22,552800,4537547741086121,35,417961,293537,0,293537
10879,Gastón Comas,38,1825500,7658385807527767,242,3142637,2004915,200492,1804423
10880,Tom Conlon,22,2658900,9120266910972793,228,3991160,3300054,3300054,0
10881,Mark Connolly,62,4780700,5704047467602558,654,9768918,1061714,107,1061607
10882,Anderson Contreras,56,4225900,3706132399156848,531,7398949,1249796,12498,1237298
10883,Simón Contreras,50,3160600,9905675274013336,420,5576081,1875547,0,1875547
10884,Ryan Cooney,55,1142900,8898994713093596,338,3402648,2956405,2956405,0
10885,Brandon Cooper,28,1940000,4991403619546317,193,2910022,1611307,16114,1595193
10886,Leo Cordeiro,61,444400,4290283481198686,267,2248911,801724,8018,793706
10887,Sam Cosgrove,70,4728800,8609736602444475,638,8885569,8220209,8221,8211988
10888,Woyo Coulibaly,56,4156200,9912158381725203,543,7528490,5327643,5327643,0
10889,Jordan Courtney-Perkins,27,3410800,3020151862057258,301,4696864,4190629,0,4190629
10890,Matthew Cox,66,4576100,7321809681445671,631,8685023,6147731,615,6147116
10891,Liam Coyle,64,2845500,3166379022240668,510,6224819,259045,0,259045
10892,Romoney Crichlow,57,3009200,9527933124923120,451,5644857,134763,13477,121286
10893,Ryan Croasdale,55,564600,6489991608957652,260,2182173,89535,89535,0
10894,Max Crocombe,38,3850800,3362650449732477,414,6451955,3172563,317257,2855306
10895,Ivan Ćubelić,26,2403700,6800252489858389,211,3432102,1132827,113283,1019544
10896,Cubero,42,561500,3387044900404536,178,1607833,352900,352900,0
10897,Ronald Cuéllar,27,3659800,8264490566066070,353,6063160,1072053,1072053,0
10898,Pablo Cuñat,56,2881200,7089782218223882,419,5404774,912767,912767,0
10899,Pastor,69,1930600,6545044488480212,468,5340610,926712,0,926712
10900,Szymon Czyż,44,2757900,9500931496661118,370,4881925,3628085,363,3627722
10901,Berkay Dabanlı,42,2679600,3492865967664645,335,4345279,346592,0,346592
10902,Erdon Daci,66,888700,3675981301990950,302,2995138,2774019,2775,2771244
10903,Ataberk Dadakdeniz,61,3122300,4740957272336476,465,5785669,5667709,5668,5662041
10904,Robert Dadok,56,4364500,8134671919599687,574,7782190,633085,633085,0
10905,Leon Dajaku,42,3209200,6925088159195148,358,5355912,3437429,344,3437085
10906,Kamil Dankowski,32,2912900,5840362689462427,271,4487004,3031847,303185,2728662
10907,Riku Danzaki,68,712900,9925890413650103,382,3428972,1640477,164048,1476429
10908,Tom Davies,31,3370400,4827519140092575,322,4975387,326653,3267,323386
10909,Jordan Davies,40,4481300,6237054106474215,483,6909378,1191125,1192,1189933
10910,Isaak Davies,35,4899200,8491190568247095,420,6802297,3120465,3121,3117344
10911,Josh Davison,60,1190600,7474058786591013,327,3357236,2661517,0,2661517
10912,Yann-Erik de Lanlay,52,3750800,8014137209697685,500,6312113,2300871,23009,2277862
10913,Marvin De Lima,26,3006900,9366242545543255,278,4288432,817966,0,817966
10914,Dion De Neve,65,949900,8704746012764383,320,3044497,1656881,1657,1655224
10915,Jeriel De Santis,70,1433400,3992360606897295,424,4313767,2631846,2631846,0
10916,Luís Phelipe,32,959500,6230824440071287,116,1363723,385378,386,384992
10917,Dario Del Fabro,61,3989900,9495896223391628,550,7108332,3122302,312231,2810071
10918,Maxime Delanghe,50,1211400,5345004490368250,220,2424467,1136621,114,1136507
10919,Patrickson Delgado,67,564000,5404283823921089,325,2675909,2360989,237,2360752
10920,Vesel Demaku,63,599500,9385804694903073,273,2442923,567279,0,567279
10921,Mickey Demetriou,69,4796600,7302093284707147,610,8767112,6947259,69473,6877786
10922,Anthony Descotte,25,4076500,9034321124482328,361,5841614,2236488,0,2236488
10923,Dawson Devoy,57,2122000,4357522762048360,395,4624253,477486,0,477486
10924,Cheick Diabaté,66,750200,9499388713560766,339,2741466,1119582,112,1119470
10925,Souleymane Diaby,69,1612000,6067494391418367,373,4152922,1438009,14381,1423628
10926,Ibrahim Diakité,25,2553800,8729991830910681,191,3397072,2929508,293,2929215
10927,Mamady Diambou,62,4497500,7060452371905460,627,8966498,3783529,3783529,0
10928,Kandet Diawara,57,2500300,7382127951894311,397,4820274,1178000,11780,1166220
10929,Agyemang Diawusie,50,2152600,7212467381206930,327,4012264,3289738,328974,2960764
10930,Leonardo Díaz,37,372100,5210481430284290,124,979159,1240,1240,0
10931,Adama Diomande,25,3778900,4157325939079578,310,5115800,689769,0,689769
10932,Lewis Dobbin,54,1939600,7727339672559599,335,3894105,2045983,204599,1841384
10933,Christian Doidge,22,1317500,8521424555543913,82,1395114,1081279,10813,1070466
10934,James Donachie,24,2186000,8383646107431781,204,3263594,383538,384,383154
10935,Renato Júnior,26,4138300,4389814967964323,350,5944415,742880,7429,735451
10936,Seniko Doua,36,2197300,8231444689470181,271,3814634,1653763,165377,1488386
10937,Kevin Doukoure,51,649500,3468333688266252,202,1943363,239542,2396,237146
10938,Andrei Dragu,42,810700,4448691410994702,202,1789755,1393592,1393592,0
10939,Issiar Dramé,45,589000,9215735122219312,180,1622177,1439838,143984,1295854
10940,Diego Duarte,52,1797300,7376853861073433,349,3841083,1666057,0,1666057
10941,Răzvan Ducan,60,4220700,4596303995283915,528,7369581,5593019,559302,5033717
10942,Demeaco Duhaney,29,1932700,7043964874484697,192,2868347,465975,465975,0
10943,Lucian Dumitriu,28,3924400,4532950475526250,389,6106222,5266632,0,5266632
10944,Nikola Đurđić,60,2869100,3081359652393473,419,5798071,5374358,0,5374358
10945,Luca Dürholtz,29,1360400,6404756598091037,157,2035426,1029703,1029703,0
10946,Abdurrahim Dursun,69,4491300,5550150410875675,608,8972614,7247684,0,7247684
10947,Saxon Earley,48,2960600,7788391832910816,411,5479684,1530580,154,1530426
10948,Daniel Edelman,41,4099400,7859262877946912,501,7146860,366408,0,366408
10949,Brahian Egüez,58,4855700,9621145734577429,528,7995501,982272,0,982272
10950,Fabian Ehmann,23,3526900,4824700014798421,311,5046784,922927,0,922927
10951,Marco Ehmann,41,2186800,9164594929077496,280,3780558,2945767,0,2945767
10952,Noah Eile,29,4139200,6256179150140402,329,6155624,1627604,1627604,0
10953,Kai Eisele,33,903900,3962848940058204,161,1691947,714333,714333,0
10954,Ibrahim El Kadiri,43,3711000,3722028794337787,427,6181161,3376410,3376410,0
10955,Fahd El Khoumisti,56,340300,7667962807570013,253,2065680,549523,550,548973
10956,Rodney Elongo-Yombo,30,4932100,4599341367401982,458,7807486,504419,0,504419
10957,Marius Elvius,53,4298900,7417032696701891,478,7191771,1709064,0,1709064
10958,Jonas Enkerud,56,1548400,3172432899979177,319,3663594,2115764,212,2115552
10959,Italo Espinoza,50,4092900,6435992788087685,525,7707656,7625881,0,7625881
10960,Bert Esselink,63,3723200,3308135093072307,526,7040553,3791198,37912,3753286
10961,Owen Evans,36,2565400,6008848677840609,281,3986740,268568,268568,0
10962,Antony Evans,52,3975100,6610012950930382,447,6674269,1949686,0,1949686
10963,TJ Eyoma,29,4351600,8237312609423989,385,6704991,701076,0,701076
10964,Kimberly Ezekwem,33,3591900,7136821352294677,342,5362083,3547045,354705,3192340
10965,Jonah Fabisch,67,3595800,5770601220129664,547,7102232,7055181,705519,6349662
10966,Lukas Fadinger,45,1252300,6874528412474173,275,2839315,2199641,220,2199421
10967,Ricardo Farro,26,2433300,7335397169320210,200,3240956,860685,0,860685
10968,Manuel Farrona Pulido,38,1434200,4550480113965843,174,2161344,1628852,1629,1627223
10969,Jesús Fernández,36,1405400,8783489480761632,180,2357380,432535,433,432102
10970,Joaquín Ferreira,37,3072200,7105220518213739,337,5271513,4936294,0,4936294
10971,Will Ferry,46,4658900,9531274747660480,554,7787835,6823655,0,6823655
10972,Tobias Fleckstein,30,2223800,9473258792513727,202,3217380,3171601,0,3171601
10973,Junior Flemmings,34,3475900,3797761142908952,361,5133795,4508312,4509,4503803
10974,Josh Flint,30,2306200,8790179317042077,225,3308240,1197565,0,1197565
10975,Francisco Flores,44,4916300,6160637995987144,502,8003686,7470508,7471,7463037
10976,Issa Fomba,69,1094200,7620790394846164,408,3797392,1811998,1811998,0
10977,Konrad Forenc,37,2780000,9275594621064548,321,4842020,2530121,2530121,0
10978,Jake Forster-Caskey,56,2925400,4767185767988771,419,5381419,3319553,33196,3286357
10979,Tomasz Foszmańczyk,61,562300,3111724829190711,252,2070105,1938569,194,1938375
10980,Ben Fox,66,848200,5633353243924603,364,3386519,1575688,1575688,0
10981,Kobe Franklin,37,948300,3783075937404029,175,1991540,649608,64961,584647
10982,Ludvig Fritzson,23,4070900,9811515476249936,329,5266009,2665157,267,2664890
10983,François-Xavier Fumu Tamuzo,61,4714000,9804382871884120,599,8717580,8061422,80615,7980807
10984,Rory Gaffney,38,705700,7446417306544856,142,1394689,742228,0,742228
10985,Orrin McKinze Gaines,62,1282800,3826748464529005,339,3441489,1376366,1377,1374989
10986,Jeffrey Gal,47,1701000,3939446516029155,297,3535588,451847,451847,0
10987,David Gallardo,43,1512600,3164274036527599,248,2913264,2565919,0,2565919
10988,Scott Galloway,23,3879400,4558118617613327,269,5086993,3065541,3065541,0
10989,Tornike Gaprindashvili,52,659500,4292260183978703,227,2085427,270923,271,270652
10990,Alan García,45,1852600,6909216223259280,278,3424057,2408668,2408668,0
10991,Cristhian García,67,2133500,6149446519869806,434,4987472,2431007,0,2431007
10992,Nathan Garcia,47,744300,3197860823324114,207,1891241,1270038,1270038,0
10993,Anselmo Garcia MacNulty,44,765300,6843891398086594,170,1769695,1296883,129689,1167194
10994,Jake Garrett,33,2630600,6985426088131890,284,4054610,3309289,3310,3305979
10995,Oscar Garrido,53,514700,9616727729664360,224,1735563,247061,0,247061
10996,Angelo Gattermayer,66,4879600,4073155908361518,697,9984766,7984505,0,7984505
10997,Nicolai Geertsen,33,2106800,6950525683872203,212,3310638,43855,0,43855
10998,Alec Georgen,56,4348400,8822477513025607,529,7096644,2680091,0,2680091
10999,Thomas Geyer,34,3713800,4004920967050729,345,5697018,250210,250210,0
11000,Justo Giani,37,1636700,9698730517110846,260,3127442,1206376,1207,1205169
11001,Jordan Gibson,29,2941500,3142615091480424,298,4760019,4375026,43751,4331275
11002,Piotr Głowacki,39,2499400,9633527062128001,307,4339464,2841442,285,2841157
11003,Go Myeong Seok,39,3477200,3099428472380802,391,6274157,4982238,49823,4932415
11004,Marcus Godinho,44,1425800,9345968425542950,241,2942204,2056984,0,2056984
11005,Fernando Godoy,68,1889100,7878330919773055,463,5134012,1592422,160,1592262
11006,Gerrit Gohlke,32,2088300,7593353678291553,206,3188129,1062975,0,1062975
11007,Samuel Lobato,32,2109500,5934348474715672,250,3511723,3183753,31838,3151915
11008,Matías Gómez,41,4586200,9340476897262401,480,7504009,1012304,10124,1002180
11009,Emmanuel Gómez Riga,70,2715700,3018225225458550,515,6183013,81385,0,81385
11010,Ben Goodliffe,53,2185100,3446220920420983,340,4278062,1824729,1825,1822904
11011,Andrei Gorcea,27,4353400,7272737775234422,389,6294813,156106,157,155949
11012,Lewis Gordon,51,3903400,9728971054331246,454,6479691,2179824,0,2179824
11013,Luis Görlich,33,1996900,8414296278947846,205,3253005,2104118,210412,1893706
11014,Pius Grabher,67,1359800,6069751162613647,383,4005490,2125443,2126,2123317
11015,Lee Grace,52,2815300,4155836598322488,437,5792591,3425135,343,3424792
11016,Alex Greive,24,4152400,8377278812199861,385,5916291,247903,248,247655
11017,Ricardo Grigore,64,2525900,3211697637694802,521,6302645,5762452,0,5762452
11018,Joel Grodowski,52,4091000,9441773061551762,516,7177452,5154568,0,5154568
11019,Dennis Grote,52,1042000,8171447950516233,232,2461637,1440867,145,1440722
11020,Gustav Grubbe,28,4226600,5062762467413644,347,5627579,3831919,0,3831919
11021,Andri Lucas Guðjohnsen,33,3465900,9585522665334069,335,5508374,1811901,0,1811901
11022,Enzo Guerrero,66,3181500,7818301492141873,569,6905945,2827359,0,2827359
11023,David Guevara,43,4917300,6611154025016344,488,7855877,6863924,686393,6177531
11024,Serhat-Semih Güler,29,1093800,8716324977928867,150,1763855,621177,621177,0
11025,Viktor Gustafson,69,3878500,3128976371678451,542,7317167,5061078,5061078,0
11026,Bruno Gutiérrez,42,3471600,5341430528715155,381,5495060,941583,942,940641
11027,Frederik Gytkjær,63,1449300,3591015492454281,412,4157941,1269471,127,1269344
11028,Manuel Haas,61,2126400,5719314430056526,407,4710281,3592651,35927,3556724
11029,Reeco Hackett,66,4494000,9320874296939896,636,8492222,5500937,550094,4950843
11030,Denzel Hall,38,4811800,5184034885560310,499,7489640,5284065,5285,5278780
11031,Brian Hämäläinen,28,2847900,3288164657342941,259,4138445,3087931,3087931,0
11032,Han Ho Gang,49,2476800,8303800876222693,381,4660995,4381948,4382,4377566
11033,Han Jiaqi,42,3139300,6453168592415030,390,5766413,3690068,0,3690068
11034,Han Rongze,65,2705400,7799888781302669,442,5612454,491697,0,491697
11035,Han Pengfei,32,1015300,4139710705284684,129,1465248,956023,956023,0
11036,Brandon Hanlan,31,2684900,8181403996392488,258,4152116,533209,0,533209
11037,Riley Harbottle,62,4667700,4729109000725580,592,9067474,1707080,1707080,0
11038,Cedric Harenbrock,69,4243200,5978504328647341,594,8675598,2506200,2506200,0
11039,Vincent Harper,70,3998000,3562621939923297,601,8007016,7544332,7544332,0
11040,Shayon Harrison,41,728500,7178733286229614,172,1534420,685253,0,685253
11041,Thomas Hasal,22,343700,7117878380167393,31,188973,91408,91408,0
11042,Patrick Hasenhüttl,54,1449800,9790341444700481,336,3730115,1557593,156,1557437
11043,Maxime Hautbois,40,2064600,5105133861230760,244,3400269,2664666,0,2664666
11044,Ibe Hautekiet,41,2946500,9662461923227360,404,5002639,414110,4142,409968
11045,Josh Hawkes,47,2308200,5400022755135886,319,4265166,1261384,127,1261257
11046,He Guan,44,2662000,9315985992085292,328,4596938,933900,0,933900
11047,Jaheim Headley,70,2886900,9705943434568675,560,7056605,1383590,139,1383451
11048,Justin Heekeren,56,4933800,7525875683416056,679,9277083,7881438,0,7881438
11049,Ogechika Heil,28,3696000,8962899859728681,324,5557678,5550734,556,5550178
11050,Mark Helm,68,4234900,6435552491054763,533,7224077,4366188,0,4366188
11051,Regan Hendry,41,2478600,9477483096822364,307,4277443,4083506,4083506,0
11052,Callum Hendry,52,4713900,7994593509289574,510,7397095,7064664,707,7063957
11053,James Henry,34,3593000,7581792389591109,366,5685249,4764616,4765,4759851
11054,Felipe Hernandez,45,2148400,5664636305359683,312,4046550,131044,0,131044
11055,Carlos Hernández,64,504100,9279645329028339,313,2427853,49942,500,49442
11056,Kobe Hernández-Foster,45,3012600,5831541856097676,335,5063676,4123316,41234,4082082
11057,Michael Heule,38,337900,5805419008082174,97,684952,385010,0,385010
11058,Thomas Himeur,55,428900,8582269915189205,200,1545253,878227,878227,0
11059,Myles Hippolyte,54,605800,8370110014049729,225,1893784,1530967,0,1530967
11060,Václav Hladký,48,3350200,9329602395672990,430,5674460,2111656,0,2111656
11061,Seán Hoare,66,1558900,3480487321318186,387,4350677,2439647,24397,2415250
11062,Kasper Høgh,65,1306900,7770746361963839,409,4198369,2639568,26396,2613172
11063,Nathan Holland,57,2652200,3719049365144512,470,5586026,1581825,1581825,0
11064,Luca Hoole,48,1276400,5512550447789061,243,2622325,2165295,0,2165295
11065,Henry Hore,48,1371200,4136214470530416,276,3105592,1437164,1438,1435726
11066,Marc Hornschuh,60,665300,9155342941986235,328,2803154,2706521,0,2706521
11067,Berto Hórreo,62,4891000,4335206941446901,716,9637948,2948202,0,2948202
11068,Engjëll Hoti,48,1352800,3956209732565378,244,2628150,1043646,1044,1042602
11069,Lukáš Hroššo,42,1633100,4423660890050021,258,2950438,2892708,2893,2889815
11070,Cameron Humphreys,41,4010200,9878058046645832,441,6090915,4341491,0,4341491
11071,Rob Hunt,64,3650600,6057509246104894,528,7475313,1726672,0,1726672
11072,Muharem Huskovic,68,2540000,4879868199307028,483,5617259,3688669,368867,3319802
11073,Elias Huth,50,3511100,3524207454358971,407,5977914,2374084,23741,2350343
11074,Hwang Jae Won,68,1941100,8797105160074457,415,4742709,384591,0,384591
11075,Jefferson Ibáñez,66,4551000,7817254626660083,654,9081411,3376545,33766,3342779
11076,Franco Ibarra,27,4217100,9907444906674184,371,5849435,4184559,0,4184559
11077,Buhari Ibrahim,24,3083200,6430633639637278,247,3873621,2649360,2650,2646710
11078,Sunusi Ibrahim,25,554200,7528032447477553,47,540140,494332,494332,0
11079,Hiroshi Ibusuki,52,764500,9210565621507544,214,2055522,891457,89146,802311
11080,Florin Ilie,58,589400,9341710027154744,243,2039642,1219243,0,1219243
11081,Plamen Iliev,46,383300,8159264918105180,188,1550552,319000,319,318681
11082,Robert Ion,34,1294200,8618433843989842,176,2142401,1708900,170890,1538010
11083,Zidane Iqbal,61,638300,8759863989786623,291,2540644,106056,106056,0
11084,Elián Irala,64,1591500,9393575033324564,359,3870030,1170535,1170535,0
11085,John Iredale,30,2130600,5556353135606370,195,3011689,2514060,0,2514060
11086,Ryan Jackson,27,1365000,3893696487256060,145,2011527,1802563,181,1802382
11087,Aziel Jackson,43,550600,6167497043357433,208,1750137,289174,0,289174
11088,Eldin Jakupović,57,4960000,8239078653925180,602,8247900,2328494,2328494,0
11089,Konrad Jałocha,25,1856200,8944860931798883,172,2712889,2644043,2644043,0
11090,Luther James-Wildin,41,2661900,7930454210081183,361,4613115,206741,0,206741
11091,Nicolas Jann,45,3835800,9882067963443975,473,6380653,2814844,0,2814844
11092,Matt Jay,40,643100,9567026695287351,194,1666822,432082,0,432082
11093,Keegan Jelacic,37,2795900,8219750318794250,348,5101263,3954496,3955,3950541
11094,Jeong Hyun Cheol,70,1116700,5704435404003077,360,3256536,1532708,154,1532554
11095,Cameron Jerome,40,3518600,9311032918951251,370,5410873,3063184,30632,3032552
11096,Kyle John,68,2274500,6053613138968826,470,5101785,2835745,283575,2552170
11097,Bjørn Johnsen,36,1630400,3067355493416719,195,2580171,194254,1943,192311
11098,Callum Johnson,66,3601000,6211679662934698,523,6426209,2915767,291577,2624190
11099,Dan Jones,63,2252100,3593529442973861,391,4677034,3461856,0,3461856
11100,Ricky-Jade Jones,28,2404100,6967996554536952,263,3809382,2671054,267106,2403948
11101,Mateo Joseph,31,3389000,8065530334753671,337,5365397,532655,5327,527328
11102,Fernando Juárez,52,1527100,5686415597872082,347,3485043,2617526,2618,2614908
11103,Zak Jules,63,3337500,4405262031260495,521,6582954,5486608,0,5486608
11104,Sam Junqua,55,2979800,3098962617222211,395,4993095,3747970,0,3747970
11105,Yusuf Kabadayi,64,682300,7360085880092420,343,2772099,897594,0,897594
11106,Elton Kabangu,27,1184300,3856421538171755,139,1821212,800393,8004,792389
11107,Rayan Kadima,43,3100200,8719809231685587,401,5678131,19231,1924,17307
11108,Sullay Kaikai,36,786900,7216455812048007,141,1504346,1033529,0,1033529
11109,Sherif Kallaku,49,3697300,6241160427042555,504,6619398,3990057,39901,3950156
11110,Patrick Kammerbauer,36,1381200,5421963184539500,178,2157933,140285,0,140285
11111,Claudio Kammerknecht,47,1908300,9894758102037725,275,3460188,867936,868,867068
11112,Marin Karamarko,57,3389600,3144267973210747,452,6134891,5637378,56374,5581004
11113,Thomas Kastanaras,46,2962600,7578468500610958,392,5137480,4893671,4894,4888777
11114,Fatih Kaya,43,4946200,9674169258423288,514,7457368,3847572,3848,3843724
11115,Kader Keïta,52,4885000,4359394701796014,574,9173725,9001139,900114,8101025
11116,Georgie Kelly,26,2392800,3911855961453396,207,3481793,1448056,0,1448056
11117,Dan Kemp,25,1462500,8759043154684376,154,2166971,503788,5038,498750
11118,Nohan Kenneh,62,1516700,8717474380679010,303,3455153,2374484,238,2374246
11119,Otis Khan,53,4047100,6401374090530801,506,7286068,2359107,0,2359107
11120,Benji Kikanović,39,3647100,6322996215997001,391,5584357,5012884,502,5012382
11121,Alfie Kilgour,35,2610400,7625317512011025,286,3800672,3593725,3594,3590131
11122,Kim Yong Hwan,24,1490800,9306138395381183,101,1756535,808017,0,808017
11123,Kim Dong Heon,63,2361600,8570900970183456,445,5026526,4238778,424,4238354
11124,Kim In Kyun,41,1180500,4773420141913164,212,2320925,525998,52600,473398
11125,Kim Sung Joon,35,783000,7433282865250797,135,1412726,301986,30199,271787
11126,Joel King,64,3599700,3711335825601461,488,7117528,6407001,0,6407001
11127,John Kitolano,36,4318400,3779368567856035,399,6690496,4808756,48088,4760668
11128,Joe Kizzi,65,3850800,9005043163713977,617,8349555,7303570,7304,7296266
11129,Mihael Klepac,32,2952400,3892940307594938,344,4987422,1365656,137,1365519
11130,Bartłomiej Kłudka,28,4326900,4408665517735128,360,6149953,107128,1072,106056
11131,Marvin Knoll,65,2601000,7470518770713826,468,6039075,5576071,0,5576071
11132,Tobias Knost,22,3950700,6580837064695508,270,5095949,3875163,0,3875163
11133,Tom Knowles,31,2295200,7311201560019963,203,3118155,687260,0,687260
11134,Thomas Kok,29,4952100,4000309288884602,490,8393438,4280443,0,4280443
11135,Robin Kölle,41,4381200,6124178870116853,508,7494753,1705211,170522,1534689
11136,Cheick Oumar Konaté,42,4018600,3813722190200320,410,6274966,5033403,0,5033403
11137,Timo Königsmann,33,3027300,4022552597129511,304,4797088,1742413,0,1742413
11138,Koo Ja Ryong,62,3455900,7074660083503938,586,7657229,2487710,0,2487710
11139,Seid Korač,26,1667400,8030692897220381,171,2416682,2191401,219141,1972260
11140,Emil Kornvig,26,1722900,4309289896190535,146,2296672,1042578,0,1042578
11141,Tihomir Kostadinov,26,3461900,6259018738954189,285,5232656,1944474,195,1944279
11142,Pritam Kotal,58,3567600,7612800816202224,535,6280259,4436166,0,4436166
11143,Billy Koumetio,58,2284400,8286660919574912,396,4761495,697351,6974,690377
11144,Johnny Koutroumbis,29,1739500,7080544534107347,171,2413109,2337589,0,2337589
11145,Mateusz Kowalczyk,69,3931000,8492328407151815,658,8965237,1338831,1338831,0
11146,Jan Král,31,4627500,5845392150465823,405,6702032,568896,5689,563207
11147,Piotr Krawczyk,64,2498600,8898460692826724,421,5011173,101380,102,101278
11148,Anders Kristiansen,42,4321200,8802202181983390,511,7335664,795878,0,795878
11149,Fredrik Krogstad,58,389500,9156281950755655,237,1844598,1137330,114,1137216
11150,Mario Kröpfl,28,4514200,7016326869542706,340,5935083,1473042,1473042,0
11151,Sergiy Krykun,50,4545000,7333180867453481,474,7781800,5174412,51745,5122667
11152,Danylo Kucher,29,2404300,8433171560221061,206,3149211,2151606,21517,2130089
11153,Tomasz Kupisz,68,459200,6497186778503018,336,2610755,686069,0,686069
11154,William Kurtović,54,1604600,3205213873314540,354,3964767,551948,55195,496753
11155,Leroy Kwadwo,32,3593400,7725211554579400,353,5791801,4478920,447892,4031028
11156,Bartosz Kwiecień,45,4950700,6534151508101535,543,8472703,3940543,3941,3936602
11157,Jonathan Lacerda,60,3673300,8841976324428228,456,6477057,1592230,159223,1433007
11158,Agustín Lagos,43,4498500,3957810425432140,478,6787428,6689807,66899,6622908
11159,Ricki Lamie,46,2000200,4602666645262864,324,4119337,2802848,28029,2774819
11160,George Lapslie,67,605900,4016476239647083,303,2722123,1930204,19303,1910901
11161,William Le Pogam,47,1964600,4393245115880682,299,3942278,702460,7025,695435
11162,Ryan Leak,62,742900,8408509486740298,245,2105588,1439533,144,1439389
11163,Lee Hyun Ju,62,4833400,4363776301616888,598,8434070,2512823,2513,2510310
11164,Lee Hyun Sik,36,1178500,6221578062473444,173,2181690,278105,0,278105
11165,Lee Tae Hui,48,3983000,4307150577809195,506,7129864,6375888,63759,6312129
11166,Lee Soo Bin,27,1992300,8929524357982114,159,2735078,1380901,13810,1367091
11167,Lee Myung Jae,45,4389400,8190182956657059,468,6812541,6596627,659663,5936964
11168,Sekou Lega,39,2789500,5768650246441936,293,4361698,4176226,4177,4172049
11169,Jakob Lemmer,62,4178400,4500359301701125,624,8060453,440756,4408,436348
11170,Yannis Letard,25,2940300,4167785134313822,246,3945759,1455891,145590,1310301
11171,Juliusz Letniowski,43,707400,7158573048116050,176,1624657,38811,38811,0
11172,Szymon Lewkot,41,3211500,9059737005805612,375,5696316,2796530,280,2796250
11173,Tomás Lezcano,67,951600,6354756689290392,365,3629312,143687,143687,0
11174,Li Shenglong,70,1484200,6623828331067447,388,4001497,3142291,314230,2828061
11175,Li Songyi,47,4091900,9069243977074096,528,6985192,3406038,341,3405697
11176,Liao Lisheng,45,4615900,8611197208942101,553,7856865,1227973,122798,1105175
11177,Liao Junjian,24,387600,7375848223030640,30,227278,149180,149180,0
11178,Patrick Lienhard,42,828900,8823507028574603,197,1951644,526360,52636,473724
11179,Lim Jong Eun,56,1630200,4525351148216518,326,3746817,1870726,188,1870538
11180,Lim Dug Keun,39,3003600,3395885783387235,394,5485024,4156808,0,4156808
11181,Lin Liangming,24,1909700,7509762026068918,160,2639086,1119595,1120,1118475
11182,Axel Lindahl,23,2941600,3101079470318662,221,4051039,1719821,1719821,0
11183,Sondre Liseth,51,3866700,9580289377001708,476,6637604,56864,569,56295
11184,Liu Tao,56,4498100,5515281254525406,521,7768711,5957456,59575,5897881
11185,Mihai Lixandru,66,4924000,8746015625687559,685,8881470,2949974,0,2949974
11186,Lex-Tyger Lobinger,53,2037900,6133735693317401,329,3760087,3263331,0,3263331
11187,David Löfquist,49,3028300,8870583259858126,354,4723521,907921,908,907013
11188,Jannik Löhden,48,897900,6666884458846869,244,2331039,1150637,1151,1149486
11189,Chris Long,24,4189100,5082302737092564,328,5702927,2929199,2929199,0
11190,Luis López,34,573000,5752154477638707,128,1091202,811769,0,811769
11191,Noel,25,4053100,5580047919139442,367,5432992,4574572,458,4574114
11192,Adri López,35,3524100,6569334441243082,387,6148301,4339831,43399,4296432
11193,Pascal Loretz,50,999000,6541838209835742,264,2808330,853175,853175,0
11194,Mathias Løvik,52,2851000,7949312365581938,455,5778286,1604066,1604066,0
11195,Angelo Lucena,57,501400,3894115468984341,258,2260734,621768,6218,615550
11196,Juan Ludueña,65,1499900,7641489572602191,378,3996010,3105998,3105998,0
11197,Enzo Luna,42,3514100,4038540017067680,409,6116412,1544875,15449,1529426
11198,Diego Luna,38,3601600,7578522036615982,408,6081253,5211496,5211496,0
11199,Alexander Lungwitz,70,3587300,9722598395172565,541,6950246,592148,592148,0
11200,Matthias Maak,27,993900,6719068559950186,95,1278775,790278,7903,782375
11201,Aimé Mabika,39,804300,6156262902535045,174,1575988,707530,707530,0
11202,Alex MacDonald,30,981000,6094779820768671,106,1326535,777019,777019,0
11203,Tim Maciejewski,40,1141100,8557377882526393,175,2029141,371145,371145,0
11204,Jack MacKenzie,31,3169600,5951409509640868,310,4892840,2273780,227378,2046402
11205,Jon Magunazelaia,27,947700,5528657477974800,102,1338137,90510,0,90510
11206,Elies Mahmoud,28,4920100,5018981446014137,478,7608330,916793,0,916793
11207,Sebastian Maier,54,1681100,6706681201981326,332,3882948,249175,249175,0
11208,Erik Majetschak,36,2330100,8603508474128303,266,3605629,3090198,3091,3087107
11209,Piotr Malarczyk,37,3518900,7217667031115986,363,5422796,4021575,4022,4017553
11210,Ivo Mammini,67,1128000,5354012017238556,344,3222941,2973349,2974,2970375
11211,Jacopo Manconi,30,1661400,9748825613670218,179,2597376,1189302,119,1189183
11212,Manuel Maranda,29,485500,7614799852307959,65,604226,540488,0,540488
11213,Wanya Marçal,49,1811400,7561797318141736,345,3925624,2904485,290449,2614036
11214,Adam Marciniak,46,1052000,8117524542474382,219,2245307,1256380,0,1256380
11215,Miller Mareco,69,471300,9408525477872422,291,2364360,234656,235,234421
11216,Pablo Marín,67,2740200,5503970649733814,443,5233607,3885221,0,3885221
11217,George Maris,34,4576100,4547241540313010,448,7146517,6312702,0,6312702
11218,Dilan Markanday,59,1698700,5111060538659408,409,4086143,3850124,38502,3811622
11219,Marius Martac,64,529300,5749288660643334,253,2207900,1020257,102026,918231
11220,Johan Mårtensson,67,1133300,4376463025812700,388,3495708,2697205,2697205,0
11221,Luis Gilberto Martínez,28,2746400,3157748271110357,252,4343535,354200,35420,318780
11222,Conor Masterson,36,807900,8780693559619057,158,1602003,24381,0,24381
11223,Valerio Mastrantonio,24,2778200,7564076043686283,221,3592191,2767641,2767641,0
11224,Joe Mattock,59,4985700,8280184165101975,643,8888396,8385234,0,8385234
11225,Konrad Matuszewski,24,1733500,4997006203306593,147,2107849,702127,70213,631914
11226,Lucas Mauragis,42,1847900,8917142198310975,273,3356647,184926,1850,183076
11227,Stevie May,34,908200,5078089250867265,142,1532018,723215,72322,650893
11228,Kyle McAllister,39,3190100,5728788934352524,339,5038039,1597596,160,1597436
11229,John McAtee,31,4627200,8414168071089419,445,7588860,937647,0,937647
11230,Kasey McAteer,67,1387600,8900037600146081,392,3954725,718717,719,717998
11231,Sam McClelland,54,1522500,9925105852306863,340,3620496,240258,24026,216232
11232,Luke McCowan,61,2441900,4563451729825998,418,4734540,1012794,101280,911514
11233,George McEachran,33,3707400,5240339532875729,339,5288733,3189759,3190,3186569
11234,Paul McGinn,61,377300,5383304710953295,257,1950920,541911,0,541911
11235,Aaron McGowan,40,690800,5679009756036588,180,1656337,1073008,1073008,0
11236,Stephen McLaughlin,70,2436200,6513926948907637,480,5321403,315509,315509,0
11237,Connor McLennan,56,2789800,4434889350247254,428,5490060,3429704,34298,3395406
11238,Marcus Johansen Mehnert,69,2457900,6084374730269808,512,5479962,4931922,0,4931922
11239,Francisco Meixedo,26,4650800,3498841700349714,421,7065247,4217824,0,4217824
11240,Jon Mellish,25,4060400,6891926140464931,315,5554979,4030620,4031,4026589
11241,Mateo Mendoza,59,1250500,9270866401506861,323,3436032,364459,364459,0
11242,Muris Mešanović,40,2490600,5801306571377378,272,3725212,1312255,13123,1299132
11243,Nikolaos Michelis,55,2891500,7320982111308807,430,5727666,4790186,480,4789706
11244,Tom Mickel,41,2214500,8162789817895097,277,3863026,38068,3807,34261
11245,Antoni Milambo,23,2335500,5909188452730611,200,3409007,2822820,0,2822820
11246,Lewis Miley,66,3966800,4349315841052933,538,6956612,3669851,36699,3633152
11247,Mickel Miller,62,2997500,6226210260242384,475,5737425,1686796,0,1686796
11248,Min Gyeong Hyeon,46,4971200,9418403559122596,559,8102579,59295,0,59295
11249,Jonnathan Mina,36,2165500,6724626298450267,265,3676240,3397046,339705,3057341
11250,Angelo Mina,51,2455500,3682348784061480,423,5198768,2047285,0,2047285
11251,Dimitar Mitov,23,3646300,4680745947395989,255,5082925,2962048,29621,2932427
11252,Vasile Mogoș,69,1119000,6439663318658689,339,3395706,1504065,1504065,0
11253,Michał Mokrzycki,54,2974800,6981803405432432,444,5725877,3889023,0,3889023
11254,Dinu Moldovan,41,3585000,5796806515676935,389,5938740,4201956,0,4201956
11255,Manuel Mónaco,38,2152400,8074545876672193,272,3744214,2894324,28944,2865380
11256,Monjonell,63,4474700,7169905506726297,588,7991494,3227706,323,3227383
11257,Christopher Montaña,68,703300,6353788427229963,322,2923765,2110659,0,2110659
11258,Lisandro Montenegro,67,1610400,8518971348929566,417,4204227,1656904,1656904,0
11259,Ronny Montero,63,1554600,6453197975744345,372,4075739,1814283,0,1814283
11260,Jasper Moon,33,3232000,6688359989695071,316,4963343,1090533,1090533,0
11261,Martin Moormann,59,1976000,6168818828069187,337,4076001,3544924,354493,3190431
11262,José Luis Moreno,58,1482400,8882761196874365,324,3421885,951817,0,951817
11263,Carlos Alberto Moreno,70,2453700,8838945126336485,492,5570613,3772625,3773,3768852
11264,Albie Morgan,50,2321300,9088811968667658,339,4545786,918947,91895,827052
11265,Pelayo Morilla,58,1491600,3891248170071698,363,3726974,3221492,322150,2899342
11266,Mamudu Moro,27,1821200,6344849383653135,148,2407955,1921959,193,1921766
11267,Carlos Moros Gracia,68,2449300,5159210330138136,473,5753508,3508725,351,3508374
11268,Glenn Morris,27,433300,8929844719543096,81,636310,464977,465,464512
11269,Kieron Morris,58,1697200,7887780548708076,349,3927344,2545214,0,2545214
11270,Michael Morrison,34,1812800,9082706892012293,242,3362364,1153896,0,1153896
11271,Yaw Moses,43,3154600,4899758039016520,355,5058701,1311604,13117,1298487
11272,Ahmed Mostafa,47,490500,3646931322840765,164,1354931,727811,0,727811
11273,Loris Mouyokolo,62,1630900,3499352909763666,394,4447785,1332562,134,1332428
11274,Marek Mróz,33,352800,8953701676457096,98,708015,527507,0,527507
11275,Piotr Mroziński,65,2560900,8774570365553305,409,5035515,3701293,370130,3331163
11276,Tom Müller,51,3850300,8463643236377474,441,6747788,2127406,2127406,0
11277,Admiral Muskwe,27,2700900,5765927248080855,262,4012310,706736,707,706029
11278,Ramil Mustafaev,56,607300,5202723606663058,241,2040194,431002,431002,0
11279,Vlad Muțiu,52,2790200,6929024915024233,444,5582963,581744,0,581744
11280,Ramy Najjarine,45,1923400,9385696399535977,273,3365025,3068552,0,3068552
11281,Gilmar Napa,52,3958500,7946815725055394,487,6648764,1324447,13245,1311202
11282,Netinho,68,4923900,8674567884108651,717,10161654,4098840,409884,3688956
11283,Santos Navarro,65,3891200,6080381912756017,581,7239034,4930837,4931,4925906
11284,Corrie Ndaba,46,4006800,9956119592479707,500,7249369,5023476,0,5023476
11285,Hassan Ndam,30,1744200,7733201993112915,226,2993516,850415,851,849564
11286,Jalen Neal,36,1300100,9334603124038843,179,2071421,1399118,1400,1397718
11287,Dylan Nealis,61,1070300,9590729694642222,343,3479336,3239029,0,3239029
11288,Lucas Ness,23,1440300,3737594327858142,140,1887715,1523004,15231,1507773
11289,Ahmad Ngouyamsa,34,590500,6054774864681361,103,945938,895999,0,895999
11290,Matti Lund Nielsen,34,2806800,7141093481517251,263,4322512,3321276,333,3320943
11291,Joel Nilsson,35,1844200,5786060545217283,211,2975031,1169042,117,1168925
11292,Bryan Nokoue,22,4730900,9468441863463937,411,6640828,2004078,2004078,0
11293,Lasse Nordås,64,505300,7272805002557627,240,2135358,477308,478,476830
11294,John Olav Norheim,28,4048800,5051180301711572,355,5657699,5161701,0,5161701
11295,Conor Noß,53,4769300,5185587318238643,529,8206386,508745,50875,457870
11296,Kélian Nsona,60,4073600,7441543117390186,534,7182765,2267042,0,2267042
11297,Orlando Núñez,50,4446100,7369379176096173,505,7382128,7235636,72357,7163279
11298,Aiden O'Brien,39,2639100,4312271053454511,283,4216071,3810525,3810525,0
11299,Anthony O'Connor,69,4970000,8031166371920483,735,10267745,551211,0,551211
11300,Thomas O'Connor,61,2166400,6725425473120318,350,4088832,1303512,130352,1173160
11301,Shane O'Neill,54,3361100,7556391322980561,448,5834652,2218673,221868,1996805
11302,Gary O'Neill,53,860700,7046414622647307,285,2713143,1161249,1162,1160087
11303,Adam O'Reilly,69,2842500,6792812120097453,504,6242309,3903214,0,3903214
11304,Rhys Oates,67,1222900,9889282190746991,371,3664742,2495583,0,2495583
11305,Koldo Obieta,41,4293800,5492016786677405,415,6365914,3541362,0,3541362
11306,Edier Ocampo,69,676100,8709060347432254,308,2582514,944090,9441,934649
11307,Oleg Ocheretko,29,4836000,5873140043060022,373,7273666,5828576,5829,5822747
11308,Funso Ojo,52,1389400,7533076390209198,275,2870400,336360,3364,332996
11309,Jubril Okedina,26,2158900,4022198206658698,179,2987114,831520,831520,0
11310,Yllan Okou,68,1010900,7905992976635150,390,3611104,425461,4255,421206
11311,Kanji Okunuki,31,4675400,8055430063638937,433,7201803,4264738,0,4264738
11312,Paweł Olszewski,42,3961000,9570008932538403,392,6024061,1924960,1924960,0
11313,Anthony Olusanya,33,4049000,3186053864051989,426,6760082,1918599,191860,1726739
11314,Kevin Carlos,27,4446400,8920912563707560,351,5771156,2494220,2495,2491725
11315,German Onugkha,52,4174600,6742185503386692,525,7097705,432409,0,432409
11316,Alexandru Oroian,51,2045500,8595174719694549,313,3837327,2028101,202811,1825290
11317,Jesse Öst,29,4820900,6730925741392214,440,7134851,5946319,5947,5940372
11318,Arild Østbø,46,1113500,9635825086386499,208,2389315,1584857,15849,1569008
11319,Moritz Oswald,28,754900,8192213276074971,74,912470,8691,0,8691
11320,Bogdan Oteliță,35,697800,9777694049403416,155,1547158,815669,81567,734102
11321,Sturla Ottesen,52,4407000,3613186872601161,576,8047222,784273,7843,776430
11322,Severin Ottiger,25,1835100,7919096821847441,178,2597566,1511635,1512,1510123
11323,Yari Otto,56,1055300,7558407310108254,321,2952521,1133267,11333,1121934
11324,Assan Ouédraogo,70,642600,6062253388532036,368,3370054,2609297,2609297,0
11325,Solomon Owusu,70,1485900,7318212801858761,381,4162638,2346132,0,2346132
11326,Rome-Jayden Owusu-Oduro,39,4600100,3822481481541720,506,7297042,6914126,69142,6844984
11327,Anthony Oyono,27,1373700,8161578917460094,132,1935322,1568516,15686,1552830
11328,Casper Øyvann,64,1358900,4184805287332283,368,3697488,681029,682,680347
11329,Benjamin Ozegovic,70,3439700,4337438597344538,529,7085682,185215,0,185215
11330,Erdem Özgenç,41,318900,9342190138281180,109,803952,498,0,498
11331,Can Özkan,57,3612000,5216682669867510,490,6574833,361908,36191,325717
11332,Alim Öztürk,55,3091400,9050970628570535,502,6333035,3967145,0,3967145
11333,Pablo Pagis,62,2607300,6633719510928268,444,5357691,1776403,0,1776403
11334,Adrion Pajaziti,37,3643600,5824011864711999,389,5446827,569955,569955,0
11335,Ollie Palmer,41,831200,9805835079712473,156,1612113,98434,0,98434
11336,Ionuț Panțîru,42,2684000,3348406997712389,342,4538578,1926125,1927,1924198
11337,Federico Paradela,54,4765600,7711176537649034,512,7767583,2077526,2078,2075448
11338,Pardo,52,2053000,5797477143968176,347,4222393,588010,58801,529209
11339,Luis Paredes,39,2981800,3076110629767628,356,5059247,4509754,450976,4058778
11340,Park Kyu Hyun,24,4815000,3357658398231187,403,7267670,3342583,335,3342248
11341,Park Bae Jong,24,2533900,8305138757777603,211,3597824,3302924,330293,2972631
11342,Tom Parkes,44,3536200,4362488267399246,451,6584710,4196002,420,4195582
11343,Harry Paton,70,3731500,4267264998551503,546,6789973,6533022,0,6533022
11344,Alex Pattison,59,1866400,4031345368108397,395,4542356,1728376,1729,1726647
11345,Shayne Pattynama,33,1749100,9385827815743528,197,2633546,2419284,2419284,0
11346,Alex Paulsen,59,1413600,6603946444734107,348,3754924,1547731,1547731,0
11347,Damjan Pavlovic,31,2108000,9360220701397023,248,3629015,2999134,299914,2699220
11348,Myles Peart-Harris,43,3767200,8834206780440767,405,6162961,4354837,4355,4350482
11349,Gastón Pedernera,60,4860200,5568596109192170,642,8486100,1696286,16963,1679323
11350,Mikkel Pedersen,30,2234500,5420876178454805,255,3712196,3349501,33496,3316005
11351,Pablo Pedraza,57,2825200,4649323683521085,447,6037560,352312,3524,348788
11352,Harry Pell,26,4119300,3742949004738137,338,5667180,4422452,443,4422009
11353,Peng Xinli,55,809400,8669874636160165,217,2086058,2002237,201,2002036
11354,Mirnes Pepić,44,4457200,8833618641247709,538,8443062,4471972,44720,4427252
11355,Rafael Pereira,29,2655300,3279942947318461,290,4252159,3539492,354,3539138
11356,Ibson Melo,59,3245900,5855346877520801,469,6595876,783760,7838,775922
11357,João Serrão,40,3861200,3989658937736887,430,6423209,719273,71928,647345
11358,Pablo Pérez,64,888200,8439053615208447,316,3002604,2044968,20450,2024518
11359,Ovidiu Perianu,63,2535000,3334816451190045,472,5485015,1595648,160,1595488
11360,Samuele Perisan,53,2149400,5617872829368807,357,4378242,2411783,0,2411783
11361,Patricio Pernicone,43,4464400,7149345361262784,511,7759265,7392851,0,7392851
11362,Aleks Petkov,50,1000900,6498207691194915,270,2572315,539680,53968,485712
11363,Zoran Petrović,70,4142900,8759318617051306,651,8122241,6594752,65948,6528804
11364,Alexandre Phliponeau,60,661700,3246248110590796,272,2293021,624476,625,623851
11365,Hugo Picard,32,3650800,8776904280115240,342,5626775,2453119,24532,2428587
11366,Tomasz Pieńko,52,3768800,6566906793683695,458,6864066,4868300,4868300,0
11367,Nando Pijnaker,41,2296500,5187395947638609,300,3731381,550547,551,549996
11368,Kleber Pinargote,22,4518600,6038589414679648,381,6407480,3123270,312327,2810943
11369,Lukas Pinckert,58,3771800,4966989574969827,493,6768330,3779827,0,3779827
11370,Matthew Platt,68,2150000,4195645598063637,481,5523213,5017140,5018,5012122
11371,Jacek Podgórski,52,1062000,9747042020486945,277,2763910,1538738,154,1538584
11372,Manuel Polster,33,4846100,4163811158667122,501,8058699,17931,0,17931
11373,Antonio Portales,65,1443800,6356228201475476,422,4106353,84462,0,84462
11374,Dylan Portilla,25,1920800,8625156328041102,175,2783283,357309,357309,0
11375,Marcos Portillo,40,1869200,4241013502885411,266,3417907,321130,0,321130
11376,Jack Powell,32,2171300,8409917718489759,253,3513888,2126149,2127,2124022
11377,Isaac Price,69,706600,9253366675745976,322,2629531,1444048,1444048,0
11378,Joe Pritchard,33,793200,4177012157141495,146,1532377,389538,38954,350584
11379,Oliver Provstgaard,22,2345800,3932325757927738,180,3026698,239584,239584,0
11380,Gustavo Puerta,49,4272500,4679289589180086,490,7365567,3715077,3715077,0
11381,Maximiliano Puig,32,3255900,4796475329890510,331,5360230,1187934,11880,1176054
11382,Ben Purrington,66,497200,5686613348756125,298,2575504,1688082,169,1687913
11383,Leandro Putaro,41,1293500,3225098552787188,213,2478935,906093,906093,0
11384,Stephen Quinn,24,3123300,4836213390424708,263,4294746,2610636,0,2610636
11385,Juan Jesús Quiñones,53,3195100,7555458839825186,458,6285284,2985493,298550,2686943
11386,Santiago Quirós,67,1274300,4224902602561014,369,3669143,768975,7690,761285
11387,Eduard Radaslavescu,42,4535000,7645401282296889,478,7295587,2050384,2051,2048333
11388,Bojan Radulović,25,2071600,8704367730005510,188,2778028,421538,0,421538
11389,Antonio Raimondo,58,3478000,5769763279206820,496,6496224,737076,737076,0
11390,Kayne Ramsay,49,3919100,7676354497157207,480,7063375,3478600,0,3478600
11391,Alexander Ranacher,56,821000,6118746533375181,279,2735070,1867872,0,1867872
11392,Connor Randall,24,1320800,3037708056449168,113,1698312,261485,262,261223
11393,Grant-Leon Ranos,30,1581900,3865392874118173,168,2393534,1970052,1971,1968081
11394,Rao Weihui,42,4596000,8940763145775521,459,7755596,2140403,0,2140403
11395,Farrend Rawson,33,4565900,6701328916477380,413,7443616,2967517,297,2967220
11396,Sören Reddemann,27,2108600,7734201475099845,176,2847019,2746232,0,2746232
11397,Nikolai Rehnen,44,1616500,6110402036868757,232,3037962,1795594,179560,1616034
11398,Jamie Reid,27,3617200,6213128472818772,308,5339393,1720737,172074,1548663
11399,Dominik Reiter,26,4986600,7798816512623735,365,6435229,509196,510,508686
11400,David Richter,43,2251100,5645326100206545,298,3974842,2524278,25243,2499035
11401,Julian Rieckmann,38,2083900,8180137602740888,273,3545899,1106421,111,1106310
11402,Lasse Rieß,51,4266400,6116479699291895,572,7377584,114711,0,114711
11403,Sebastian Ring,34,3862300,3476192063736585,365,5893633,1364945,1365,1363580
11404,Sascha Risch,69,4040700,5129914614407338,600,8029762,7198822,7198822,0
11405,Edson Rivas,42,3671900,8039167266623805,423,6387740,2487405,0,2487405
11406,Jorge Roa,51,534100,4376585129963610,211,1833176,1695383,16954,1678429
11407,Thomas Robinet,46,1722900,9712579639116161,318,3720001,740691,0,740691
11408,Robbie Robinson,31,3642300,7430778058612367,373,5554597,1678431,16785,1661646
11409,Harvey Rodgers,28,4624600,7268098731861365,406,7303610,3705483,0,3705483
11410,Thiago,41,2498200,8833141078196535,289,4082641,1039974,0,1039974
11411,Ignacio Agustín Rodríguez,39,703500,6069335470211865,193,1704929,553995,554,553441
11412,Fabian Rohner,46,2040200,3356587033937945,335,4350192,2475268,248,2475020
11413,Javier Rojas,32,4070100,8092403730120446,433,6631495,4284062,42841,4241221
11414,Gilli Rólantsson,26,1355600,6616978994502259,131,1901985,1577882,15779,1562103
11415,Mihai Roman,52,3479200,4968089163873742,508,6942349,3046780,304678,2742102
11416,Diego Alonso Romero,42,3460500,4670282813177346,407,5790265,5338016,533802,4804214
11417,Anthony Roncaglia,37,3965700,7943346864844280,425,6614878,1080057,10801,1069256
11418,Danny Rose,28,327100,8405227790773220,75,496843,131177,131177,0
11419,Lasse Rosenboom,48,2436300,4749057796321334,350,4471340,4039962,4040,4035922
11420,Otto Rosengren,58,3049400,3411913721296656,462,6042584,361785,0,361785
11421,Lucas Röser,27,3885800,9907712823939555,317,5360203,3341579,0,3341579
11422,Jordan Rossiter,51,3384000,4207268208558292,434,6312565,541968,54197,487771
11423,Storm Roux,38,4618200,4553951875325718,458,7163805,902588,0,902588
11424,Kelyn Rowe,47,3831200,8367933089694344,471,6535830,2479406,2480,2476926
11425,Juan Pablo Ruiz Gomez,23,4614800,9286344250085555,367,6835656,5942276,59423,5882853
11426,Ryan Rydel,29,4199500,4624423668636782,372,6036694,5214862,52149,5162713
11427,Juan Saborido,63,1767000,3980270661712757,396,4170679,1826545,0,1826545
11428,Kieran Sadlier,36,1082200,9091474834932690,161,2000773,273245,0,273245
11429,Maciej Sadlok,36,3015600,5866562094448337,358,5473989,5047859,5047859,0
11430,Amadou Sagna,53,2484700,8248599913264472,419,4660497,2216019,0,2216019
11431,Mirko Salvi,65,824600,8923673164508012,315,2921787,2710223,272,2709951
11432,Piotr Samiec-Talar,37,433000,5383285257640634,112,886971,241347,24135,217212
11433,Alejandro Samudio,26,1033600,6217046895158133,104,1361372,127250,12725,114525
11434,Martin Samuelsen,29,3631900,9745902531607064,307,5344876,4266115,426612,3839503
11435,Derensili Sanches Fernandes,46,2444800,8898322998595914,319,4320339,1126621,1126621,0
11436,Valentín Sánchez,62,2943800,6266292701100163,537,6346375,1852908,185291,1667617
11437,Carlos Uvilde Sánchez,31,4495000,3625563538856361,421,6882224,6464366,647,6463719
11438,Juanlu Sánchez,29,1508000,4686953559894054,179,2445905,115572,116,115456
11439,Thomas Santos,70,2094200,9895894389603371,474,4948255,1441972,144198,1297774
11440,Francisco Júnior,38,1866600,9096420862450595,263,3039539,2661069,2661069,0
11441,Niklas Sauter,43,1609500,9091513334631210,246,3115974,2824500,0,2824500
11442,Amine Sbaï,27,3788900,4719056627558950,367,5709602,3589898,35899,3553999
11443,Dane Scarlett,57,3718500,5713181130899706,505,6448167,2188205,2188205,0
11444,Lukas Scherff,61,1164600,8194675680078792,290,2899862,1255002,125501,1129501
11445,Yannick Schmid,67,3664600,4908108795947069,583,7596331,1188445,1189,1187256
11446,Leon Schneider,26,2574300,4578637566538727,228,3930748,3396508,3397,3393111
11447,Oscar Schönfelder,69,2795000,4653377254468283,536,6374835,789647,790,788857
11448,Lewis Schouten,25,4533500,8118234439847126,371,6439597,5328236,5329,5322907
11449,Fabian Schubert,33,4979600,6897737783255338,503,7569846,1816429,18165,1798264
11450,Lion Schuster,59,4502400,7461530259502927,623,8512981,4296557,430,4296127
11451,Léo Scienza,63,4192200,5339128423496687,643,8347544,404324,0,404324
11452,Steve Seddon,34,2316100,3254053118360921,290,4147321,3159056,3160,3155896
11453,Jenson Seelt,62,1217700,8244767983239800,328,3481452,1381529,1381529,0
11454,Erlend Segberg,24,1953000,9348507310084504,156,2591466,824055,0,824055
11455,Moritz Seiffert,47,1161800,5622630493315161,248,2684415,236699,0,236699
11456,Seo Jin Su,24,645300,3209570846651437,52,626751,63646,0,63646
11457,Jakub Serafin,57,1553600,9825928385428093,284,3200541,2499123,2499123,0
11458,Kléri Serber,60,2879100,8045412658782136,472,5848417,2740957,274096,2466861
11459,Alin Șeroni,41,1458600,4827455547683552,232,2572645,2294862,0,2294862
11460,Thiago Servín,45,1126700,7832688074680815,203,2214158,2056104,206,2055898
11461,Takayuki Seto,59,1462600,6984303273744214,321,3533183,2936580,2937,2933643
11462,Serano Seymor,51,4225600,6651678854615119,513,7490097,1632518,16326,1616192
11463,Laorent Shabani,66,1262800,6335532384536985,328,3622998,2359813,23599,2336214
11464,Meritan Shabani,66,1042000,6628111342743506,338,3364508,89795,0,89795
11465,Noah Shamoun,56,4870400,3398116654162766,558,8680770,7298690,0,7298690
11466,Joe Shaughnessy,22,3888200,7049272453721273,329,5695757,2398936,23990,2374946
11467,Oli Shaw,45,4707200,7047214535111451,545,7950777,2387422,23875,2363547
11468,Jan Shcherbakovski,69,1468500,5383377877334391,391,3842114,2535156,0,2535156
11469,Juljan Shehu,63,1362700,8918729656260207,372,3697922,2210203,221021,1989182
11470,Nathan Shepperd,44,4062600,5432843665139910,439,7075078,2837858,0,2837858
11471,Evgeniy Shikavka,63,569400,5939066640382844,312,2599046,582632,583,582049
11472,Shin Se Gye,49,4731200,6452898546746012,515,7870960,3903020,3904,3899116
11473,Sekou Sidibe,40,852200,8299314892834027,178,1824844,614037,0,614037
11474,Silvan Sidler,29,4874700,8891142550480523,420,7008933,6024789,0,6024789
11475,Omar Sijarić,30,4272900,3672620000037711,422,6553595,2520709,25208,2495501
11476,Luís Silva,33,2582800,8731836803493960,292,4108116,1539675,0,1539675
11477,Oliver Silverholt,66,4743700,4979138325530273,711,8842671,6608723,66088,6542635
11478,Dynel Simeu,26,2186800,9767286153415849,208,3246367,2562031,2562031,0
11479,Roko Šimić,27,2356900,6492799037711528,218,3594420,857964,8580,849384
11480,Josh Sims,31,2131600,4938197460944019,253,3245521,1434767,1434767,0
11481,Simon Skarlatidis,42,2341200,5401818265543480,335,4165468,1380616,1381,1379235
11482,Meris Skenderović,51,3674400,3980866676267121,549,7447715,5274859,0,5274859
11483,Vetle Skjærvik,39,2665100,5736953039568021,304,4342159,1784692,1785,1782907
11484,Mateusz Skrzypczak,44,3913900,6241173958713036,443,6048245,242156,2422,239734
11485,Thierry Small,26,2008000,7453460440494051,168,2817908,12341,12341,0
11486,Dennis Smarsch,50,3804100,6290096451176093,485,6531046,708913,709,708204
11487,Ian Smeulers,60,2308400,9087268707965235,417,5004731,974705,9748,964957
11488,Andy Smith,70,2488100,6689066243397111,501,5489154,544815,545,544270
11489,Kane Smith,67,2222000,6875451516926094,450,5138060,1144540,11446,1133094
11490,Liam Smith,37,3087300,4393303854400585,364,5449529,2267936,0,2267936
11491,Alistair Smith,23,406200,7704639804393431,15,110502,22730,228,22502
11492,Matt Smith,44,4758600,4887347235998151,487,7227541,3570896,358,3570538
11493,Jordan Smith,30,847200,8700301950042916,104,1224782,310643,311,310332
11494,Matt Smith,61,3262400,4396280688884495,468,6109553,5766303,0,5766303
11495,Jan Sobociński,30,3265500,4215298262366026,259,4874360,594639,0,594639
11496,Arnau Solà,67,1023600,4534357697942728,341,3152740,2136179,0,2136179
11497,Joachim Soltvedt,39,2557500,9680032446244535,302,4080526,772778,7728,765050
11498,Alessandro Sorrentino,27,3123900,8433492794684919,270,4906865,3922430,3922430,0
11499,Ruel Sotiriou,56,1894500,6961702532182017,367,3967066,2763500,277,2763223
11500,Sebastian Soto,25,2773500,4328078237230015,240,4138299,1479136,1480,1477656
11501,Matheus Pato,50,4211500,3789184532023220,533,7489289,455851,4559,451292
11502,Sylla Sow,62,2848900,8611198045940900,457,6130108,3033011,303302,2729709
11503,Jack Sowerby,54,1384400,9519848653396966,279,3017425,1818070,0,1818070
11504,Meiko Sponsel,42,4636300,7158551854164324,491,8139246,1483738,14838,1468900
11505,Tony Springett,39,944500,3452977885615421,199,2119008,1455815,0,1455815
11506,Julian Stark,60,4814500,9013781044403668,583,9220503,5069046,5070,5063976
11507,Simon Stehle,30,3209900,6835284988015352,327,4629907,344199,34420,309779
11508,Daniel Stenderup,28,3479400,3652872852793281,286,5100147,3089359,309,3089050
11509,Halldor Stenevik,46,4731000,4583960128501586,581,8224955,343954,3440,340514
11510,Janek Sternberg,22,2348700,4566985296804397,177,3069649,2726586,0,2726586
11511,Filip Stevanović,55,778500,5560747094994442,269,2272732,1008298,0,1008298
11512,Alen Stevanović,39,3692500,7022156337197236,365,5343078,2897072,0,2897072
11513,Mathew Stevens,64,1625700,4493385340845745,355,3765476,1793944,180,1793764
11514,Anthony Stewart,49,3323700,9714420286292677,429,6017438,5947755,0,5947755
11515,Paul Stock,49,1179100,7534463444098912,261,2863774,318898,319,318579
11516,Michel Stöcker,52,4452500,4537591589431382,539,8468611,6468666,647,6468019
11517,Jayden Stockley,53,1813500,6036141590019898,341,3779866,3493196,3493196,0
11518,Simon Straudi,62,3340200,9582398392984295,450,6551538,304707,0,304707
11519,Fabio Strauss,39,898600,3347786386850828,187,2035612,1524221,152423,1371798
11520,Robert Street,57,1725900,6087641847479881,358,3976626,1326760,132676,1194084
11521,Oliver Strunz,60,1610000,8958597954383725,321,3482778,108691,109,108582
11522,Jakub Surovčík,25,1674400,6045093479972140,137,2321847,623726,62373,561353
11523,Sam Sutton,52,1172900,8415898244660166,298,3170444,2373622,237363,2136259
11524,Keita Suzuki,58,2703800,8158863860028320,394,4912989,414812,0,414812
11525,Ben Sweat,25,4463700,8476197513122481,350,6088857,2541733,0,2541733
11526,Daniel Szczepan,22,650900,3896616301046936,69,763769,123853,0,123853
11527,Kryspin Szcześniak,67,4205300,4387575290635223,524,6991970,4563557,0,4563557
11528,Szymon Szymański,50,4512200,8291906018754137,571,7245955,1092431,0,1092431
11529,Richmond Tachie,38,4879000,6805596152805083,447,7475627,4780546,4780546,0
11530,Dalibor Takáč,55,4915500,7975062680971319,610,8103525,2093086,2093086,0
11531,Callum Talbot,22,4168900,6676284350852652,329,5629803,296739,29674,267065
11532,Adil Taoui,58,907300,6901440032535993,305,2705930,1601533,16016,1585517
11533,Andrew Tarbell,66,983500,8478111014143418,389,3823567,109606,10961,98645
11534,Emre Taşdemir,34,3479900,5084639324945868,380,5747470,3135806,3135806,0
11535,Dale Taylor,51,1407100,8048147721485490,283,2995889,465415,4655,460760
11536,Slobodan Tedić,70,2018200,7683286104774884,453,4589332,1299397,1299397,0
11537,Russell Teibert,26,2582200,4937989790946694,239,3723736,965246,0,965246
11538,Dom Telford,48,2643400,4420049820662230,374,4611658,2002013,2002013,0
11539,Christopher Telo,55,799200,8783498028733321,241,2379379,1410202,1410202,0
11540,Søren Tengstedt,52,1306500,8066706151224547,291,2907832,1065732,107,1065625
11541,Demba Thiam,29,3447300,6313645643350709,336,4959753,2820978,282098,2538880
11542,Marvin Thiel,58,2344900,7878593792046962,369,4787436,4327236,4328,4322908
11543,George Thomas,58,2169300,4812044257395249,352,4270482,3994963,400,3994563
11544,Luke Thomas,30,2523900,4388209062651265,243,4012321,3612885,36129,3576756
11545,George Thomason,52,3206500,6598516952614908,445,5584480,4490915,44910,4446005
11546,Liam Thompson,69,2277000,8641630606846043,429,4821200,3701236,3701236,0
11547,Tobias Thomsen,38,3418300,9813421322041575,368,5745179,1763982,1764,1762218
11548,Alexandru Țigănașu,50,2979000,7494301896999288,430,5675469,3504172,35042,3469130
11549,James Tilley,43,635500,5852946975377586,157,1510338,1048053,10481,1037572
11550,Joona Toivio,29,1584600,3586103988252104,141,2155627,1976453,197646,1778807
11551,Santiago Torres González,47,4285000,9045936897273657,471,7431622,5652668,0,5652668
11552,Mohamed Touré,32,3770800,7291490049515757,378,5574690,1767970,177,1767793
11553,Michał Trąbka,23,2386300,3166097022248518,174,3174185,1342729,134273,1208456
11554,Bonota Traoré,69,4531300,3331772513547479,667,8912555,3086121,0,3086121
11555,Kacper Trelowski,34,360300,6688697610808960,104,735998,673738,674,673064
11556,Laureano Troncoso,60,3710000,8558857680282262,558,7711688,3252264,0,3252264
11557,Anton Tsarenko,32,2197400,8338383262844671,229,3584723,2260022,0,2260022
11558,Kabongo Tshimanga,64,1528000,9865630983428973,324,3601978,2492461,249247,2243214
11559,Marc Tsoungui,53,1591300,8177824655398130,304,3494456,122289,122289,0
11560,Jordan Tunnicliffe,40,3658100,4124323104943441,405,5676004,2890621,0,2890621
11561,Ed Turns,48,944600,5980678426510180,231,2318709,1539841,153985,1385856
11562,Lukas Tursch,53,1886000,8072054162788943,323,4171547,2357931,236,2357695
11563,Can Uzun,63,2176600,4236651844382992,368,4589418,3419610,3420,3416190
11564,Ely Valderrey,69,4261300,4175296706109514,643,7952896,2211490,0,2211490
11565,Harvey Vale,31,1542800,4584659860783053,163,2329070,2073394,2073394,0
11566,Pablo Valencia,55,3835000,4523481806291275,504,6338668,2781340,2781340,0
11567,Rúben Fonseca,59,2712400,4125332178359646,481,5606090,2671699,26717,2644982
11568,Rúben Ismael,25,2175200,5597804702857562,212,3087851,2481886,2482,2479404
11569,Antoine Valério,44,1307400,7533824413911377,237,2569494,1333447,134,1333313
11570,Gustavo Vallecilla,42,3315800,5106044195956692,363,5403846,1383333,1383333,0
11571,Lenny Vallier,24,2536700,3266216896399378,255,3860694,205290,0,205290
11572,Ruben van Bommel,40,3847100,3455101361390304,427,5880636,1502439,151,1502288
11573,Delano van Crooij,69,3635400,6446209543244021,636,7724891,488316,0,488316
11574,Rav van den Berg,58,1738700,3530105343879704,348,3885313,3629321,363,3628958
11575,Bradly van Hoeven,44,2845500,3905705824635491,371,4997736,2241424,2241424,0
11576,Franco Vega,63,1927000,9565409872423769,424,5038465,1212671,121268,1091403
11577,Stefan Velkov,50,1776100,6682758999798982,336,3926126,1629910,1629910,0
11578,Tijs Velthuis,60,3359500,7772631577550546,444,5981787,2616105,262,2615843
11579,Dixon Vera,41,2596800,8074840431167679,311,4339200,699857,6999,692858
11580,Federico Versaci,38,4777400,8506869974458698,501,7640070,6156973,616,6156357
11581,Gaute Vetti,63,1080100,5014173328589989,308,3055643,1135586,11356,1124230
11582,Kane Vincent-Young,50,3069100,9101648649077991,410,5614489,607945,60795,547150
11583,Jannes Vollert,32,1655900,5684805622877801,206,2718169,1593469,159347,1434122
11584,Giacomo Volpe,38,2036200,4404660859936896,250,3355997,2148875,214888,1933987
11585,Ivan Vujica,32,3281500,4748266312573958,303,5060544,965607,966,964641
11586,Dijan Vukojević,35,4991000,6009670141636766,515,7821063,1928674,193,1928481
11587,Oliver Wähling,25,3679500,9875453520298594,325,5322860,3878009,388,3877621
11588,Tim Waker,65,4022800,3429932997987079,584,7496169,2589709,2590,2587119
11589,Simen Wangberg,65,4437400,6165825496494628,647,8102705,6854571,6855,6847716
11590,Paul Wanner,36,1663000,4604268797737124,226,2684285,1178807,0,1178807
11591,Ben Warland,31,860600,3208027844280846,95,1178080,437984,43799,394185
11592,Martin Wasinski,58,4283000,9567104503180949,507,6853677,85837,85837,0
11593,Luke Waterfall,46,4280200,8239262934738364,551,8050931,6388042,639,6387403
11594,Ryan Watson,40,2615800,8041354605745165,295,4156561,2271917,2272,2269645
11595,Bartłomiej Wdowik,70,696900,9556554536911811,380,3210277,2135470,213547,1921923
11596,Alexander Weidinger,50,3372100,8336685456498350,391,5609627,4575654,0,4575654
11597,Dylan Wenzel-Halls,39,3525100,9278782420806888,423,6117616,2452848,246,2452602
11598,Quentin Westberg,38,4754600,8586396775081953,491,7545451,4644290,4645,4639645
11599,Adam Wharton,70,4552200,7834003023519177,643,8158805,5467393,547,5466846
11600,Dennis Widgren,39,4967300,7339513077019198,505,7661614,2946220,295,2945925
11601,Rasmus Wiedesheim-Paul,48,4750000,5240310713189347,551,7573668,2852914,28530,2824384
11602,Niklas Wiemann,25,3011400,7106230943851783,305,4674617,2090058,2091,2087967
11603,Oscar Wiklöf,42,2065000,3900016290923746,293,3897486,2729530,272953,2456577
11604,Caleb Wiley,46,4642100,4288524666820098,585,7969531,5677691,5677691,0
11605,George Williams,66,2678900,3872055565749813,451,5569057,4278943,428,4278515
11606,MJ Williams,61,1946500,6512849086207066,375,4321767,4050765,406,4050359
11607,Ben Williams,40,3943700,8441155140364870,436,7014383,3964891,0,3964891
11608,Shaun Williams,39,3028600,9619395879734585,334,5332876,3281344,329,3281015
11609,James Wilson,52,3092800,9760545463753481,452,6061869,3661218,0,3661218
11610,Joshua Wilson-Esbrand,52,775000,3053719231078612,266,2316644,524567,52457,472110
11611,Freddy Winsth,59,2938100,5476126386231667,412,5302064,1712393,0,1712393
11612,Casper Winther,30,2859200,5853152373370028,242,4090666,3392806,0,3392806
11613,Tyreik Wright,36,4957200,9395546663951709,492,7646694,6007545,600755,5406790
11614,Akil Wright,32,2422700,8385065087607840,222,3691967,3269315,3270,3266045
11615,Rihito Yamamoto,65,4680800,7859910289993817,595,8856220,2755445,276,2755169
11616,Yan Xiangchuang,27,4204200,4091115535707801,371,6273396,2409696,24097,2385599
11617,Romaric Yapi,52,4513000,7257010674135240,550,7414480,6141464,6141464,0
11618,Lamar Yarbrough,33,2008500,8232337907614265,234,3031337,2563226,256323,2306903
11619,Erencan Yardımcı,58,1201900,5654368857648742,323,3240299,1188738,1188738,0
11620,Ali Yaşar,29,4834900,6083061612284922,440,7673457,2137901,2138,2135763
11621,Mert Yılmaz,35,4682700,3404750464862119,444,7222322,1562336,1563,1560773
11622,Dominique Youfeigane,57,3196400,9321736634644922,491,6040421,5100189,0,5100189
11623,Luke Young,56,2355500,7368660038480680,414,5223029,1922490,19225,1903265
11624,Bendjaloud Youssouf,44,490000,9004665386103602,148,1155997,467091,4671,462420
11625,Yun Suk Young,31,2630200,6222886763902669,272,4160973,3799617,380,3799237
11626,Yun Pyung Gook,40,1500700,6415848142392860,236,2869088,806233,0,806233
11627,Cyril Zabou,69,4343400,8642275908871132,647,7953878,232000,2320,229680
11628,Vasilis Zagaritis,50,1936900,9093077895798765,293,3767406,2379854,2379854,0
11629,David Zalazar,69,2978400,8251929133074969,495,6609277,2199328,21994,2177334
11630,Luis Zárate,25,4733400,6557056018825329,424,6613976,4531949,0,4531949
11631,Zarzana,53,3484100,8868823982238890,467,6713572,738712,0,738712
11632,Dominick Zator,57,3570600,9461359424208470,491,6584695,5318410,532,5317878
11633,Nadir Zeineddin,49,3517200,5393533925900489,415,6019224,1027274,1027274,0
11634,Zheng Kaimu,26,3784800,9470883081459428,332,5383982,2510076,2511,2507565
11635,Lukáš Zima,50,1062400,5187042127208906,212,2245142,766732,7668,759064
11636,Tanguy Zoukrou,23,2326200,8487719100206187,167,2988268,2869756,28698,2841058
11637,Mateusz Żukowski,40,3571000,6514730294395902,416,5809152,4580334,4580334,0
11638,Maciej Żurawski,54,2939400,8224110389817322,434,5839298,4386882,0,4386882
11639,Tareq Abdullah,29,4096400,5640425225629481,393,6511039,445476,0,445476
11640,Waleed Abdullah,30,1869500,7809514355785780,161,2549019,510256,51026,459230
11641,Samuel Abifade,31,803000,7282700132839688,149,1604316,1390043,1390043,0
11642,Amir Abrashi,30,528000,9505808394261207,91,873120,222524,223,222301
11643,Kevin Ackermann,57,2654700,8960420499712844,416,5439916,5168861,51689,5117172
11644,Brian Aguilar,70,2116900,8520201116212921,478,5429417,3964465,3965,3960500
11645,Sebastian Aigner,52,1953800,7147617072393171,303,3845920,2357281,2358,2354923
11646,Jack Aitchison,43,1605000,7829022142327472,260,2949669,1376504,138,1376366
11647,Lucas Akins,52,4873700,5560755261721360,608,8956855,7898689,7898689,0
11648,Ensar Aksakal,40,4804400,4270527821928935,522,8117849,7718717,0,7718717
11649,Awn Al Bishi,48,3921200,4983345193463191,473,6665242,922355,92236,830119
11650,Raid Al Ghamdi,47,1566000,4459257702433359,270,3254689,60941,0,60941
11651,Alaa Al Hajji,35,2365200,8645266058634377,274,3810443,870363,0,870363
11652,Ali Al Hamadi,49,2005600,3056972206918671,365,4341447,2610565,26106,2584459
11653,Abdullah Al Joui,48,3013300,6965173949097134,416,5813536,1348885,135,1348750
11654,Osama Al Khalaf,35,1879000,7876330668579560,223,2800163,2032006,203201,1828805
11655,Hamad Al Mansour,50,2542400,8747519126171558,395,4745299,1282724,128273,1154451
11656,Muteb Al Mufarrij,35,3047400,4437652949268977,332,5002798,4100149,410015,3690134
11657,Bandar Al Mutairi,69,3057700,4322782640054824,489,6409292,3743578,37436,3706142
11658,Ammar Al Najjar,23,4174500,7442177106076775,372,5871989,868373,86838,781535
11659,Saleh Al Qumayzi,66,708800,9855824280257768,345,3115627,667958,66796,601162
11660,Nader Al Sharari,35,3893800,6641661174559806,365,5660859,1979358,1980,1977378
11661,Hussain Al Shuwaysh,69,4517500,9348090803279534,603,8312273,3007404,3007404,0
11662,Ali Al Zaqan,54,3087800,4282156196570483,447,5635820,4834030,483403,4350627
11663,Flavio Alcedo,49,4423100,6488722216481273,501,7473637,1696923,16970,1679953
11664,Paolo Alcocer,31,2049500,8004580208232384,217,3334102,1307022,131,1306891
11665,Wessam Abou Ali,62,3792300,8828010508731159,502,7260013,677483,677483,0
11666,Hussein Ali,60,4326700,4328172006575154,657,8521766,3570954,358,3570596
11667,Ikromjon Alibaev,33,4176900,4281626196871787,429,6305165,710767,71077,639690
11668,Teddy Alloh,27,1416100,7145700820359096,147,1962053,1124157,1125,1123032
11669,Wildo Alonso,41,2344700,7426654912017736,277,4197423,3286362,329,3286033
11670,Rodri Alonso,28,1998400,5855926742035093,189,2829607,291677,292,291385
11671,Fran Álvarez,55,4117100,7782223395611382,499,7091483,2713401,2714,2710687
11672,Romeo Amane,57,3030500,5965672690654890,476,5943450,409718,0,409718
11673,Alfredo Amarilla,45,1441700,7355845229464278,262,3106636,2359489,235949,2123540
11674,Andrés Amaya,31,1342000,4757132845198824,153,1982094,419018,41902,377116
11675,Michael Ameyaw,53,2736900,8373869091339787,385,5099317,1153617,115362,1038255
11676,Simon Amin,56,3854500,4767201403691697,541,7747017,2901880,2902,2898978
11677,Mohamed Amsif,33,2969700,8214618404905311,301,4902729,2922247,2923,2919324
11678,Fredrik Andersson,66,3885400,4477900839511811,572,7701496,3106584,3106584,0
11679,Kikín,33,3338000,9277089944758456,304,4479569,3246435,3246435,0
11680,Prince Aning,53,4847100,9834462378446727,653,8865537,7466087,7467,7458620
11681,Niclas Anspach,57,4735400,5584546741508511,620,8995053,6599669,65997,6533672
11682,Terry Antonis,26,3679800,4773552353053037,371,5422340,3472073,3473,3468600
11683,Brian Anunga,49,774300,4410209346068890,254,2320135,2283146,0,2283146
11684,Louis Appéré,67,1765100,5263015403705871,407,4577104,3409479,3410,3406069
11685,Mateo Argüello,35,3340700,6281997379088144,327,5334185,2573594,0,2573594
11686,Carlo Armiento,27,1158700,8526825156008487,102,1492533,511855,0,511855
11687,Sinclair Armstrong,58,2794600,4009013114970560,461,5654088,2262642,227,2262415
11688,Dawid Arndt,33,1796500,3806985176577324,225,2981352,2596466,259647,2336819
11689,Zac Ashworth,31,4602300,5609682146143617,470,6884363,5369566,0,5369566
11690,Fisnik Asllani,25,302400,5702150415586780,62,379333,199912,19992,179920
11691,Jonathan Aspropotamitis,49,4768100,7741912264161043,543,8103792,4755420,4756,4750664
11692,Youssouf Assogba,40,2604000,8440762517045314,308,4503611,725760,72576,653184
11693,Josh Atencio,27,2419500,3736962828658929,248,3379776,263237,0,263237
11694,Víctor Aznar,65,3716400,4295002720679776,520,7282163,59341,59341,0
11695,Josef Brian Baccay,63,1294300,3992334469207175,365,3927014,3772684,37727,3734957
11696,Carlos Jatobá,42,1498000,4734689058725090,236,2783455,965922,965922,0
11697,Juraj Badelj,70,3657500,6845537295147375,623,8297800,7173826,717383,6456443
11698,Samy Baghdadi,36,1107400,6742690001030832,194,2089972,1482934,148294,1334640
11699,Jamal Bajandouh,22,1564000,3781550428334560,124,1999410,898502,89851,808651
11700,Krzysztof Bąkowski,34,1082600,7909257389833295,147,1852237,143886,143886,0
11701,Matan Baltaxa,25,3896400,9849417658465542,376,5880292,3378153,337816,3040337
11702,Samuel Bamba,22,4864700,3738669240269040,405,7560101,1038635,104,1038531
11703,Damon Bansais,55,4315500,8902202180115950,622,8019862,476622,0,476622
11704,Ezechiel Banzuzi,65,685400,3096814662025237,335,3029531,553494,0,553494
11705,Kosta Barbarouses,53,903400,4554523668085979,237,2472766,1532792,0,1532792
11706,Tommaso Barbieri,25,334200,3816260089363396,54,350545,283997,0,283997
11707,Sergio Barcia,60,4452500,6789028389332756,612,7741057,6959949,6959949,0
11708,Tom Barlow,49,2815000,8388680740636731,453,5503481,2928704,2928704,0
11709,Joselpho Barnes,46,662100,3261232881617149,223,2026056,664022,66403,597619
11710,Faustino Barone,67,4421800,3070751299669437,611,8772521,5452599,5452599,0
11711,Lachlan Barr,23,2058300,9641192681974754,155,2618076,918009,0,918009
11712,Nicolás Claudio Barrientos,33,486800,8141896763927081,83,681773,215681,215681,0
11713,Brian Jepthe Bayeye,61,2467900,9183568664502359,378,4540911,2980942,2980942,0
11714,Burak Bekaroğlu,46,1712700,4948162141768466,285,3480381,2560819,0,2560819
11715,Daouda Beleme,67,1926200,8814299013695652,418,4456060,443371,44338,399033
11716,Mouhamed Belkheir,33,2121000,8327504049498125,222,3489830,16406,16406,0
11717,Quentin Bena,32,1902000,6311990406217530,233,3091554,961140,96114,865026
11718,Ayman Benarous,40,1095500,6269135769934558,174,1861727,539460,0,539460
11719,Pedro Benito,63,3371000,7266274064127168,560,6960465,3886512,3886512,0
11720,Mal Benning,39,2491900,7084675372878333,320,4388750,3502547,350255,3152292
11721,Robbie Benson,57,1258700,9822536869612653,365,3495075,513635,51364,462271
11722,Alessandro Berardi,62,2237000,5952333116195925,423,5246963,3617647,361765,3255882
11723,Douglas Bergqvist,34,550000,7383347381094401,120,1098036,795100,0,795100
11724,Dominic Bernard,24,4676700,8009960760270844,391,6312806,5563146,0,5563146
11725,Hans Christian Bernat,70,4536600,5506491412120424,662,8993990,3390372,339038,3051334
11726,Ömer Beyaz,50,1103700,4558823001130764,282,2821928,848998,849,848149
11727,Bi Jinhao,36,1516200,5790104897611109,207,2438871,623607,0,623607
11728,Mika Biereth,69,415800,8431319636221980,276,2299907,191994,1920,190074
11729,Harrison Biggins,42,4157900,5259480782979236,441,6513785,731125,732,730393
11730,Emre Bilgin,38,2539500,8135069539860209,299,4362010,1407763,140777,1266986
11731,Noah Bischof,39,4531400,4052927705130642,489,7467369,2368605,237,2368368
11732,Parfait Bizoza,59,3553800,8957762001219980,549,6951063,5988036,598804,5389232
11733,Bjarki Steinn Bjarkason,46,1480200,7791832329458220,257,3037841,1880077,18801,1861276
11734,Fabio Blanco,64,1096500,9202817218525671,331,3351566,2921897,293,2921604
11735,Tino Blaž Lauš,42,1538400,8022796312614932,232,2812339,1822102,18222,1803880
11736,Davor Blažević,44,1097200,4939206506674105,189,2076104,1021202,0,1021202
11737,Xander Blomme,28,2980500,9718937412714234,311,4758359,3023955,3024,3020931
11738,Augustine Boakye,30,4346800,4970241943137369,389,6271535,5289567,529,5289038
11739,Hiram Boateng,62,515500,7960505523991662,289,2520576,1484877,149,1484728
11740,Benjamin Böckle,41,495900,9892328363620124,149,1228728,883498,0,883498
11741,Lamare Bogarde,47,4268500,4072428342451392,539,7833647,6591271,659128,5932143
11742,Florian Bohnert,48,3003500,8085022586503217,381,5139602,3850124,3851,3846273
11743,Pierre Bolchini,48,4263700,9341480946185180,488,6979967,2238819,22389,2216430
11744,Francesco Bombagi,22,2201200,6586438812341321,191,3169074,2735447,274,2735173
11745,Antonio Bordușanu,30,821500,3825801183969281,88,1008523,602181,603,601578
11746,Cameron Borthwick-Jackson,64,939500,5310786303670948,326,3198153,2273595,227360,2046235
11747,Subhasish Bose,25,4303700,9522711593243907,339,5808537,1468536,14686,1453850
11748,Mehdi Boudjemaa,60,3687200,7468632703764559,501,6350115,2260142,227,2259915
11749,Ryan Bowman,52,3921900,4115318192879801,550,7370290,5613187,5614,5607573
11750,Tom Bradbury,44,1336200,4661848158998857,265,3022451,2706192,271,2705921
11751,Mario Bratu,25,1486300,5378210837576629,137,1891360,451430,0,451430
11752,Maximilian Braune,42,1926500,5612359956148968,296,3640326,546994,0,546994
11753,Luuk Breedijk,29,2928600,7609869352013038,268,4250650,3669475,3669475,0
11754,Anthony Breslin,55,925000,8215768037499173,321,3133114,2874129,288,2873841
11755,Tom Brewitt,59,4571600,7635282489658541,618,8963494,2598537,259854,2338683
11756,Patrick Brough,48,2191800,5935627597797550,274,3591778,1523428,152343,1371085
11757,Corey Brown,59,1778900,7720325956064608,325,3906371,347090,0,347090
11758,Garry Buckley,58,603700,6527624732002959,265,2150068,2148020,215,2147805
11759,Omar Bugiel,38,2061700,5161576852192419,283,3745400,1865790,186579,1679211
11760,Trent Buhagiar,43,1999400,7772392964605196,281,3523364,1046619,10467,1036152
11761,Csaba Bukta,50,4244400,6628809544187571,479,6867235,1786867,179,1786688
11762,Liam Burt,61,2283700,8259195895171770,397,4782688,1098878,10989,1087889
11763,Alexander Busch,31,3805500,4541931861482295,378,5416592,3669173,0,3669173
11764,Ronald Bustos,47,2198400,7719146549214690,329,4265427,174272,174272,0
11765,Neill Byrne,33,1903100,9853981707464863,219,3141515,1357065,0,1357065
11766,Catriel Cabellos,60,411200,8712946136542360,274,2283120,1114442,11145,1103297
11767,Jorge Cabezudo,62,4010100,9650226644801006,521,6905272,596182,5962,590220
11768,Rodrigo Cabrera,31,2618400,3650659986336904,299,4509676,3084394,0,3084394
11769,Bryan Caicedo,45,3974500,9763489776954651,470,7175370,4672003,4672003,0
11770,Jake Cain,32,3820700,3759938914056065,411,6096876,5636458,5636458,0
11771,Carlos Calzadilla,46,4989200,9905408070674185,585,9219999,3524997,352500,3172497
11772,Mamadou Camara,40,1500300,4103321149965693,198,2412412,406718,0,406718
11773,Hady Camara,27,3449800,8922010040502693,333,5330497,1046943,104695,942248
11774,Sahmkou Camara,50,3355300,7053422102439603,437,5655018,4990660,4991,4985669
11775,Haroune Camara,43,3110000,3836637016516429,390,5176355,2868746,287,2868459
11776,Mamadi Camará,26,4690800,5951451558110420,387,6585299,922243,922243,0
11777,Axel Camblan,45,1283600,6606774686164527,231,2707209,1768615,0,1768615
11778,Augusto Cambón,53,4789500,6969991983001403,550,8408302,4640702,465,4640237
11779,Kyle Cameron,23,2555300,4474309779408528,205,3353092,2863097,286310,2576787
11780,Callum Camps,68,2717800,4118250394438417,472,6011382,960930,96093,864837
11781,Marco Camus,32,2258600,7108501874898005,211,3458102,1432177,1433,1430744
11782,Niall Canavan,57,521200,9658609623791659,274,2408300,549228,0,549228
11783,Cañizares,56,549900,5915055947712238,218,1873257,1850892,1851,1849041
11784,Alan Cantero,49,1427300,3505478334595038,298,3298182,2061845,20619,2041226
11785,Pedro Capó,66,4608900,5314274993982332,619,8468404,5171710,518,5171192
11786,Mustapha Carayol,29,2879500,4604143325521285,270,4310953,2793543,279355,2514188
11787,Tobias Carlsson,53,1999100,3271597020023797,360,4437732,212568,0,212568
11788,Amar Ćatić,64,3574300,7864775000530763,481,6859844,141256,0,141256
11789,Luke Chambers,39,1317600,4225847640082873,180,2400533,1651578,166,1651412
11790,Harry Chapman,57,3053300,5376877532096746,500,6453646,1621157,163,1620994
11791,Cheng Jin,35,3468100,3985747850602768,347,5507548,1561272,0,1561272
11792,Dennis Chessa,63,566100,3515416944659304,288,2603999,725151,0,725151
11793,Fabio Chiarodia,24,636800,4602329922896087,93,941495,416168,41617,374551
11794,Adam Chicksen,44,2257200,9071215108501398,337,4211975,4146585,4147,4142438
11795,Cho Hyun Taek,31,4339000,4115794086808113,433,7030543,281810,28181,253629
11796,Isaac Christie-Davies,36,1175200,7466763249436716,194,2216213,1239248,1240,1238008
11797,Riccardo Ciervo,26,818900,5300829547229706,90,1114742,91492,0,91492
11798,Marius Cioiu,53,4020000,4710827356719725,544,7550005,6449109,64492,6384617
11799,Geroge Cîrjan,50,2858400,8229609943474338,415,5782537,76471,765,75706
11800,Andrea Cisco,46,2025400,4239698919307091,296,3548090,2154728,0,2154728
11801,Juri Cisotti,69,796400,7358089241079435,343,3027236,2248125,225,2247900
11802,Ollie Clarke,55,1733200,6187350497917957,360,4110456,2139417,213942,1925475
11803,Reyes Cleary,62,4334400,9774798377216346,552,8365169,3140657,315,3140342
11804,Jack Clisby,58,4975900,8933832298931290,624,8664278,5709900,0,5709900
11805,Joel Coleman,34,4015000,3389413997277746,366,6329056,610450,0,610450
11806,Seámus Conneely,47,972000,4203500690772743,204,2071404,765110,7652,757458
11807,James Connolly,39,1497400,5438415190651276,221,2607544,1722181,17222,1704959
11808,Dion Conroy,70,1048900,8488896545161951,393,3749296,1565234,0,1565234
11809,Juan Córdova,40,2945100,9393835203995404,340,4785342,4131499,0,4131499
11810,Matías Córdova,50,4199700,4698057575283561,526,7577237,3546354,0,3546354
11811,Dean Cornelius,25,2162900,5252972188371750,197,2968368,1500116,1500116,0
11812,Milan Corryn,63,2196300,6329329981078050,478,5134497,613510,61351,552159
11813,Marijan Cosic,48,1369500,5064596501426893,292,3323951,923421,92343,831078
11814,Barry Cotter,66,2342900,4895467884527669,463,4957634,3066291,0,3066291
11815,Artur Craciun,30,1833500,8965772710508470,174,2741289,1135439,1135439,0
11816,Erico Cuello,34,893700,5473619618237562,144,1607623,1564526,157,1564369
11817,Giuseppe Cuomo,52,4497200,8551904852432959,563,7659054,6249198,62492,6186706
11818,Andy Dallas,47,2984100,4126439892709589,380,5277754,4308479,0,4308479
11819,Christian Dalle Mura,39,566900,3942237217431189,132,1176297,1041182,104119,937063
11820,Tom Dallison,57,605200,8612072013406288,272,2305360,1010013,1010013,0
11821,Robbie Deas,66,3702900,3078652081252711,585,7782152,6019954,6020,6013934
11822,del Cerro,25,4386400,3751228469339807,315,5667825,5155581,516,5155065
11823,Ryan Delaney,28,3413500,3758437648332132,306,4764293,418053,0,418053
11824,Fran Delgado,65,4397400,7117420208494900,585,8549979,638119,0,638119
11825,James Delianov,59,1154100,7316975009986422,323,3278881,2601025,2601025,0
11826,Enis Destan,41,4501700,3578775915501695,516,8256464,6063831,60639,6003192
11827,Mikey Devlin,57,1296600,4498879585935245,299,3015675,1363856,13639,1350217
11828,Fabio Di Michele Sanchez,63,2321600,7762420758574495,393,5094381,2240889,0,2240889
11829,Alan Di Pippa,61,3810300,5652660929676732,533,7262032,6669776,66698,6603078
11830,Lamine Diaby Fadiga,67,549600,8059974980531537,315,2461790,1176492,1177,1175315
11831,Moussa Diallo,32,1670300,5702362817975802,176,2565929,2006731,2007,2004724
11832,Carlos Díaz,51,3560700,9211132515181450,495,7077721,6849591,6849591,0
11833,Mawlanyaz Dilmurat,49,3999000,5553126813708452,478,6970054,5093196,510,5092686
11834,Filip Djukic,56,4009000,8513371687444778,498,6691568,5853767,0,5853767
11835,Ben Doak,33,4711200,8750218039549418,411,6792389,2770737,278,2770459
11836,Ronal Domínguez,37,3945600,3915930892450679,384,6106889,6059548,6059548,0
11837,Iago Domínguez,58,910500,7900273110846285,274,2473967,619307,620,618687
11838,Will Donkin,57,4908600,5397856244263609,589,8859503,5061033,0,5061033
11839,Jacky Donkor,60,3446500,3857800730094526,487,6626048,6410967,6410967,0
11840,Mario Dorgeles,31,2538700,3173794743360362,267,3976927,576225,57623,518602
11841,Jeriel Dorsett,36,4094100,7967022631162805,433,6489172,2650024,266,2649758
11842,Mamadou Doucouré,69,2246100,7905182000824196,432,5158840,2761642,277,2761365
11843,Achraf Douiri,64,2731500,6657077453025958,513,5950436,1820863,18209,1802654
11844,Cheick Doumbia,37,1447400,3664281743709891,180,2215893,78536,0,78536
11845,Damion Downs,65,1332700,6426419415892220,369,4012045,3356161,335617,3020544
11846,Jean Armel Drolè,27,4847700,8670387878131814,380,6341079,4387245,439,4386806
11847,Duan Liuyu,62,4534200,4241407793927505,582,7841889,7259627,726,7258901
11848,Edoardo Duca,28,1858000,3720800219832605,197,2639145,53943,53943,0
11849,Filip Dujmović,64,1828300,5138004695641037,353,4075003,3297063,0,3297063
11850,Andrei Dumiter,57,1890800,4769193210170299,328,3968591,1436506,1437,1435069
11851,Maksym Dyachuk,49,3784500,6437925533461316,436,6005342,4686423,4686423,0
11852,Xavier Dziekoński,46,4127900,7191204357017727,506,7813768,1052216,1053,1051163
11853,Jack Earing,64,4794700,6504775524045752,588,8007778,3782669,0,3782669
11854,Chinedu Ekene,49,2692300,5768032296468398,392,5325696,463943,463943,0
11855,Abu Bekir Ömer El Zein,63,855400,9803717919280367,319,2767747,1441804,144181,1297623
11856,Jordan Elsey,56,746900,8404865475038753,259,2482869,2021768,0,2021768
11857,Mihai Eșanu,55,379100,9880854167306842,257,1884505,503753,50376,453377
11858,Josué Escartin,65,4430100,6513864190089004,565,8498168,2958388,296,2958092
11859,Julius Eskesen,40,3497700,9126659654376752,414,6045701,530428,530428,0
11860,Marcelo Esponda,37,4962200,9213864562584059,508,8209238,2510671,2511,2508160
11861,Philip Fahrner,30,539900,7365253757549760,97,896478,691953,0,691953
11862,Josh Falkingham,60,4310700,5119233510310546,592,7517805,6679664,6679664,0
11863,Boubacar Fall,56,3867700,7368388372578050,500,7121751,3130700,314,3130386
11864,Oskar Fallenius,27,3883300,8856579219317814,331,5469097,4485283,44853,4440430
11865,Giacomo Faticanti,35,4273100,4890868321030400,477,6944052,474867,474867,0
11866,Khalil Fayad,25,1435600,7488563694446501,142,1977617,76525,0,76525
11867,Peque,66,1086500,9565166505608027,339,3292300,2767712,0,2767712
11868,Kevin Felida,39,2424200,3581969422680117,308,4187144,1237218,0,1237218
11869,Maciel,30,4638000,4059484666318608,403,6435893,4528013,0,4528013
11870,Feng Jin,38,1239400,8682439676563007,181,2149609,1136398,1136398,0
11871,Ryan Ferhaoui,28,390400,9493783778646525,48,361163,338882,3389,335493
11872,Mathias Fetsch,36,3395700,7843237457930247,326,4690953,3222467,323,3222144
11873,Ryan Flynn,60,2746100,8660507150629401,381,5286383,669033,0,669033
11874,Sam Foley,42,493700,4907274441940759,140,1281831,566176,0,566176
11875,Anthony Forde,25,3634100,8924801386205930,331,5230197,681446,0,681446
11876,Antonio Foti,24,4647200,8251798491726536,440,7101372,2621454,262146,2359308
11877,Matty Foulds,56,1176900,8527442479499083,296,3001684,117656,0,117656
11878,Tyrese Francois,35,4552400,9113125419174083,481,7049603,4149602,415,4149187
11879,Oscar Luigi Fraulo,28,3243800,8954474570739423,319,4903262,1445041,14451,1430590
11880,Nick Freeman,47,1191500,5554850511892611,248,2730043,223414,2235,221179
11881,Ethan Galbraith,31,3293600,3728606463478005,272,4874950,4096518,410,4096108
11882,Sean Gannon,39,1062900,7937675084899053,186,2098734,250533,250533,0
11883,Adrian Gantenbein,69,1817500,5350551672061423,426,4615191,4171769,0,4171769
11884,Ged Garner,27,1768000,3571079699121741,192,2809086,1305847,131,1305716
11885,Manu Garrido,49,2150400,7063191003720804,312,4020791,1598196,1599,1596597
11886,George Gavrilaș,36,2084000,4556622035819809,265,3623309,2767705,277,2767428
11887,Timur Gayret,61,3182000,7327744561761236,470,6162198,209192,2092,207100
11888,Jonas Gemmer,44,2043800,6469432147223025,300,3930408,1908497,1909,1906588
11889,Tiago José Geralnik,44,627400,4842712500800923,178,1617876,1006717,1006717,0
11890,Deniz Giafer,39,3436100,8225680312998567,375,5452723,1384676,1384676,0
11891,James Gibbons,37,2550600,7250553991813838,277,4267619,3546594,35466,3511128
11892,Diego Gil,53,2269700,5365080787261386,374,4434279,2212973,221298,1991675
11893,Alex Gilliead,69,2654600,6793447522355625,460,5701937,3590790,0,3590790
11894,Go Yo Han,53,4315000,7755835133050203,498,7424142,4659426,4660,4654766
11895,Go Moo Yul,44,3583000,8050698815303498,446,6392963,4127698,4128,4123570
11896,Alan Godoy,29,1662500,6554103042174927,169,2553393,1626433,1626433,0
11897,Udoka Godwin-Malife,25,2316000,3508611872485217,190,3295990,2988636,298864,2689772
11898,Taras Gomulka,52,4618100,8039449328329230,550,7869261,330917,0,330917
11899,Michael Gonçalves,24,4125900,7857883299715154,337,5634257,1451200,1452,1449748
11900,Federico González,56,2167400,5359984255592187,385,4565646,2466976,0,2466976
11901,Jorge González,61,2714700,6133921979860396,468,6003434,731788,732,731056
11902,Kaide Gordon,25,1023000,6472233231434492,74,1121938,77003,77003,0
11903,Felix Göttlicher,31,1781100,5407168263139693,181,2773586,2588806,0,2588806
11904,Tarik Gözüsirin,32,4992400,3210879929929895,400,7728270,1050467,106,1050361
11905,Gustav Granath,53,2311300,9984556595468056,327,4251553,2177277,217728,1959549
11906,Kieran Green,66,1898700,9007857570557968,436,4875479,4243307,424331,3818976
11907,Tom Grivosti,28,4633800,9598917218285451,370,6105067,2850213,285022,2565191
11908,Maximilian Großer,63,4609200,3232573917508968,580,8092494,2511585,25116,2486469
11909,Emin Grozdanic,67,4481400,4727373736047013,640,8968597,5983218,0,5983218
11910,Brajan Gruda,47,1270600,3372993234861375,243,2746413,1463724,146373,1317351
11911,Moussa Guel,42,1013400,8259284543059481,235,2293208,857665,858,856807
11912,Julen Jon,50,3559900,8417104620903357,434,6031380,3385322,0,3385322
11913,Abdoul Guiebre,68,934600,4259312426549099,387,3649626,1709672,0,1709672
11914,Gökhan Gül,37,3652700,6907732225811239,355,5610412,1272276,127228,1145048
11915,Lasse Günther,38,986400,3829321334069563,184,1993010,1570789,157079,1413710
11916,Göktan Gürpüz,44,634000,8052008996014996,149,1351705,1275546,12756,1262790
11917,Jesper Gustavsson,31,2940800,7939772865440058,310,4799446,1419580,1420,1418160
11918,Darko Gyabi,32,3161800,4581866215251966,294,4965537,3741899,0,3741899
11919,Zachary Hadji,45,3623200,5059293986546164,407,6285527,622857,622857,0
11920,Alexander Hahn,51,3289600,9164774960106140,418,5545815,1038282,10383,1027899
11921,Kreshnik Hajrizi,56,581300,6772848274457781,234,1905880,1371517,1372,1370145
11922,Lavdrim Hajrulahu,58,3007700,4570604103637671,477,5849422,1523164,1524,1521640
11923,Belal Halbouni,49,4340300,9494738881067222,591,7783165,1544409,1545,1542864
11924,Valon Hamdiu,24,1185800,9466959713596461,103,1468322,399568,399568,0
11925,George Harmon,41,595400,5750114547610907,152,1341303,64679,64679,0
11926,Herman Haugen,59,4481400,3800184093576799,605,8437857,8349739,8350,8341389
11927,Mike Hauptmeijer,39,851600,7713764534998812,161,1679789,628840,628840,0
11928,Jalen Hawkins,24,3454400,7499058642228599,248,4664132,3794301,3795,3790506
11929,Oliver Hawkins,69,3237700,8783161893836594,575,7264103,4866141,0,4866141
11930,Sanousi Hawsawi,58,3321400,8238273569532953,468,6057288,2577157,258,2576899
11931,Oscar Hedvall,27,2068900,8747948992543241,221,3202970,439034,4391,434643
11932,Aune Selland Heggebø,30,3081300,8043679914991096,269,4197454,3007134,300714,2706420
11933,Melker Heier,48,2629400,5698965847477023,386,4793511,4090887,410,4090477
11934,Heo Yul,35,314600,9105304237614211,118,900456,52551,0,52551
11935,Herrando,38,665200,6345233570481855,140,1311485,361488,0,361488
11936,Jose Herrera,45,2158100,9881548712318281,320,4251070,1122263,113,1122150
11937,Charles-Jesaja Herrmann,64,4461500,4080286805459904,606,8253326,6642784,0,6642784
11938,Luca Herrmann,52,3780600,8076122236421252,549,7148780,2003255,20033,1983222
11939,Felix Higl,37,2603700,7605521812377847,304,4100735,1639657,163966,1475691
11940,Benjamin Hjertstrand,57,1897500,9621449554181854,341,3990660,3989087,39891,3949196
11941,Kadir Hodžić,38,2180000,9102673830313276,299,4149719,1488507,148851,1339656
11942,Harrison Holgate,35,546000,6500999891272296,108,964871,890647,8907,881740
11943,Jake Hollman,27,2521900,7446063435595696,218,3452959,3255979,32560,3223419
11944,Gavan Holohan,37,2916600,6540213617133566,328,4523689,974519,975,973544
11945,Tomáš Holý,61,2426000,9837406672460872,399,5222503,5068038,506804,4561234
11946,Hong Si Hoo,57,597400,8494614144256245,274,2419322,852069,852069,0
11947,Seok-ju Hong,33,3968700,6040946617599165,375,5850347,5129198,5129198,0
11948,Nikolai Hopland,45,4234800,7171603652683534,505,7750966,5917083,0,5917083
11949,Eric Hottmann,60,2663800,8516047726323316,481,6238661,4602978,461,4602517
11950,Andréas Hountondji,66,2110300,8931619922733566,468,4899493,4694276,469428,4224848
11951,Kimmo Hovi,56,4030800,9525590327539669,547,7608600,2267688,2267688,0
11952,Hu Ruibao,51,3386100,6007789304375560,508,6309116,5694442,0,5694442
11953,Charlie Hughes,45,3533700,5217949708615479,417,5944229,1364769,13648,1351121
11954,Denver Hume,31,2411400,8217220637719961,290,4096070,3206017,3206017,0
11955,Ashley Hunter,37,3592000,4677529360459982,422,5906398,1809738,0,1809738
11956,Erik Hurtado,58,1702800,4382373839296966,377,4186231,2305292,0,2305292
11957,Isaac Hutchinson,63,4251500,5813479088480501,554,8049550,4180766,418077,3762689
11958,Hwang Jae Hwan,63,300200,3557938323891356,232,1670780,1318077,1318077,0
11959,Ellis Iandolo,30,4746700,7400796076747346,495,8027996,4713027,0,4713027
11960,Jibril Ibrahimi,59,4196200,4893435112910216,590,7554537,4888199,4888199,0
11961,Melih Ibrahimoglu,65,4342700,8788997704456202,635,8682578,4737839,0,4737839
11962,Zeno Ibsen Rossi,30,3682400,3973429923608869,349,5458430,1417188,141719,1275469
11963,Dejan Iliev,29,823100,9043541783281922,84,1088487,64437,6444,57993
11964,Burak İnce,57,3144900,6471446644856677,453,5954444,4436067,4437,4431630
11965,Garissone Innocent,33,3723400,9400182150486991,400,5802614,3178701,0,3178701
11966,Nestory Irankunda,60,3509800,4185351723935135,559,6544932,3552421,356,3552065
11967,Clint Irwin,66,4906800,9211413399880873,721,9187985,4291408,429141,3862267
11968,Ryotaro Ito,34,4185600,7297875414038928,464,6951717,3779596,377960,3401636
11969,Joey Jacobs,41,916400,3112961024110363,186,2072672,1497626,1497626,0
11970,Thomás,32,1478000,3815633156653268,175,2263009,2215054,22151,2192903
11971,Jordan James,48,4350800,5575821374449977,466,7075983,4622973,462298,4160675
11972,Dean James,68,3358700,9768401486074785,536,6530117,4867391,4868,4862523
11973,Jang Ho Ik,31,1674500,7781900735023675,204,2690213,852320,0,852320
11974,Alexandre Jankewitz,62,2887200,6157653222405438,445,5248462,5033640,5033640,0
11975,Lenn Jastremski,67,4162800,4825457262881167,619,8420611,7758594,7758594,0
11976,Jeon Jin Woo,24,1929200,8395601249306501,182,2771170,887441,887441,0
11977,Jeong Min Ki,40,2006000,3207058095327540,243,3451822,553921,0,553921
11978,Carlos Jiménez,55,4117000,8352756845217371,503,7049613,2150709,216,2150493
11979,Alexander Johansson,51,1990300,5663569204126814,326,3964192,2145396,0,2145396
11980,Herman Johansson,22,3400000,5068590115955517,237,4668439,2884967,28850,2856117
11981,Louis John,59,4973800,5982900939878976,630,8534607,7099013,7100,7091913
11982,Federico Jourdan,32,784100,6240782496398348,105,1179032,250743,25075,225668
11983,Jung Dong Yoon,46,1363500,8804821625727325,240,2815904,241809,0,241809
11984,Matthew Jurman,33,4237500,3334057847227701,368,6036792,4172561,418,4172143
11985,Mads Kaalund,50,3119700,4533234769374408,410,5622664,276753,0,276753
11986,Paul Kalambayi,62,616300,9639790932017084,280,2409189,360903,361,360542
11987,Abdoulaye Kamara,57,1298200,5767137235716287,274,2870600,2624940,2624940,0
11988,Majed Kanabah,67,3961400,5573619382751860,578,7371700,5352059,5352059,0
11989,Kang Yoon Seong,31,3457100,3501481656120945,337,5251784,5072821,0,5072821
11990,Silva Kani,68,4305000,3849436277612568,602,8161294,4850278,0,4850278
11991,Benjamin Kanuric,31,566600,8278474909391970,101,901536,337965,338,337627
11992,Andreas Karamanolis,60,4091400,9679482488415137,564,7637537,6973325,0,6973325
11993,Malte Karbstein,59,2842400,4962578984291923,400,5147712,3219873,32199,3187674
11994,Daniel Karlsbakk,44,2340600,5889678565594324,349,4328368,1987433,199,1987234
11995,Niklas Kastenhofer,49,3542100,5994326398749579,425,6116435,5105652,0,5105652
11996,Gökcan Kaya,63,776200,9871899514205676,332,3222299,1281758,1281758,0
11997,Bryang Kayo,59,4659100,9496684806586477,635,8755683,783564,7836,775728
11998,Joshua Kayode,37,2354300,5849080231984474,261,3583177,3541977,354198,3187779
11999,Conor Kearns,59,3361900,9398506180939310,525,7083911,7067889,706789,6361100
12000,Liam Kelly,54,1380400,8376924498131326,366,3576731,1514701,1515,1513186
12001,Cammy Kerr,65,1861700,6931616488305373,413,4850798,2954659,0,2954659
12002,Topi Keskinen,66,3346800,8002256339685122,474,6218113,5425124,5425124,0
12003,Saidou Khan,27,2838600,3640708833717475,246,4386879,68384,68384,0
12004,Kristoffer Khazeni,40,3962500,4771157680145803,426,6512179,1903399,19034,1884365
12005,Kim Ji Soo,29,3359300,6189228484344720,309,4618601,2886134,288614,2597520
12006,Kim Ju Chan,63,2331600,4746857255377646,466,5654846,2663060,0,2663060
12007,Kim Han Gil,56,1039400,3841733566136482,302,2997227,667889,668,667221
12008,Kim Jun Ho,30,3237600,6099839552344265,326,5019477,231820,23182,208638
12009,Liam Kinsella,69,3748400,4571721341991130,613,8005148,4912963,0,4912963
12010,Florian Kirschke,70,2669600,5504047682746782,556,6380770,5837171,0,5837171
12011,Colin Kleine-Bekel,70,2649700,5532015874785796,499,6048545,2410345,241035,2169310
12012,Niklas Klinger,30,3997000,5142038365131228,326,5625293,4399191,0,4399191
12013,Tobias Koch,45,3079000,5549680215640097,393,5444710,2417221,2417221,0
12014,Kevin Komar,57,4449400,6480411617535237,561,8072711,7970708,7971,7962737
12015,Vegard Kongsro,67,2349300,9091272331772279,466,4995770,2789264,0,2789264
12016,Yoan Koré,27,441100,3676498000437416,74,656105,609963,609963,0
12017,Kortajarena,54,4565700,6327924691430340,612,8484549,709719,0,709719
12018,Živko Kostadinović,55,2227700,5425742367084328,407,4807947,3144433,3145,3141288
12019,Elijah Krahn,41,1687100,9252523127185341,231,3066143,83932,8394,75538
12020,Anton Kralj,56,4725400,5244826322872169,618,7916968,5490253,550,5489703
12021,Oscar Krusnell,54,2390200,7041143841721870,379,4807333,3468339,347,3467992
12022,Noah Kruth,69,4447000,4147239855243149,655,8322626,6747760,0,6747760
12023,Garang Kuol,60,3232000,6187809884298804,491,6446991,4717162,472,4716690
12024,Kaan Kurt,22,1797500,4554433786074948,127,2290268,1767872,17679,1750193
12025,Kweon Han Jin,55,3889900,3721630744004270,519,7227796,4790897,0,4790897
12026,Omar Labrador,54,2716400,9530614141822837,377,4968631,3061933,0,3061933
12027,Ross Laidlaw,36,4104100,5525623003800296,438,6564028,3514243,35143,3479100
12028,Thor Lange,31,3488000,7642621672974521,346,5423888,1244498,1245,1243253
12029,Jack Lankester,62,2647200,5574279004422546,441,5315319,2254695,226,2254469
12030,Michael Lansing,30,2980300,9731616383776432,283,4070456,291387,29139,262248
12031,Lucas Laso,27,3253500,7008427443073718,309,4686027,688474,688474,0
12032,Marcel Lavinier,68,2923700,5025357589400533,527,6575583,4435474,4436,4431038
12033,Darragh Leahy,45,3072200,7286011466030942,409,5641786,2456330,245633,2210697
12034,Noé Lebreton,31,4131000,5509173430298098,422,7164698,1006676,101,1006575
12035,Lee Eu Ddeum,48,3086400,6515697453131762,422,5703513,3736049,374,3735675
12036,Lee Sang Ki,38,386400,8907684449696825,122,957720,432941,43295,389646
12037,Lee Jun,63,716200,6232001633256813,303,2745674,1560691,156070,1404621
12038,Lee Seung Mo,53,867900,3142865929706118,285,2656993,996904,0,996904
12039,Granit Lekaj,62,4888100,9243526797749414,643,9201684,7041820,7041820,0
12040,Alfie Lewis,34,3164400,6526482539485790,288,4823481,225390,0,225390
12041,Fedde Leysen,51,576200,4420501737163762,220,1909045,1086827,10869,1075958
12042,Li Tixiang,33,1391100,6120484031175878,173,2233436,611616,612,611004
12043,Daniel Lino,62,3830300,6532142470762607,564,7851117,1349174,135,1349039
12044,Elliott List,63,1019200,4703802750285603,339,3235598,1856702,1857,1854845
12045,Armani Little,28,369100,8156200387165029,50,358952,86594,866,85728
12046,Arian Llugiqi,30,4833500,8496242656500281,426,7386092,5274317,0,5274317
12047,Thimothée Lo-Tutala,45,1456900,4308053494076656,283,3130680,774721,774721,0
12048,Lucas Fabrizio Lopez,41,4359100,8228023878907820,501,7446387,1951484,1952,1949532
12049,Pablo López,63,555900,4764230744435313,281,2493317,860430,8605,851825
12050,Ariel López,65,3510600,9594473517412605,474,6332685,4077352,0,4077352
12051,Jean Louchet,64,2592600,8134665705865333,451,5317312,2357524,2358,2355166
12052,Donald Love,42,4998500,9821561782360160,513,7819532,3451532,0,3451532
12053,Lü Peng,44,381600,3519897166894226,184,1359416,903429,90343,813086
12054,Lü Haidong,36,3328300,4347482654460882,398,5650088,902305,902305,0
12055,Daniel Lucero,64,4691100,8624967477056801,686,9041154,1007927,1008,1006919
12056,Andreas Ludwig,50,4621300,5919956790893547,523,7578114,1038597,0,1038597
12057,Santiago Luján,63,310000,9677919400764819,271,2005945,126683,12669,114014
12058,Matty Lund,32,1582400,4364196157998313,213,2648409,2465975,0,2465975
12059,Yannis M'Bemba,38,2267000,6685677687387845,291,3789008,1503888,1504,1502384
12060,Calum MacDonald,44,696300,8721228556244237,178,1584423,1390094,0,1390094
12061,Daniel MacKay,70,3580600,8438019072942505,598,7474648,4769012,477,4768535
12062,Lukas MacNaughton,23,4345700,3374825434595179,354,6677838,4064563,406457,3658106
12063,Cammy MacPherson,36,4433400,3998282881602358,454,6648774,3054623,0,3054623
12064,Jacob Maddox,53,955700,3001149348400324,269,2592335,130865,13087,117778
12065,Eros Maddy,30,2634900,4240877386497745,260,4186390,773109,0,773109
12066,Tyler Magloire,39,2130800,8405023797098741,278,3689114,565094,0,565094
12067,John Mahon,59,1272600,7063039108159745,330,3403503,624177,6242,617935
12068,Philipp Maier,52,4383900,6179889195372581,500,7035854,4019758,402,4019356
12069,Kobbie Mainoo,66,1429600,4780611284503819,431,4566459,1493248,150,1493098
12070,Jordan Majchrzak,59,2486300,9932525761296210,448,5776791,4304903,0,4304903
12071,Ali Majrashi,69,2420400,7683415817453988,506,5346694,2724140,0,2724140
12072,Karim Mammar,64,1030100,7569215830340462,284,2914227,1072147,10722,1061425
12073,Aaron Manu,64,1719200,6007858004060370,413,4588423,4037260,403726,3633534
12074,Julián Marchioni,59,972500,9632736954889341,262,2447510,397975,397975,0
12075,Miguel Marí,62,2872500,7309298134855316,461,5804264,1916086,0,1916086
12076,Gustavo Marins,37,2795000,4474778041336513,320,4483856,396300,3963,392337
12077,Nathan Markelo,39,4359700,3614152434593931,413,6994902,2850243,286,2849957
12078,Ivaylo Markov,36,3071200,8257581809872672,387,5322017,467018,4671,462347
12079,John Marquis,67,4022600,9063124347740842,562,7598759,1645026,0,1645026
12080,Luís Mario Martínez,23,4790100,4023926865081541,388,7008382,6793501,0,6793501
12081,Francisco Martinicorena,45,2479300,9864132667048736,341,4750206,4109891,4109891,0
12082,Gavin Massey,57,4359400,7065053689023769,598,8400351,492246,492246,0
12083,Tawanda Maswanhise,35,1186000,8839205138416911,174,2216251,1474505,147451,1327054
12084,Max Mata,45,1927700,7508827298992618,279,3606026,2165114,217,2164897
12085,Jamille Matt,35,2036300,8405737110661253,225,3187234,1191730,120,1191610
12086,Jannik Mause,59,3041700,4216639231652723,459,6008204,2200648,2201,2198447
12087,Christian Mawissa Elebi,47,3970100,5947873994777797,454,6944522,5379160,0,5379160
12088,Luke Mbete,42,3514900,7459311024185395,346,5752955,2814443,28145,2786298
12089,Alfie McCalmont,66,3919700,3109594912541204,560,8070773,5390913,0,5390913
12090,Luke McCormick,38,2609000,5959903226475423,323,4330609,2683196,0,2683196
12091,Luke McGee,56,2762300,6347498436909552,423,5035857,3086548,3087,3083461
12092,Jordan McGhee,29,4815300,5835492133175114,384,7319668,4724303,4724303,0
12093,Nathan McGinley,57,2949700,7119121116263817,441,5784430,354754,354754,0
12094,Edward McGinty,27,1986800,4176460295399809,174,2517002,635433,635433,0
12095,Rory McKenzie,44,4986200,5627346721054266,532,8898883,6401248,6401248,0
12096,Robbie McKenzie,39,607400,5892413948202961,120,1094640,316613,0,316613
12097,Conor McMenamin,28,3840100,5156281831798423,358,5812430,3186561,319,3186242
12098,Gideon Mensah,50,2995200,9911183696504145,432,5806749,4254891,4255,4250636
12099,Leândro,67,2758300,7564547935079591,467,5689869,5340744,5340744,0
12100,Falko Michel,61,3912400,6177160413520172,537,7570936,667701,0,667701
12101,Nicholas Mickelson,47,583300,3290922125056935,194,1633881,1143663,1143663,0
12102,Michael Mieles,30,1111100,4751581469999783,145,1828320,484745,0,484745
12103,George Miller,42,3444200,5777454920138186,394,5949579,1386050,0,1386050
12104,Stanley Mills,44,852400,9486993047160462,214,2161858,978560,978560,0
12105,Jovan Milošević,24,3792100,8698978532241557,365,5848948,3734834,374,3734460
12106,Robert Milsom,25,938900,5826447049032537,100,1234283,638,0,638
12107,Jeison Mina,62,2798000,8945296257414697,406,5047528,1907017,19071,1887946
12108,Stefano Minelli,40,3338300,5284045001906904,402,6207984,4375458,0,4375458
12109,Filippo Missori,27,2911100,4924408914330309,247,4160388,2150216,216,2150000
12110,Kaito Mizuta,24,3744800,8808100035833812,308,5198930,2274365,22744,2251621
12111,Baran Mogultay,32,3445500,8480224756601245,343,5009687,4814192,482,4813710
12112,Iyad Mohamed,46,1375600,5285556165905977,246,2995022,876695,8767,867928
12113,Sylian Mokono,61,1974800,3204042475397129,419,4680086,4004790,4004790,0
12114,Luke Molyneux,24,2504000,3391240365103254,210,3148893,2086604,0,2086604
12115,Francis Momoh,60,4068400,7843064904159891,521,7117772,853369,854,852515
12116,Juan Camilo Moreno,67,1706300,5003001423302232,378,4066416,3276897,328,3276569
12117,Manu Morillo,36,2082900,3254623067183595,235,3536302,3440851,3440851,0
12118,Callum Morton,58,3083900,5598564457630517,468,5978808,2843984,0,2843984
12119,Ngal'ayel Mukau,39,4124200,3012501634983293,422,6554479,482898,0,482898
12120,Danny Mullen,32,1436000,3316922014650773,188,2441044,2217559,222,2217337
12121,Mun Ji Hwan,34,2052900,5897709278267600,246,3255528,741776,0,741776
12122,Alex Murphy,39,2635400,4844765657547141,311,4447753,4125304,0,4125304
12123,Jordan Murray,60,864600,3650511053963897,276,2510608,1596895,15969,1580926
12124,Simon Murray,31,3080600,3397191342343873,304,4461261,644404,0,644404
12125,Torben Müsel,70,2055500,8598267287569871,419,4865205,2992910,2993,2989917
12126,Danny Musovski,52,3222300,6944461568320809,439,5700028,1005705,1005705,0
12127,Ashley Nadesan,56,3280000,3667063792056342,497,6917491,271472,272,271200
12128,Suheyel Najar,64,2600900,3746952629944491,439,5094129,2494,2494,0
12129,Mark Natta,51,2506100,4073672155564894,399,5307656,3498406,34985,3463421
12130,Donald Nduka,51,3618400,5201074879792956,453,6337828,3914496,3915,3910581
12131,Nathan Ngoy,57,3960000,4437620275116814,536,7294837,7098244,709825,6388419
12132,Will Nightingale,60,4125800,4610039598175453,571,7376069,6679562,6680,6672882
12133,Bilal Njie,29,642200,8666108013542100,99,1022776,112713,11272,101441
12134,Dan Nlundulu,61,3965500,7820205440788139,533,7701876,6321468,0,6321468
12135,Luke Norris,57,812000,9319341472136300,277,2656931,1216506,0,1216506
12136,Lucas Noubi,22,680200,4966904422077307,55,631904,139097,1391,137706
12137,Amin Nouri,56,645500,5842817903425798,223,1989478,1852005,1853,1850152
12138,Krystian Nowak,67,1667100,6333662092216158,420,4401641,3904953,3904953,0
12139,Patrick Nwadike,69,4007300,3921516987160556,546,7407152,7100461,7100461,0
12140,Silas Nwankwo,38,4257100,7601210787913220,456,6882603,480210,0,480210
12141,Moses Nyeman,48,4806300,6229003658483533,481,7110714,4909986,4909986,0
12142,Lee O'Connor,42,766100,5635213839346285,159,1542225,23424,2343,21081
12143,Tomás O'Connor,35,441400,9480646066258102,121,971414,84835,8484,76351
12144,Richard O'Donnell,40,2293000,3842269972645720,312,4269302,1834252,184,1834068
12145,Jonathan Obika,69,3907500,3251237364783661,605,8008075,6339731,6340,6333391
12146,Marvin Obuz,58,2696400,6853336344371509,455,6003609,1778358,0,1778358
12147,Kristoffer Ødemarksbakken,35,759100,3206848342336263,129,1284053,200627,2007,198620
12148,Akin Odimayo,29,1712500,7341215397346268,156,2554112,279509,2796,276713
12149,Clarke Oduor,33,3814600,7523018171218580,403,6005003,2836017,283602,2552415
12150,Luke Offord,64,4756500,3947250782006868,618,8165270,3697542,36976,3660566
12151,Oh Jae Suk,50,512200,5545238350868056,211,1786630,1786569,17866,1768703
12152,Fejiri Okenabirhie,34,3041300,9219314057598163,338,5081474,749719,0,749719
12153,Isaac Olaofe,67,3298600,6541086431805302,541,7153793,2533662,253367,2280295
12154,Vadaine Oliver,53,723300,8734128662433024,276,2478955,721546,7216,714330
12155,Tuomas Ollila,54,3924400,7960082655972121,550,7610714,6489131,649,6488482
12156,Joseph Olowu,24,966900,5559993290348224,73,1050008,782944,0,782944
12157,Promise Omochere,28,4195200,7735807504014323,399,6748507,2507455,25075,2482380
12158,Wyatt Omsberg,52,3879200,3388379501083306,496,6973584,1898592,1899,1896693
12159,Luis Ortíz,60,4737600,4422220211377257,622,8395309,7789359,7789359,0
12160,Pedro Ortiz,45,3509300,8896820917144748,414,5622890,5457319,546,5456773
12161,Robin Østrøm,43,2758000,8366452589878032,318,4628571,2851971,28520,2823451
12162,Shaibou Oubeyapwa,22,2698600,7582451669135318,229,3789128,238664,0,238664
12163,Doğukan Özkan,28,4080600,9872861261101343,322,5698431,1604208,1604208,0
12164,Pacheco,40,1447900,3111899187352981,254,2772511,1281109,1282,1279827
12165,Álex Padilla,50,4943300,9500552204688102,577,9065946,7882215,788222,7093993
12166,Lucas Paes,36,4583300,8844085570631483,518,7752851,5138240,0,5138240
12167,Yannick Pandor,64,3408300,9695012545689189,506,6604050,2719276,2720,2716556
12168,Park Jung Bin,52,3013100,6862868328210709,392,5217514,2200913,220092,1980821
12169,Alfonso Pastor,39,2264900,4569033320895248,284,3905587,906116,906116,0
12170,Tim Paterok,60,4867800,5151377879292317,627,8879175,2962861,296287,2666574
12171,Omari Patrick,37,3801600,6880386562313772,399,6249750,4123326,0,4123326
12172,Maxime Pattier,43,1040700,5006435306294898,193,2090255,825602,0,825602
12173,Tim Payne,49,4362500,7848843389869430,550,8142246,5320364,0,5320364
12174,Alex Pearce,47,2244100,4936662905124478,327,4297974,2579936,257994,2321942
12175,Mateo Pellegrino,38,3928700,9146012506466118,382,5699749,3463933,3463933,0
12176,Nicholas Pennington,58,1492600,5111027234649838,379,3878023,2106290,0,2106290
12177,Grenddy Perozo,66,548300,3726639249865005,294,2598070,571171,0,571171
12178,Kévin Perrot,54,2794500,9095382444462217,377,5101441,4224128,0,4224128
12179,Taylor Perry,43,2358000,7350957124559506,308,3959883,3598480,360,3598120
12180,Noah Persson,26,4758000,8610492102269557,403,6554034,62265,0,62265
12181,Andrei Peteleu,55,4207600,6799634877229523,523,7427734,5050535,50506,5000029
12182,Oliver Petersen,57,3046100,7334041945815600,437,5876936,3519205,351921,3167284
12183,Luca Petrasso,44,556400,9974016938464736,186,1670190,51350,5135,46215
12184,Dylan Pierias,41,301400,7322951164571620,158,1169701,456327,0,456327
12185,Ignacio Pintos,68,4100700,8443363103257298,612,8032583,848186,0,848186
12186,Lenny Pirringuel,63,3087200,8704771013904168,513,6589879,5164020,516402,4647618
12187,Luke Plange,34,4026000,4473841217310262,417,6414703,1564520,1565,1562955
12188,Sandro Plechaty,45,2713300,3948498052633167,343,5046154,2909221,2909221,0
12189,Marco Pompetti,23,4238100,8581765304600400,329,5992443,255878,25588,230290
12190,Vlad Pop,53,4985200,8189227185327291,584,8866175,2969157,0,2969157
12191,Alexandar Popović,62,1073400,6066880026927994,371,3572867,3050122,0,3050122
12192,Darren Pratley,59,3533600,8014308075509660,542,7094252,6302112,631,6301481
12193,Aaron Pressley,68,2490100,3312409534741843,472,5302578,3395461,3395461,0
12194,Bjarne Pudel,38,4541600,5628796673291108,415,6477269,2382684,23827,2358857
12195,Jarell Quansah,23,2993600,9625877625169827,250,4392890,3739479,3740,3735739
12196,Javier Quiroz,37,3801400,7129359612109591,451,6294300,1757129,176,1756953
12197,Sidney Raebiger,58,541300,7062289738295080,273,2181975,713173,71318,641855
12198,Santiago Ramos Mingo,23,4204400,7937764200436610,348,6036881,1658996,16590,1642406
12199,Jonathan Rasheed,67,327600,6466807814488658,255,1948195,276555,2766,273789
12200,Petar Ratkov,31,3418900,8172460336197072,315,5433973,431297,4313,426984
12201,George Ray,33,2426800,8181322353840010,282,3833832,193567,193567,0
12202,Recasens,65,1279800,9082978203222262,428,4355727,860200,8602,851598
12203,Maxence Renoud,52,4099400,3599694564404139,506,7181866,2466580,24666,2441914
12204,Paulo Retre,28,2953300,9434060762055970,277,4422799,866467,0,866467
12205,Jayden Richardson,48,2669500,7264736847218629,352,5098824,4875824,4876,4870948
12206,Nico Rieble,52,2141900,9916749981029767,351,4262610,2744168,0,2744168
12207,Joe Riley,38,1629000,9042717721352244,211,2618630,1676712,0,1676712
12208,Damian Rivera,63,1829000,6698778297825575,389,4449757,1432576,144,1432432
12209,Jamie Robson,34,4891600,6286723830669974,497,7995598,4851365,0,4851365
12210,Joel Roca,48,320000,7018114151497291,196,1606634,950972,950972,0
12211,Álvaro,28,973100,3637063963505065,96,1229371,710259,0,710259
12212,Oliver Rojas,69,2184900,6378105536899540,461,5253349,4858334,4858334,0
12213,Fernando Román,42,2054500,7917523483557020,340,4076480,1547052,155,1546897
12214,Jhohan Romaña,44,4199000,7025778498482710,472,7279654,414168,0,414168
12215,Moritz Römling,40,1816200,5328379244943366,241,2950249,162308,16231,146077
12216,Tuur Rommens,66,1273600,6792417620419808,315,3103672,1026582,1026582,0
12217,Imad Rondić,55,1979600,6165772993566708,334,3939055,2739538,0,2739538
12218,Henry Rorig,26,2203000,8581703786172151,210,3103096,3029477,3029477,0
12219,Colin Rösler,33,581600,9571263083760246,90,872026,99506,9951,89555
12220,Tommy Rowe,55,3003600,3905068136627217,429,5760870,4199455,0,4199455
12221,Tobías Rubio,37,2976600,8853970242939916,339,5220802,1729380,0,1729380
12222,Morten Rüdiger,24,2248700,9404703744307394,220,3429125,393961,0,393961
12223,Alex Rufer,49,2768900,8016822512783896,352,4891878,44856,0,44856
12224,Morten Sætra,25,2140900,8772107948695201,182,2787670,2263978,2263978,0
12225,Andrea Sala,70,4818300,8081003096557633,611,8340263,6728970,67290,6661680
12226,Enes Sali,68,1035500,4089798258206877,339,3403293,2743101,274311,2468790
12227,Emiliano Saliadarre,62,4971200,6277853072392637,614,8197231,7424027,74241,7349786
12228,Justin Salmon,56,3957400,4850366158855498,476,7060351,2739528,0,2739528
12229,Hugo Salvatierra,64,2777900,4208057183057249,463,5636831,4956537,4957,4951580
12230,Nicolas Samayoa,46,3663700,7731587177097012,430,6056964,461811,461811,0
12231,Lucas Sanabria,25,3310400,5588090872740448,309,4539750,1831891,1832,1830059
12232,Theo Sander,65,3803900,8149561601682574,589,7149591,6027421,6027421,0
12233,Will Sands,53,3738100,7497688326484377,477,6576801,3657625,36577,3621048
12234,Mohammed Sangare,46,1452200,6936481840164379,270,2937586,285389,285389,0
12235,Jorge Sanguina,34,2484200,9902882276085578,263,4026325,3379853,338,3379515
12236,Antoni Sarcevic,41,4263200,5781716275798634,500,7623624,5715113,0,5715113
12237,Mouhamadou Sarr,54,592500,4587034950318152,204,1913163,1722098,173,1721925
12238,Charlie Savage,34,1959600,6959519239321022,255,3375503,2184359,21844,2162515
12239,Nicolas Schmid,33,2541800,7628979335677488,280,3933150,2578846,25789,2553057
12240,Randy Schneider,47,2447900,3311139173525017,368,4349898,4025667,4025667,0
12241,Jan-Marc Schneider,47,3405900,8009929453805528,369,5757184,2593505,25936,2567569
12242,Ryan Schofield,35,4910700,5478457292813212,486,7177209,6508866,650887,5857979
12243,Youri Schoonderwaldt,32,2588000,4414788000957767,253,3842398,1279967,1280,1278687
12244,Oscar Schwartau,63,3249000,3544261184061942,536,6980590,510961,0,510961
12245,Jan Sedlak,56,3384500,8203407938100714,472,6302871,3715541,37156,3678385
12246,Lion Semić,34,4839200,6838693795722006,409,6885796,6619629,661963,5957666
12247,Luis Sequeira,51,2118400,9059801009683750,370,4622390,4398439,0,4398439
12248,Javi Serrano,60,2003100,8930600346084045,409,4739106,76221,0,76221
12249,Zidan Sertdemir,57,3086000,8844383147621135,443,5781564,930606,930606,0
12250,Mohammed Shaker,56,2675200,5315167626341050,370,4814994,331734,332,331402
12251,Shao Puliang,30,4090900,8854662777629508,328,5531598,3294920,329492,2965428
12252,Khiry Shelton,24,2398800,8124092289825798,220,3629876,3448220,345,3447875
12253,Liam Shephard,40,771700,8483232630308615,178,1612674,521363,521363,0
12254,Sam Sherring,69,379300,4312751469924662,306,2439585,2121304,0,2121304
12255,Connor Shields,70,786600,3640487290873268,327,2895232,1972063,198,1971865
12256,Shin Kwang Hoon,56,1049600,4143417173732097,318,3018860,497773,498,497275
12257,Shola Shoretire,30,3734100,7183094700555775,332,5258827,4046949,4046949,0
12258,Patryk Sikora,66,3905300,9170823829763591,610,8095448,510271,5103,505168
12259,Matías Silva,30,2774900,7210008495375638,260,3976039,72769,7277,65492
12260,Tomás Silva,69,676900,5478310372871975,324,2895010,1012556,10126,1002430
12261,Gonzalo Silva,31,1623300,9039208886214870,170,2311875,1993626,199363,1794263
12262,Tomás Sives,59,2856900,6683788768871700,448,5258935,2067682,2068,2065614
12263,Stefan Škrbo,29,4261600,9757178201113480,421,6661620,3542655,0,3542655
12264,Maciej Śliwa,44,481000,4131987150520762,184,1578936,1154646,11547,1143099
12265,Greg Sloggett,49,922300,5233450523094749,238,2525180,1753984,0,1753984
12266,Rijad Smajić,24,687200,4820185325713582,80,857420,781405,78141,703264
12267,Matte Smets,40,978400,8576044554117928,173,1818382,391682,392,391290
12268,Will Smith,64,4242000,9386403287746408,607,8068002,7804789,0,7804789
12269,Tyler Smith,63,1000000,3290349728445848,307,2724882,1336273,1337,1334936
12270,Kacper Smoliński,57,3881600,3281460635444263,568,7858679,1348646,134865,1213781
12271,Noah Söderberg,39,3370700,6274053692658522,390,5691087,3523704,0,3523704
12272,Daniele Sommariva,68,306200,5551189229920599,324,2618430,1045064,105,1044959
12273,Matías Soria,67,1045900,7969988396695426,357,3281805,924970,925,924045
12274,Alan Sosa,46,3372400,7106896362074179,406,5556649,3623508,36236,3587272
12275,Jaushua Sotirio,64,330200,8270135300871723,281,2344352,988683,98869,889814
12276,Pedro Souto,60,3361800,9941367219666454,476,6117764,3673628,367363,3306265
12277,Adam Stejskal,38,2430000,3598591764568904,283,3666239,1632910,0,1632910
12278,Jamie Sterry,69,1783100,5515980676127812,431,4619122,4270435,0,4270435
12279,Jack Stevens,70,2729100,9717289254302543,451,5995068,2156700,2157,2154543
12280,Layton Stewart,51,1668100,4254639937718853,295,3219204,2969948,296995,2672953
12281,Manuel Stiefler,67,908500,3702122265017410,333,2961106,161115,161115,0
12282,Ianis Stoica,60,2862900,4282855920283489,501,6045725,401267,401267,0
12283,Chris Stokes,33,2623500,5010236008510570,269,3781812,2241331,224134,2017197
12284,Aidan Stone,39,4193100,3495006130226989,460,7110034,6773503,678,6772825
12285,Ignacio Suárez,66,4327700,7525014243016953,566,7303653,1388042,1388042,0
12286,Quinn Sullivan,31,2947300,5695410831535556,299,4821215,2021821,20219,2001602
12287,Levi Sutton,30,3451800,4031263283402997,308,5224024,1983840,1983840,0
12288,Mario Šuver,34,4402200,5239023870940573,376,6680795,2028728,0,2028728
12289,Zion Suzuki,61,4011000,7095617728988861,526,7025294,4793419,480,4792939
12290,Will Swan,26,3170400,9549034723802730,245,4150146,668378,0,668378
12291,Jayden Sweeney,70,509200,6677659293458286,377,2984229,1796411,179642,1616769
12292,Serafin Szota,27,1940600,4951814826672808,187,2892175,2725986,273,2725713
12293,Remigiusz Szywacz,36,4577200,7903817110405031,499,7527580,1292216,1292216,0
12294,James Talbot,53,2879600,7666451441380238,430,5521315,1981545,198155,1783390
12295,Jakob Tånnander,30,3588400,5306818317466923,303,5013238,721748,722,721026
12296,Sidnei Tavares,29,4000100,8932266250638767,379,6139227,3486157,3486157,0
12297,Jake Taylor,69,1962200,9288018091025320,420,4851762,2008556,0,2008556
12298,Richard Taylor,57,1324000,5560048183111124,343,3688083,1245338,125,1245213
12299,Franklin Tebo Uchenna,42,4470200,7482382392022274,520,7487699,612856,0,612856
12300,Semir Telalovic,35,2280100,4143209870963292,238,3548072,788662,78867,709795
12301,Dragoș Tescan,38,819200,5393068830438139,166,1614735,1062873,1062873,0
12302,Anirudh Thapa,50,2076600,7420567833167010,371,4460697,1846504,185,1846319
12303,Doug Tharme,47,2765500,8660994427381213,369,4954690,1241430,0,1241430
12304,Conor Thomas,47,1857600,5742016780241473,283,3496387,2715073,27151,2687922
12305,George Thomson,58,513100,9774242639937787,249,2054286,689366,0,689366
12306,Răzvan Tincu,40,1998100,7093693678973017,257,3323058,1741079,174108,1566971
12307,Mohammed Tolba,61,1515200,5699822836040448,359,3712918,3006076,300608,2705468
12308,Jonathan Tomkinson,44,1532300,3102924730650784,233,2824554,972311,973,971338
12309,Joe Tomlinson,54,2733600,6863435807580115,412,5494453,4923918,493,4923425
12310,Ruon Tongyik,64,4174200,8410989643755196,527,7468184,5265758,5265758,0
12311,Noel Törnqvist,56,3325100,7140669122397201,462,6490910,1154656,0,1154656
12312,Richie Towell,28,352900,7533120660052256,85,590360,225763,22577,203186
12313,Lisandru Tramoni,55,2399200,4489093761028643,395,4662344,406232,407,405825
12314,Brahim Traoré,40,4997700,8659386089327472,534,8045149,3978379,3979,3974400
12315,Chaka Traorè,66,3458800,3014050246313103,638,7514453,2740132,2741,2737391
12316,Rafa Tresaco,64,1882400,9627083094609166,380,4244337,2079906,2080,2077826
12317,Nicolò Tresoldi,53,1353000,9248265194304882,271,2967848,2151079,21511,2129568
12318,Ryan Trevitt,39,1531800,4588478325067876,215,2636156,2313941,0,2313941
12319,Driss Trichard,70,2242300,9175481409718406,474,5573045,3526912,353,3526559
12320,Antonis Tsiftsis,68,3085500,3464137829765188,507,6185339,3867676,38677,3828999
12321,Marinos Tzionis,52,3545800,6377659793963243,489,6372497,2130841,0,2130841
12322,Thor Úlfarsson,42,3035700,9805134730509746,360,5251424,515943,515943,0
12323,Victor Ulloa,28,905100,7047395234329917,129,1461844,919250,91925,827325
12324,Lukas Ullrich,66,1851300,9083104168608784,390,4329767,3384167,3384167,0
12325,Tariq Uwakwe,34,301600,3311082559983327,106,741205,361372,362,361010
12326,Tommi Vaiho,54,4372000,6166710812904222,573,8256872,4242792,0,4242792
12327,Gonzalo Valdivia,56,4481600,8811036902790391,542,8401517,271185,27119,244066
12328,Iván Valenzuela,25,769900,9116780727757539,100,1189227,551800,551800,0
12329,Gustavo Vargas,39,2999500,5210869217306119,345,5049070,3462470,346247,3116223
12330,Nikola Vasic,43,4046000,6831874129610115,481,6872647,6537633,6537633,0
12331,Agustín Vera,26,586300,3840763696665646,67,689076,511177,5112,506065
12332,Charles Vernam,53,1242200,3794330541679554,328,3405368,3156407,31565,3124842
12333,Pau Víctor,44,4114700,8869078088656715,430,6632690,5477048,0,5477048
12334,Dewar Victoria,34,2789000,5670698623471334,287,4420134,877219,0,877219
12335,Mauro Vigorito,60,3884400,8128846522389635,532,7107843,860682,8607,852075
12336,Alexis Villa,59,709700,8175976808475447,288,2374381,334974,335,334639
12337,Anderson Villacorta,47,2449000,4372381036513664,354,4219485,2776140,0,2776140
12338,Agustín Villalobos,65,949300,9956351716196322,343,3117985,1280167,1280167,0
12339,Jaime Villamil,61,4673500,7487345562256142,693,8795692,7022967,7022967,0
12340,Charlie Vindehall,69,3234400,9357300836711645,561,6882153,697808,697808,0
12341,Bohdan Viunnyk,32,1701600,5754566033836133,192,2650121,1209891,0,1209891
12342,Jakub Vojtuš,23,459800,3164184629126736,43,408184,323919,0,323919
12343,Jake Vokins,51,4303700,8301395889481297,510,7732424,2018853,202,2018651
12344,Leonardo Vonić,67,1278000,9457865980452970,384,4019961,3386034,3387,3382647
12345,Luka Vrbančić,67,841200,8354506707896293,326,3119964,850944,8510,842434
12346,Abdelwahed Wahib,57,3532800,5760580198992586,476,6462287,5307829,531,5307298
12347,Dennis Waidner,38,2476300,8789810453156654,335,4452208,3822956,0,3822956
12348,Jacob Wakeling,64,2188300,3675988287464999,455,5328860,764918,764918,0
12349,Lukas Wallner,66,369000,5399205469276455,314,2553714,41751,41751,0
12350,Wang Guoming,51,2800500,6730030802408853,384,5351109,2403342,0,2403342
12351,Wang Haijian,49,1690300,4679756189201110,294,3508234,602029,0,602029
12352,Tyrell Warren,48,1700200,7201285020619705,315,3562882,2909227,2909227,0
12353,Lukas Watkowiak,38,3617300,3052560618441018,394,5920134,4395439,439544,3955895
12354,Louie Watson,54,2126800,3458743810274297,364,4429029,3191779,0,3191779
12355,Dylan Watts,32,341300,7426932682906590,101,773318,736617,736617,0
12356,Gerrit Wegkamp,44,528300,4146816233961416,211,1865832,79130,0,79130
12357,Timon Weiner,56,896100,8124022909683151,274,2472969,2199025,220,2198805
12358,Max Weiß,59,4199300,5050100717203974,527,7436768,4983732,4983732,0
12359,Josef Welzmüller,65,1625100,4789975151760346,368,4211372,160848,1609,159239
12360,Marcel Wenig,56,1302000,8776564927689057,357,3501365,463205,0,463205
12361,Magnus Westergaard,45,848500,5226121106246447,214,2089435,1264997,1264997,0
12362,Harvey White,39,435200,7555773546019329,168,1410636,185004,186,184818
12363,Tom White,55,3525400,3999967182207844,483,6807741,1033678,104,1033574
12364,Jannes Wieckhoff,26,1702900,7529978332509193,175,2488338,1629546,163,1629383
12365,Conor Wilkinson,56,4636800,8398091304797557,563,8263994,6129963,6129963,0
12366,Loïc Williams,25,3454300,5072509131431227,259,4831361,619786,619786,0
12367,Roan Wilson,67,2429700,8602400389633440,444,5114927,3466627,0,3466627
12368,Fabian Windhager,25,1373300,3497259266572728,93,1653582,468226,468226,0
12369,Felix Vrede Winther,41,3851200,8221629604134588,417,6089280,1225645,122565,1103080
12370,Łukasz Wolsztyński,24,3964300,4844172121636104,344,5999973,2914577,2914577,0
12371,Gary Woods,28,2778200,5548522142638268,271,3903033,939477,93948,845529
12372,Joscha Wosz,49,2656100,4231231952550962,337,4630628,2314379,2314379,0
12373,Arkadiusz Woźniak,62,3655800,4375612344773271,561,7430991,1416799,141680,1275119
12374,D'Margio Wright-Phillips,50,2308100,8208556647699613,325,4548764,2960867,296087,2664780
12375,Xu Jiamin,69,371500,5981354166808753,316,2563157,1854010,1855,1852155
12376,François Yabré,46,1090200,6888563610571782,245,2498336,2194630,21947,2172683
12377,Yang Kuo,23,391600,8830670049415128,39,287601,98888,989,97899
12378,Yang Xiaotian,61,3895700,8113925276895031,516,6820679,1373410,0,1373410
12379,Yang Hyung Mo,47,820800,6344639974227351,216,2104797,2045317,2045317,0
12380,Yang Yun,47,3802100,3932260520923280,513,6881176,1418408,0,1418408
12381,Kusini Yengi,62,1708700,6440171100416682,354,3676905,706025,70603,635422
12382,Yi Teng,47,3506600,5870743886189792,447,6120155,4405639,0,4405639
12383,Yu Je Ho,33,4401000,6910320081720163,390,6816842,6525937,652594,5873343
12384,Yu Yang,25,1318300,6935426767284122,160,2035919,1314622,1314622,0
12385,Hampus Zackrisson,22,854600,8472324542729243,34,708829,564093,0,564093
12386,Kamil Zapolnik,70,4010800,4147876341684188,546,7643083,6417569,6417569,0
12387,Eriq Zavaleta,30,1745200,5999874477525172,195,2701950,2533515,25336,2508179
12388,Lequincio Zeefuik,70,1476000,8273628808550267,410,4114744,170536,17054,153482
12389,Ajdin Zeljković,64,2340200,7102055324737391,466,5337190,1922000,192200,1729800
12390,Nathan Zézé,57,2935900,6826937373011958,435,5528775,2041230,0,2041230
12391,Zhang Wei,44,4141900,4920576691291561,496,7483003,4775428,0,4775428
12392,Zhang Xiaobin,57,2363700,8156736338782244,405,4703325,3832684,3833,3828851
12393,Zhang Yan,42,1538200,5255350074740547,230,2824255,1715693,172,1715521
12394,Zhang Chi,29,2805300,4678178026244151,270,4521690,3888490,0,3888490
12395,Milen Zhelev,54,1340200,8302805259186751,284,2939087,1997578,19976,1977602
12396,Zheng Dalun,23,2797700,5530047993448969,248,3845655,513009,0,513009
12397,Diego Živulić,35,4482700,3265766575742221,475,7403713,6842345,0,6842345
12398,Marcel Zylla,57,1065900,6999304272453539,314,3149415,2121712,2122,2119590
12399,Mohammed Abbas,65,750100,6317750556836752,296,2537937,1730543,17306,1713237
12400,Amir Abdijanovic,49,800000,6425522578067857,198,1901742,1580051,15801,1564250
12401,Abduhamit Abdugheni,46,4468400,5978899953338551,500,7352833,2803188,0,2803188
12402,Alexander Abrahamsson,37,355300,9971965083238235,100,781743,573480,57348,516132
12403,Miguel Acosta,23,2937900,3308088355167607,261,4043536,1670895,168,1670727
12404,Matthew Acton,63,2417400,5387842984786014,463,5503896,580280,0,580280
12405,Daniel Adamczyk,23,856600,6847676743494957,55,777975,641975,6420,635555
12406,Rafał Adamski,28,2175700,7961974413893783,179,3148158,1781271,1781271,0
12407,Aske Adelgaard,46,4242900,9313938696296844,495,6981717,2437039,24371,2412668
12408,Michel Ndary Adopo,70,1795200,3345143946799157,496,5401450,63510,6351,57159
12409,Joe-Loïc Affamah,43,4938400,8054121922295159,504,7780065,5621859,563,5621296
12410,Lalo Aguilar,67,4797500,9887126085329147,616,9082055,5951430,0,5951430
12411,Ernest Agyiri,64,353200,8162181833257022,241,1864341,1381985,138199,1243786
12412,Tomás Ahumada,67,992900,4912405408356083,387,3724122,58605,5861,52744
12413,Tuncer Duhan Aksu,45,2954800,4858486398659437,415,5850395,3102803,31029,3071774
12414,Khaled Al Blooshi,31,3105100,6185773778894270,294,4851030,156190,15619,140571
12415,Khalifa Al Dawsari,63,1502700,8356049070881062,393,3851321,3140526,0,3140526
12416,Amaar Al Dohaim,66,997900,7086643960978279,402,3950866,3818621,0,3818621
12417,Faisal Al Ghamdi,49,4249600,5177080691212915,538,7529055,5517527,552,5516975
12418,Abdullah Al Hamdan,24,3511200,6649488460460316,274,4557563,604668,0,604668
12419,Abdullah Al Jadaani,54,4294400,8041470434099727,563,7532521,2684055,26841,2657214
12420,Mohammed Al Majhad,39,2886400,3649556901631212,341,4763879,2767307,0,2767307
12421,Abdullah Al Meqran,31,2205200,8955906012534446,234,3387088,1168628,11687,1156941
12422,Saad Al Mousa,42,4179500,3259450230081202,438,7036247,1564043,1564043,0
12423,Yousef Al Mozairib,53,4606500,5996624576830966,595,7850143,3407428,0,3407428
12424,Abdulrahman Al Safri,40,529800,6553017911127729,132,1145982,331575,33158,298417
12425,Abdullah Al Salem,56,3385600,6176943675794898,480,6809839,5806431,580644,5225787
12426,Khaled Al Samiri,59,1259500,8755076778191350,324,3096345,460153,0,460153
12427,Abdulelah Al Shammari,40,2223600,6288178000722318,291,3633746,429761,0,429761
12428,Cheye Alexander,62,3720000,7421364230899777,611,7798318,256945,256945,0
12429,Bastian Allgeier,29,1414400,9834339475014566,166,2123308,2032258,20323,2011935
12430,André Alsanati,43,4350700,7079732193967890,426,6623072,950641,95065,855576
12431,Fernando Álvarez,29,2218700,5828069908826160,219,3370313,1435892,1435892,0
12432,Ricardo Alves,57,1304500,6642948108466640,310,3380719,3216724,3216724,0
12433,Giuseppe Ambrosino,41,3226200,5697977278790703,395,5797408,931299,931299,0
12434,Wisdom Amey,39,3780400,6628739688943700,428,6106661,5544323,555,5543768
12435,Danny Amos,25,2290200,6674218834254400,167,2908119,2323158,233,2322925
12436,Harry Anderson,54,3107200,5946688532140239,509,6084182,2539276,2540,2536736
12437,Marius Antoche,57,1000700,7270337859247376,275,2555569,2127989,2127989,0
12438,Ayman Aourir,69,2841900,5540795778779875,506,5955294,1946678,1947,1944731
12439,Thomas Aquilina,53,4806700,9116993806755349,555,8448781,8381679,8382,8373297
12440,Martín Araya,46,4955000,6844194048414609,471,7711171,1960036,196004,1764032
12441,José Arbio,48,716900,6904193069197070,242,2197080,1595898,1595898,0
12442,Ossama Ashley,42,2469300,4421769575025995,307,4034053,2720450,2720450,0
12443,Arthur Atta,48,4909800,3802410259064671,520,8423737,4795751,480,4795271
12444,Aventis Aventisian,28,2256700,5254289927190330,222,3330729,360842,0,360842
12445,Yasin Ayari,38,1460200,3578301974029358,234,2778702,370358,3704,366654
12446,Cristhian Báez,55,3827200,9514401918313416,534,7868957,3395739,3395739,0
12447,Bai Yang,66,1310300,6676959567435378,381,3698871,1264341,126435,1137906
12448,Odin Bailey,36,3434000,9190530569022520,376,5688560,1487212,1488,1485724
12449,James Balagizi,51,2836800,3499956147867182,370,4771749,4233316,424,4232892
12450,Aden Baldwin,46,577200,9740904842931535,188,1515659,1178910,117891,1061019
12451,Samuel Ballet,64,3106700,5664330413889019,493,6220434,52942,52942,0
12452,Guillermo Balzi,58,945200,7131854936735055,283,2732394,1495352,150,1495202
12453,Luis Banegas,44,480900,4327630993584048,188,1518358,670228,670228,0
12454,Yannik Bangsow,24,3855400,6068393456969536,284,4887515,1951848,19519,1932329
12455,Aldo Bareiro,44,1629400,5128039410986724,238,2965947,267656,268,267388
12456,Paddy Barrett,30,1193600,3815571852437157,125,1645113,224865,0,224865
12457,Norman Bassette,23,4143000,4186365988114304,320,5485499,3015414,0,3015414
12458,Luca Bazzoli,32,3688500,8846698973561031,364,5197270,43647,0,43647
12459,Owen Beck,29,1191400,3528027507017846,136,1684446,1319526,13196,1306330
12460,Jan Bekkema,32,2571100,5564647212534256,256,3734026,3680062,0,3680062
12461,Marcel Benger,45,2788600,8348655276858082,363,4812035,4354706,0,4354706
12462,Rhys Bennett,53,3700400,3870835226667918,464,6848451,3913375,0,3913375
12463,Viktor Bergh,52,2860600,8938739045497406,391,5190215,1377573,13776,1363797
12464,Lucas Bergvall,28,2218900,6583190720744855,246,3577197,3277112,0,3277112
12465,Nicolò Bertola,37,429900,8025801544683686,129,979977,752609,7527,745082
12466,Rahul Bheke,62,2129500,7529701362539557,443,5060303,2092982,0,2092982
12467,Jakub Bielecki,53,2598500,5398669202739288,424,5392119,3800044,0,3800044
12468,Carl Björk,37,528700,9158459010151978,145,1178617,60616,0,60616
12469,Koen Blommestijn,48,4045700,7591656097265656,506,7643446,4900445,0,4900445
12470,Tom Bloxham,25,3692200,9708441228039727,290,5218316,1517280,151728,1365552
12471,Ernest Boahene,47,4737300,6581036377052394,559,8336431,5204413,520442,4683971
12472,Thomas Boakye,38,1856000,5424312040738013,241,3189804,1504229,1505,1502724
12473,Luke Bodnar,43,2770800,3943623710341474,348,4962576,1628835,1629,1627206
12474,Giovanni Bogado,34,1351800,5994216393443968,175,2253538,338977,0,338977
12475,Greg Bolger,50,2649900,5987372542664100,395,5361727,944358,945,943413
12476,Kayne Bonnevie,59,2844600,3205791909030423,455,5727103,216771,0,216771
12477,Noah Botić,30,2190400,7838200212649221,182,2915749,2157778,216,2157562
12478,Mehdi Boukamir,25,2540700,4569478052602362,222,3505476,30475,3048,27427
12479,Kieron Bowie,29,4958900,3679601958726499,417,7740536,1270469,1271,1269198
12480,Coniah Boyce-Clarke,33,3831100,8201298953236674,353,5184574,2592824,2592824,0
12481,Harry Boyes,22,2864900,5843024314722481,241,4253440,4200531,420054,3780477
12482,Andy Boyle,70,2345800,3797577138867835,545,5646372,2501872,0,2501872
12483,Johan Brattberg,31,3010900,5676977184205484,309,4486938,83232,833,82399
12484,Kian Breckin,61,1833900,9231015585894121,364,4065468,893744,893744,0
12485,Jakob Breum,37,4390500,9959417806361178,402,6377403,1259984,1260,1258724
12486,Louis Breunig,48,4365200,8879360985355349,565,7830714,2204407,0,2204407
12487,Diego Bri,25,2692300,4106522557736204,192,3554088,1398837,0,1398837
12488,Ethan Brierley,27,4984900,4327183096926112,413,7609570,2239103,0,2239103
12489,Jordan Brown,48,601600,5139855182893237,183,1712607,593261,0,593261
12490,Lee Brown,24,1073600,8984280643737766,96,1324153,1261075,1261075,0
12491,Darren Brownlie,48,4952800,9288338209039333,562,7565333,7188711,7189,7181522
12492,Max Bruns,60,1195300,4376958174372737,335,3541161,1922726,19228,1903498
12493,Michał Buchalik,52,1636900,8215467573205077,329,3762801,1877038,0,1877038
12494,Noel Buck,43,2169300,9247796888780174,323,3937180,652937,653,652284
12495,Keith Buckley,59,2196000,4307225024048016,381,4552145,173013,173013,0
12496,Ameen Bukhari,31,2015600,5868718189041495,209,3149234,2090246,2091,2088155
12497,Rasim Bulić,34,4195400,6745508095185270,435,7103634,253200,253200,0
12498,Darragh Burns,40,2893300,4592568942160323,340,4620976,1859563,186,1859377
12499,Warren Burrell,56,3635700,6775360218755055,475,6382130,4476443,0,4476443
12500,Azer Bušuladžić,38,2621400,5866995411291689,303,4127055,1545176,15452,1529724
12501,Daniel Butterworth,39,2378800,8128164780804776,285,3865104,2898016,0,2898016
12502,Mehmet Ali Büyüksayar,30,4797600,8029150630618084,410,6854748,97547,0,97547
12503,Gianfranco Cabrera,35,4737000,5209803588191591,490,7467283,556491,557,555934
12504,Alexandro Calut,23,1226000,4924594243954866,122,1551987,1088630,10887,1077743
12505,Christian Camarillo,26,4614700,8346063328258949,331,5692582,1595480,159548,1435932
12506,Innes Cameron,30,2413600,9507325740913343,253,4038237,211181,2112,209069
12507,Cao Yongjing,45,4349100,4810759686852988,467,7261519,3331925,0,3331925
12508,Lorenzo Carissoni,36,1747600,3958911852277149,223,2840296,520964,521,520443
12509,Fredrik Carlsen,56,2685700,4297514999268806,383,5249426,2194761,2195,2192566
12510,Luis Casiani,63,4344000,7314336802831589,640,8921303,2372726,0,2372726
12511,Lewis Cass,50,4678700,3673977547109857,542,7476191,6833806,0,6833806
12512,Tommaso Cassandro,61,4762500,4106470761176923,569,7606379,6030245,0,6030245
12513,Thomas Castella,28,3293400,9284160538120323,321,4836236,2432304,243231,2189073
12514,Jesper Ceesay,62,2617400,5781960830866530,444,5633329,4681157,4681157,0
12515,Ekin Celebi,51,2077500,4863760063682600,345,4296866,429749,0,429749
12516,Tarek Chahed,63,2386300,7642190457743859,457,5274809,3222189,0,3222189
12517,Tommy Chamba,48,1763700,8137049140793608,277,3204227,496398,497,495901
12518,Harry Charsley,56,1531400,8069441817017314,311,3628779,1529369,0,1529369
12519,Cheng Yuelei,30,3057700,3700508432910668,318,4546686,2042723,204273,1838450
12520,Choi Jun Hyuk,53,3366700,4810134366800019,469,6815494,179391,17940,161451
12521,Mateusz Cholewiak,69,699400,8849956657956093,388,3373083,443218,0,443218
12522,Nadjib Cissé,26,409000,8841431679349878,61,464837,408385,409,407976
12523,Ibrahima Cissé,55,1997900,5954490278936954,293,3992065,1092641,110,1092531
12524,Abdoulaye Cissoko,31,3134400,8464673548037800,308,4853158,1244788,0,1244788
12525,Craig Clay,49,4131000,9423556064546658,499,7284111,6125449,6125449,0
12526,Tom Clayton,39,3642300,3571637651934184,381,5516626,4056004,4056004,0
12527,İsmail Çokçalış,39,1039800,8902260898539305,173,1992924,962601,9627,952974
12528,Dennis Collander,56,4927000,6754810827553976,572,8271262,5667082,56671,5610411
12529,Brandon Comley,67,4286000,4376469590219623,661,8435120,8186961,818697,7368264
12530,Dylan Connolly,26,1841800,8400509867084032,165,2613990,1566632,15667,1550965
12531,Iván Contreras,50,2125800,9751171281730153,369,4215181,415431,0,415431
12532,Jack Cooper-Love,57,1946200,8926960767870158,368,4153032,238806,2389,236417
12533,Ali Coote,62,574800,3346346255792352,269,2117957,1623364,162337,1461027
12534,Cui Lin,32,1966700,6899562574344724,242,3259548,970808,9709,961099
12535,Laurin Curda,55,1043700,5728139528268188,258,2556387,990137,99014,891123
12536,Sam Curtis,54,2278000,6845735982322346,346,4418433,3086891,30869,3056022
12537,Mladen Cvjetinovic,46,2831600,3393153015972649,364,4845830,737956,0,737956
12538,Júlio Dabó,60,3095200,8742802736064794,462,6011955,4077570,407757,3669813
12539,Niklas Dahlström,65,2003900,9081568177943641,414,4747272,267674,267674,0
12540,Simone Davi,33,1932900,5906689180473547,225,3023511,1864724,187,1864537
12541,Archie Davies,30,4337000,4573371462042043,374,5958178,1729221,172923,1556298
12542,David Davis,50,4299200,5636527160334084,542,7560690,3100414,3100414,0
12543,Théo De Percin,61,1833400,3124025956548916,437,4495002,4301728,4301728,0
12544,Steven Deana,69,1795600,3186364940264299,444,4897845,226651,227,226424
12545,Sadou Diallo,31,2739100,8346528496898155,280,4115065,1188524,1188524,0
12546,Iliya Dimitrov,47,2711700,6847244448640577,396,5374156,1476813,1477,1475336
12547,Marko Divković,60,1167900,9313216471319417,289,3032027,1152097,115210,1036887
12548,Belmin Dizdarević,57,2927300,7220775371740846,445,5759696,196136,0,196136
12549,Nikola Djorić,58,3734600,4980722116169540,444,6789264,3941428,3941428,0
12550,Kristijan Dobras,30,1527400,7730683430535349,152,2216316,1659432,165944,1493488
12551,Owen Dodgson,43,1556000,3743387262902968,253,3067946,2789804,0,2789804
12552,Ben Doherty,53,1923900,4124755906868789,347,3935537,2572241,257225,2315016
12553,Kyliane Dong,34,4356200,8090246710827228,413,6143208,24742,0,24742
12554,Ross Doohan,45,3157600,9411105286251063,405,5578301,4383005,439,4382566
12555,Griffin Dorsey,52,3549400,6768534062342269,517,6731781,1349599,135,1349464
12556,Dudu,64,3284600,7899389245329317,519,6592705,5318632,531864,4786768
12557,Declan Drysdale,59,1267700,6635416952907998,364,3803268,597749,59775,537974
12558,Du Jia,68,3053400,3387453943513321,541,6586643,5547025,0,5547025
12559,Cameron Dummigan,27,1068800,3751326192509310,97,1383664,1188041,0,1188041
12560,Ryan Duncan,39,608900,3764070692145612,123,1152367,750313,0,750313
12561,Julian Dunn,55,1862200,3698743744432817,368,4549569,2133137,214,2132923
12562,Denilson Duran,57,3818200,5045342671781038,486,6239023,778059,0,778059
12563,Simon Ebonog,46,959900,5342337718556843,201,1940352,727088,727088,0
12564,Earl Edwards Jr.,66,2123100,9307211972560892,439,5193364,113226,0,113226
12565,Noel Eichinger,70,3649100,8679817404326025,605,7441629,3215995,3215995,0
12566,Tobias Eisenhuth,31,1238900,8831855530125170,133,1826685,365065,0,365065
12567,Issam El Maach,47,3859500,4335328787131338,443,6262868,5670733,0,5670733
12568,Zachary Elbouzedi,36,3606300,8785660789323144,413,6036538,2895281,28953,2866328
12569,Anosike Ementa,49,3716000,5642893757690943,475,6496987,1729002,1730,1727272
12570,Ulrick Eneme-Ella,54,3948800,5180243059033707,522,7157270,4510514,0,4510514
12571,Mads Enggård,27,1072000,4263139780065186,131,1686465,1529821,1530,1528291
12572,Maximilian Entrup,51,3157800,4529312972780911,389,5603613,776284,7763,768521
12573,Espigares,65,1938600,3901648490700987,415,4818516,2159647,0,2159647
12574,Francesco Pio Esposito,22,3848200,4707803469999592,280,4970385,1611522,1612,1609910
12575,Tiago Estevão,27,3976800,5845339633997390,307,5646392,882905,0,882905
12576,Karl Edouard Etta Eyong,62,4254400,4171381443648486,633,8146971,6286993,62870,6224123
12577,Connor Evans,62,2335200,5826015675666475,476,5146874,4331142,43312,4287830
12578,Luca Everink,27,2901000,7716912815758274,272,4238594,2644349,264435,2379914
12579,Julien Fabri,48,3723400,4961770035019376,474,6726404,5173944,0,5173944
12580,Paul Farman,41,2030700,3755057764759269,266,3367664,1112986,0,1112986
12581,Noah Fatar,64,2649800,5767263231092890,479,5750712,1576935,158,1576777
12582,Baba Fernandes,28,1514000,9808311603226418,169,2407372,11329,1133,10196
12583,Brandon Fernandes,43,3678300,9735664519900623,424,5686036,2770763,2771,2767992
12584,Román Fernández,44,1749000,9659911772455296,257,3038464,1583411,1583411,0
12585,Rafa Santos,48,1408300,5966026474126135,279,3112058,1478382,1478382,0
12586,Jordan Flores,62,1434700,9777732493821772,414,4125023,1900259,1901,1898358
12587,Franchesco Flores,27,2370900,7210863424997253,213,3445767,2890785,0,2890785
12588,Alberto Flores,35,2646400,5719863792662430,280,4182042,2962212,0,2962212
12589,Oliver Fobassam,24,3509100,9121859562683992,298,4831143,2728872,0,2728872
12590,Alex Forés,62,638100,4179658849872172,269,2225048,1162665,1163,1161502
12591,Denis Franchi,58,1273500,3035545958421296,294,2888980,2496397,0,2496397
12592,Mario Fuente,67,3719800,5152374158497335,593,8163918,2588583,2589,2585994
12593,James Furlong,31,2942800,5291238821834137,302,4468857,2521786,252179,2269607
12594,Guillaume Furrer,27,4606900,4786630197427132,392,6551835,6416329,64164,6352165
12595,Mohammed Fuseini,42,1437300,8919534291190195,242,2691267,1479874,1480,1478394
12596,Noah Ganaus,51,3041700,5588792701749846,419,5481369,4318937,432,4318505
12597,David García,22,2851000,4093339278245471,250,3993720,542239,54224,488015
12598,Joe Garner,39,3074400,9327707298590763,346,5425488,1851671,186,1851485
12599,Giovanni Garofani,40,1788700,7604412489308486,256,3302326,821750,0,821750
12600,Theo Gécé,65,4723600,3328845923989773,618,8689717,2857268,0,2857268
12601,Gelardo,55,3461800,8556868683261087,486,6269709,2832883,2833,2830050
12602,Andrei Gheorghiță,67,4381300,9357554372102475,680,8178339,6010121,60102,5950019
12603,Juan Cruz Giacone,32,2971100,3441999570646816,329,4778507,3861069,0,3861069
12604,Gvidas Gineitis,45,1001000,3995966665835671,235,2425608,1539847,1539847,0
12605,Federico Giraudo,68,4014600,8625647141658018,612,7335407,815638,816,814822
12606,Dennis Gjengaar,26,812000,3101703240840339,106,1192914,389546,0,389546
12607,Ben Gladwin,67,1942800,5510299276804576,472,5297625,641470,641470,0
12608,Franculino,54,4108400,7359018869911115,547,7728682,4312161,0,4312161
12609,Arthur Gnahoua,60,1805900,4660859687844071,353,4019234,877327,8774,868553
12610,Nicolás Goitea,70,2241600,9779706146897848,439,5240111,644225,6443,637782
12611,Rafael Fernandes,54,4393600,3256987284489496,578,8005037,5658817,0,5658817
12612,Tomas Gomez,51,3425300,4344850408494109,410,5443105,49169,492,48677
12613,José Gómez,52,1110200,8890131431141792,289,3053079,1142841,1143,1141698
12614,Diego González,43,3535600,6291789054424713,424,5937121,155776,1558,154218
12615,Tyler Goodrham,57,425300,8242749282933886,273,2047298,1593023,1594,1591429
12616,Kellan Gordon,69,4885000,4432654207248597,647,9445450,8658496,0,8658496
12617,Liam Gordon,29,4844500,6357926561845024,406,6867336,3775133,377514,3397619
12618,Robbie Gotts,35,1242700,9325771015584150,197,2388093,549066,5491,543575
12619,Conor Grant,48,4813800,3857421769076896,516,7548229,7120190,0,7120190
12620,Jędrzej Grobelny,51,1324400,9840697840684673,265,2966437,302669,30267,272402
12621,David Grözinger,22,2252500,8463858388587195,170,2741882,488188,488188,0
12622,Yanis Guermouche,50,2784300,9735951396114256,368,4978111,3549462,35495,3513967
12623,Thomas Gundelund,34,3509800,5208824795670163,396,5813155,4189842,4189842,0
12624,Gwon Wan Gyu,48,1797500,7432202066362571,302,3799182,3165752,3166,3162586
12625,Albian Hajdari,32,4732800,6125542983586424,454,7205514,6895727,690,6895037
12626,Lucas Halangk,57,1114000,5514487203429650,272,2691176,1414246,0,1414246
12627,Jack Hamilton,66,1460000,6959701460845731,379,3823614,787694,788,786906
12628,Fredrik Hammar,25,1752400,9138867988772962,170,2593106,1089956,1090,1088866
12629,Sondre Fosnæss Hanssen,53,605700,6388521250827183,225,2083341,1404706,141,1404565
12630,Rekeem Harper,59,2843700,4597695751403226,444,5360767,4251997,4252,4247745
12631,Luke Harris,55,2599300,8933564882590566,435,5011606,4698294,0,4698294
12632,Fabrice Hartmann,33,1170700,8734148713088210,145,1717335,842727,84273,758454
12633,Brandon Haunstrup,49,2227400,7946554553783305,313,4295935,3176191,318,3175873
12634,Ryan Haynes,36,4232200,8910837853899221,398,6114373,1928172,0,1928172
12635,Torbjørn L. Heggem,38,2453600,8014018089072495,279,4174466,1786884,1786884,0
12636,Kane Hemmings,46,2009300,9080865354610418,332,3974199,652673,65268,587405
12637,Jay Henderson,52,3268000,9658174322467894,422,5698228,3647373,364738,3282635
12638,Rushian Hepburn-Murphy,63,1050200,9079482657037115,327,3215701,746673,746673,0
12639,Ezequiel Herrera,23,345100,8257173295162253,45,293106,155317,15532,139785
12640,Nahuel Herrera,42,2748900,7259625787576332,339,4680599,4507269,0,4507269
12641,José Herrera,49,4055300,5058044365261910,514,7175079,1238313,0,1238313
12642,Thomas Heward-Belle,50,3829800,8946416109349182,496,7097349,5655138,0,5655138
12643,Bode Hidalgo,44,462000,7701279453574853,153,1256206,967636,0,967636
12644,Abdulbasit Hindi,41,2645800,5648459484727554,286,3943361,2354506,236,2354270
12645,Jack Hingert,32,542900,5845672063450810,95,933546,306171,0,306171
12646,Joe Hodge,32,1137700,7836027129094689,167,1972926,1570260,1571,1568689
12647,Albert Hofman,68,2585800,4573613023237462,503,6231339,1102371,1102371,0
12648,Erik Holt,65,2954400,9102823317918075,558,6589819,4514999,4514999,0
12649,Tom Hopper,43,1726500,4457038123736916,264,3176668,2495786,2495786,0
12650,Daryl Horgan,37,3209800,8258254943496268,382,5084783,4217000,0,4217000
12651,Rafael Hornos,26,339500,6042228155373342,46,332381,182854,0,182854
12652,Sebastian Hornung,40,1050200,7240910108538838,168,1939224,1897756,1897756,0
12653,Hu Jinghang,58,3682400,5847513759870861,498,7066606,1922391,192240,1730151
12654,Kyle Hurst,59,4358300,4566289723788940,550,7414297,6109401,61095,6048306
12655,Anel Husic,66,4553000,7290911869520746,625,8824746,3366438,337,3366101
12656,Benjamin Hvidt,49,2171300,7129678496479346,334,4387938,2183095,218310,1964785
12657,Hwang Soon Min,67,3219400,8999395342101009,577,6545366,5511479,0,5511479
12658,Lukas Ibertsberger,23,3087400,9379773587959527,272,4680796,1149955,0,1149955
12659,Dane Ingham,44,1486900,3555558452866914,260,3004481,2482068,24821,2457247
12660,Damian Isac,31,3470800,7243166285904722,339,5455395,386671,38668,348003
12661,Jacob Italiano,43,3100800,7822402217093701,364,5244800,3033793,304,3033489
12662,Risto Jankov,50,3140000,6398622303920854,378,5692990,3046821,3047,3043774
12663,Vítězslav Jaroš,41,467000,3635146945767943,139,1172416,290768,291,290477
12664,Seedy Jatta,69,2063600,6881986963304584,473,4894838,2887042,2888,2884154
12665,Dominic Jefferies,28,3658500,8350114759309222,341,5366038,358218,0,358218
12666,Monir Jelassi,67,1853900,8099427792825670,430,4750561,2805270,0,2805270
12667,Lukas Jensen,51,2653100,5341369480879794,363,4936346,2199868,0,2199868
12668,Luke Jephcott,50,311400,4988982476168226,221,1662872,201130,0,201130
12669,Jin Yangyang,51,828300,3673023818765364,211,1945012,1124685,113,1124572
12670,Eirik Holmen Johansen,54,3760100,8066568864116102,485,7165737,2392728,240,2392488
12671,Lucas Hägg Johansson,44,2688200,6838328407260776,320,4678885,1480863,1481,1479382
12672,James Jones,44,3796900,4522456451045655,430,6702342,6470036,6471,6463565
12673,Elias Kachunga,24,3840200,8840021580085512,321,5451319,870962,870962,0
12674,Elliot Käck,67,1305300,9005502652295157,358,3840787,3048253,30483,3017770
12675,Anton Kade,48,603600,5693068832138674,205,1746167,430452,431,430021
12676,Georgios Kanellopoulos,24,2519900,8106860418856935,206,3411639,2558282,2559,2555723
12677,Kang Yun Koo,31,717300,7664466923507902,130,1328328,770292,771,769521
12678,Kang Ji Hoon,55,2987800,4338316055159336,406,5776097,5049207,0,5049207
12679,Filip Karbowy,67,407000,3139069125326628,316,2582588,1510096,15101,1494995
12680,Johan Karlsson,60,1378400,4390438620166125,367,3677231,3362226,336223,3026003
12681,Victor Karlsson,67,757000,8258992201012484,341,2774628,2648253,265,2647988
12682,Konrad Kasolik,56,2042200,9165318930376993,415,4343812,3929678,0,3929678
12683,Matija Katanec,48,2039500,3265328533074197,336,4169033,2305097,2306,2302791
12684,Ke Zhao,32,876600,3101583632303723,137,1449661,695132,695132,0
12685,Felix Keidel,43,3182300,5831217977747461,379,5127000,2233281,0,2233281
12686,Fiacre Kelleher,31,4124300,5165649318536002,411,6826484,6207797,62078,6145719
12687,Dan Kelly,69,1333600,6091130859293379,355,3577519,1260856,127,1260729
12688,Charlie Kelman,67,1884900,6176267671711923,436,4685886,499677,500,499177
12689,Michael Kempter,61,2001400,9519178919008413,414,4643237,2439782,0,2439782
12690,Johnny Kenny,41,3508200,3235370925786499,406,5412064,4906528,0,4906528
12691,Kim Ji Hyun,56,2658800,4269349711476790,434,5016466,2104492,210450,1894042
12692,Kim Ju Kong,55,3249100,6397289596490663,441,5701901,2594466,0,2594466
12693,Kim Kang San,63,3932000,9723578946479579,581,7744815,6653845,0,6653845
12694,Kim Young Uk,62,4666100,5995572347853156,615,8723686,7788656,0,7788656
12695,Oliver Kjærgaard,57,2831300,8632994839780530,447,5684872,1250744,1250744,0
12696,Antoni Klimek,47,506800,4607508170514213,196,1612660,812535,812535,0
12697,Mateusz Kochalski,37,1203600,7169353351768703,182,2051737,545107,54511,490596
12698,Mohamed Koné,38,3246100,6904970179681708,384,5494677,2525074,2526,2522548
12699,Phillip König,60,2799100,9428037281173669,490,6046642,108142,0,108142
12700,Nathan Konstandopoulos,49,3599100,3340632152490243,520,7357382,1283027,128303,1154724
12701,Bartłomiej Kukułowicz,32,4252400,9189420733652867,383,6455177,2540177,2540177,0
12702,Alou Kuol,54,1332000,7016677313117320,356,3868320,426959,426959,0
12703,Amar Kvakić,69,3828900,4580181807551784,574,7399059,623736,623736,0
12704,Salvatore Dario La Vardera,44,3642300,6670780894579658,404,6306955,1753412,0,1753412
12705,Samir Lagsir,66,4994300,6910180051448415,655,8767383,1228692,12287,1216405
12706,Rob Lainton,50,2857700,8827971880233900,425,5607554,3011643,0,3011643
12707,Charlie Lakin,67,3526900,8210852157595873,541,6839657,1262086,0,1262086
12708,Johan Lara,44,1776800,8711934805116017,288,3394360,2714989,2714989,0
12709,Victor Larsson,42,3477000,4817602137684353,443,6380771,3006257,3007,3003250
12710,Lucas Lavallée,64,1304400,6557399161997399,346,3690258,3035808,303581,2732227
12711,Ian Lawlor,26,3643600,5817746200584032,275,4784382,401871,4019,397852
12712,Tom Lebeau,31,3577200,3949522712616516,349,5356328,2327377,2328,2325049
12713,Lee Kang Hyeon,36,1737700,6572684133350992,193,2577233,1942331,194234,1748097
12714,Lee Ji Sol,22,4616600,6562269638091357,350,6306247,703963,7040,696923
12715,Lee Ji Han,54,1824300,7014022765492925,342,3891778,1244833,0,1244833
12716,Lee Jeong Hyeop,66,4248000,8206085243854663,591,7774439,3909758,3909758,0
12717,Frank Lehmann,29,3227900,8704490030362296,303,4597622,3922011,393,3921618
12718,Kyvon Leidsman,35,493200,6249525715696821,125,1115530,801021,802,800219
12719,Dexter Lembikisa,28,909400,6590868098389076,104,1197970,742598,0,742598
12720,Jamie Lennon,32,909500,9359405770673261,108,1325330,539028,53903,485125
12721,Leung Nokhang,65,3553900,9283520478458233,503,6611668,6468608,0,6468608
12722,Adam Lewis,50,548600,6889377396393070,221,1853978,1253138,1254,1251884
12723,Rubén Lezcano,49,3801500,7635174466705622,519,6713083,4532911,454,4532457
12724,Li Yang,54,3667200,5881475554442892,494,6761060,467383,4674,462709
12725,Manuel Liendo,51,1043800,4724243411106993,242,2561835,729758,729758,0
12726,Lim Eun Soo,52,4370700,5432760007542385,530,7324782,5418502,0,5418502
12727,Alexander Lind,68,2096800,5758446154458147,490,5169872,4420159,0,4420159
12728,Harvey Lintott,40,2858100,8067438779258596,334,4535389,1889176,1890,1887286
12729,Liu Yang,53,4483500,5100834234986461,573,8314218,327305,0,327305
12730,George Lloyd,33,853200,9499694718925446,131,1460097,1444273,1444273,0
12731,Per Lockl,62,3085800,3323533406814544,476,5721341,4474852,44749,4430103
12732,Enrique Lofolomo,37,4785700,6188494665432400,459,7761715,4260610,4260610,0
12733,Ryan Loft,66,929000,3844955592741521,283,2907673,178221,0,178221
12734,Rosaire Longelo,35,4608900,6327226246830725,444,7844916,7321348,7321348,0
12735,Kacper Lopata,57,3292200,6274886228387635,446,6351784,3241418,325,3241093
12736,Yordi López,49,4423300,6664461812399237,564,7559668,6617473,0,6617473
12737,Adrien Louveau,41,2782400,7413794146798858,349,4383003,1407840,1407840,0
12738,Jason Lowe,30,1734500,3132124636562586,175,2649737,1732780,1732780,0
12739,Nicolas Lüchinger,55,3163700,6043684158885592,389,5157953,5060714,506072,4554642
12740,Kamil Lukoszek,38,4200900,3666559027716870,465,6916660,832465,0,832465
12741,Luo Jing,54,4369300,7224504456499733,552,7928607,732417,732417,0
12742,Ismet Lushaku,56,4297500,7719964028477984,574,8221062,5247101,524711,4722390
12743,Néhemie Lusuena,52,372400,6285862291470989,229,1691758,411324,41133,370191
12744,Taylor Luvambo,67,4430200,5422365684249666,592,7829754,6373682,63737,6309945
12745,Dean Lyness,61,3326900,5016153139957469,483,6299344,6166047,6166047,0
12746,Brad Lyons,33,2808900,4507344295592940,299,4513112,2174753,218,2174535
12747,Yann Mabella,28,4177100,9384184622985215,369,6499782,1657520,0,1657520
12748,Roman Macek,35,1107100,8556508913420895,161,1873524,659319,0,659319
12749,Renzo Machado,44,1210000,5283216606302251,236,2570765,2055610,206,2055404
12750,Gustav Sandberg Magnusson,66,808400,8862983935871215,385,3333258,1322242,0,1322242
12751,Brian Maher,43,3143600,6341925101315780,393,5113036,4323509,432351,3891158
12752,Niall Maher,58,4552700,5751019534408069,637,8594057,3446528,344653,3101875
12753,Abdulaziz Majrashi,32,2187900,9261943402194352,238,3455937,1052160,10522,1041638
12754,Abdulaziz Majrashi,37,1562300,8118119309361038,216,2516477,368025,3681,364344
12755,Breston Malula,54,4962700,3903099628896159,554,7891626,7316495,731650,6584845
12756,Mikaël Mandron,55,3983300,3340034236608780,554,7175108,4562442,4562442,0
12757,Richonell Margaret,26,1674200,6636124619471729,170,2461941,120223,1203,119020
12758,Daniel Margush,41,1106600,6987657604056058,225,2483330,1642144,164215,1477929
12759,Shaho Maroufi,63,2392200,4763103271969958,436,5219954,4882859,48829,4834030
12760,Leonardo Marson,24,1036400,4064372717656599,102,1338101,829120,829120,0
12761,Derlis Martínez,35,2532100,3134093436046577,304,4120715,1988231,1989,1986242
12762,Laureano Martínez,65,2627500,8967504027918952,449,5993560,1878350,18784,1859566
12763,Esteban Matus,41,376100,5277443818543447,146,1069706,1049704,105,1049599
12764,Iba May,39,3116300,7820505173716249,341,4877487,1190939,120,1190819
12765,Eliezer Mayenda,56,405600,8575737523220387,224,1653860,291552,29156,262396
12766,Ibrahim Maza,68,2926800,6707153940473536,536,6510835,6243035,6244,6236791
12767,Bradley Mazikou,55,4033200,4097374331474493,510,7234087,2630625,2630625,0
12768,Malick Mbaye,30,3481600,5340619607756323,288,4880494,2259568,225957,2033611
12769,Jake McGing,48,2150100,8480144091515604,344,4080302,2950703,2950703,0
12770,Ryan McLaughlin,43,4840700,6504918308987698,496,7691632,3855462,0,3855462
12771,Callum McManaman,35,3568100,6442198798204079,399,5893377,5748763,575,5748188
12772,Charlie McNeill,42,4816300,3013104324262081,553,8555879,5898107,5898107,0
12773,Rick Meissen,29,4090800,3499771861771629,313,5382702,2785589,0,2785589
12774,Rollin Menayese,57,2073400,6457887347407033,385,4205731,2867003,0,2867003
12775,Jacob Mendy,70,4168300,3841182648288030,639,8396471,6029128,6029128,0
12776,Osky,44,4941900,3054529450528977,548,8680836,6111750,0,6111750
12777,Chris Merrie,67,4564500,8713344264361680,606,8171862,7922603,79227,7843376
12778,Metinho,69,2922400,7507647790781587,503,6340643,530764,531,530233
12779,Jonas Michelbrink,25,1767900,8359679516154653,167,2454344,1935275,1936,1933339
12780,Leonel Miguel,54,3316200,7496009315065202,456,6108991,1530340,0,1530340
12781,Nikola Mileusnić,60,3438900,5585790784186733,463,6382248,3331660,3332,3328328
12782,David Min,57,2921700,8132937491035242,418,5459232,4666403,46665,4619738
12783,Jostyn Mina,41,2840600,7178344641314226,350,4802284,1225106,0,1225106
12784,Alan Mariano Miño,55,1223700,4401925640094298,288,3068729,1973709,198,1973511
12785,Akash Mishra,53,2583400,4904083299075464,380,4727309,2232575,224,2232351
12786,Jeppe Arctander Moe,50,3828900,5417874029281423,429,6282468,1457793,1458,1456335
12787,Estivel Moreira,50,962800,6857542134225640,257,2639610,1876561,187657,1688904
12788,Valdeci,37,300800,3909656141516841,93,665849,76568,0,76568
12789,Nathan Moriah-Welsh,67,539700,5061795618906696,307,2670108,631837,0,631837
12790,Rodrigo Morínigo,35,2040700,6215306769267624,216,3112326,102012,1021,100991
12791,Louis Mouton,24,4236700,3991153508666319,332,5639273,1586726,1587,1585139
12792,Agon Mucolli,69,2880300,6062889476197711,567,7117420,584563,0,584563
12793,Jack Muldoon,66,2250300,7152760083061167,390,4861290,2889882,2890,2886992
12794,Toby Mullarkey,70,660000,3617376583255738,348,3154423,1448841,1449,1447392
12795,Josh Mulligan,49,4262000,5499171072021050,499,7336370,2791132,279114,2512018
12796,Ian Murphy,61,1996400,6170440543758639,390,4391259,4078081,40781,4037300
12797,Fraser Murray,52,3458500,9780572701139405,458,6459335,3947559,0,3947559
12798,Alexandru Musi,63,2002000,4336036092028916,370,4207322,3768225,37683,3730542
12799,Joseph N'Duquidi,33,2821100,5323487084838796,310,4470507,3019673,0,3019673
12800,Takuhiro Nakai,23,863600,9040551394382872,53,736332,47175,4718,42457
12801,Abdenego Nankishi,48,3169800,5242601379409259,456,6210024,2291984,2292,2289692
12802,Hampus Näsström,28,1955100,3398017414969401,184,2982360,1992035,0,1992035
12803,Noah Naujoks,53,3539600,3103439977202612,467,6348232,3822716,0,3822716
12804,Elliott Nevitt,66,1406700,8388058835165565,365,3749691,2517419,25175,2492244
12805,Alex Newby,35,1537200,6577690528253834,211,2516246,459427,0,459427
12806,Steve Ngoura,54,2562900,9931117641018859,418,4921376,1304295,1304295,0
12807,Stefan Nigro,45,648500,9011464346331005,200,1881836,1333065,13331,1319734
12808,Aleksander D. Nilsson,62,785900,5599690595989593,298,2706101,769935,76994,692941
12809,Obed Nkambadio,51,858400,9957479870317225,241,2361576,680423,68043,612380
12810,Junior Noguera,70,978300,6370149560245553,403,3598974,1704139,1704139,0
12811,Tsiki Ntsabeleng,68,1463000,6479435626098226,344,3631164,2685746,0,2685746
12812,Kieran O'Hara,45,1671900,6297470533490629,280,3383699,2544190,25442,2518748
12813,John O'Sullivan,63,4796100,9081765853336330,665,8789339,4469607,44697,4424910
12814,Connor O'Toole,57,2727700,7801362741668163,419,5534143,1430975,1430975,0
12815,Linus Obexer,26,1253500,8600182279822024,117,1499387,633567,633567,0
12816,Emeka Oduah,55,2693300,8327765382249884,390,4905613,4446828,4446828,0
12817,Shadrach Ogie,59,3138300,5882282408442768,438,5661969,1294755,12948,1281807
12818,Ben Old,43,1166200,5179590077698803,239,2588693,1976924,1977,1974947
12819,Andrea Oliveri,42,2764500,4635326816558179,355,5299062,3790051,37901,3752150
12820,David Olsson,37,1646900,7143401956742485,208,2706671,17175,0,17175
12821,Halvor Rødølen Opsahl,39,2537500,7853767741005874,346,4638075,1516986,151699,1365287
12822,Orri Óskarsson,47,1424600,9998991906780664,247,2676469,2412916,0,2412916
12823,Moses Otuali,42,1679800,7463569967919284,246,2908023,1317200,0,1317200
12824,Kassoum Ouattara,53,302800,3135977806738597,167,1253224,129761,129761,0
12825,Lautaro Ovando,64,1068100,5961991111483767,310,3175224,2883218,0,2883218
12826,Nicolás Palavecino,50,1010100,7872966791352976,258,2576865,387880,38788,349092
12827,Park Chan Yong,30,3863100,4852588800409167,374,5871440,5174851,51749,5123102
12828,Park Cheol Woo,41,4356400,4930728896686015,505,7080111,2824769,283,2824486
12829,Kaheem Parris,64,2085500,5817441721979588,390,4596337,490886,491,490395
12830,Răzvan Patriche,55,4246100,9135100421775913,525,7885047,7158954,7159,7151795
12831,Phoenix Patterson,36,3435300,6984557803984784,323,4809098,3088299,30883,3057416
12832,Cristian Paz,33,4615500,7076884561447048,492,7651700,2498678,249868,2248810
12833,Kjell Peersman,24,1087200,5649857968896511,93,1323068,267529,0,267529
12834,Pei Shuai,34,4922500,8817869137828756,477,7701577,3725786,0,3725786
12835,Dženan Pejčinović,55,4674200,3450637975375812,582,9025919,4415837,4416,4411421
12836,Matti Peltola,52,4736300,6364242045212047,578,8252535,7070222,0,7070222
12837,Dion Pereira,39,3126900,6787301417529792,343,5182178,4863306,4864,4858442
12838,Brayann Pereira,24,3390700,6443001715375924,268,4989398,2933480,293348,2640132
12839,Dylan Perera,39,4580400,8622646961243194,489,8092931,4430828,44309,4386519
12840,Hugo Pérez,37,1082700,8881877723549404,192,2199977,468483,4685,463798
12841,Jeremías Pérez Tica,45,672500,9715209998488799,168,1690345,1114794,0,1114794
12842,Sonny Perkins,27,1937800,5351530955565384,196,2852369,450333,45034,405299
12843,Barne Pernot,31,1145500,9387796792221660,127,1569941,641342,6414,634928
12844,Nebiyou Perry,67,4696100,7856337887049877,643,9194531,6360858,0,6360858
12845,Jakob V. Persson,51,1474500,6415314145075391,288,3229994,2334806,234,2334572
12846,Marcel Pięczek,62,4911200,4928531905234084,664,9295177,1536004,0,1536004
12847,Diego Pineda,65,1464900,6521932725838484,395,4283217,2237084,0,2237084
12848,Gonzalo Piñeiro,45,1272700,9007955053235221,231,2494700,752563,752563,0
12849,Maksymilian Pingot,44,2633500,6803280377330521,349,4708017,3105153,311,3104842
12850,Virgile Pinson,45,1834300,9842507211968686,280,3494664,2381691,239,2381452
12851,Simon Pirkl,57,698100,9095485238334793,222,2045312,657670,0,657670
12852,Wiktor Pleśnierowicz,26,3661600,9327363898547045,313,5404541,1187370,1187370,0
12853,Dante Polvara,23,1500800,7551837151781248,142,1984816,448358,44836,403522
12854,Paris Polykarpou,65,1012800,4097791895452987,351,3195868,1428634,1429,1427205
12855,Álvaro Preciado,37,3629900,5465517676522087,370,5346664,4524501,4524501,0
12856,Branco Provoste,32,3638200,5428806933564310,369,6089482,6071675,607168,5464507
12857,Christy Pym,52,3282100,6017613130810698,486,6805375,4941741,4942,4936799
12858,Lirim Qamili,47,3244200,8026489017554958,422,5689264,5152717,516,5152201
12859,Mohammed Qasem,55,4288200,6858320471249036,569,7764918,3647832,365,3647467
12860,Sebastián Quintana,43,728600,8895753919094563,154,1607634,956465,9565,946900
12861,Apuia,55,360600,6469556215405370,212,1591962,202558,20256,182302
12862,Dion Rankine,37,3389000,8445678649765408,342,5307755,561692,56170,505522
12863,Nils Reichmuth,50,3662600,5774280790303972,511,6443754,4176504,417651,3758853
12864,Guillermo Rendón,28,664900,8037309685533297,71,761847,564295,56430,507865
12865,Lewis Richardson,67,1712800,5227256514278316,424,4442830,1538709,1539,1537170
12866,Joe-Joe Richardson,43,4589800,4014142808644927,520,7355817,3250546,326,3250220
12867,Manu Rico,30,422900,6858271989708224,87,746308,463294,4633,458661
12868,Liam Ridehalgh,35,4711800,7236960903866800,445,7383767,6083942,60840,6023102
12869,Alan Riquelme,34,1925100,8034637099970847,236,3287534,822442,823,821619
12870,Víctor Rivarola,41,3965200,6176303677324521,414,6484150,1589202,15893,1573309
12871,Scott Robertson,33,1726500,3589702537385165,217,2851592,166922,1670,165252
12872,Ethan Robson,43,1962600,7435205365845256,262,3410707,1526032,15261,1510771
12873,Yomar Rocha,60,2893700,5225659564695793,452,5778794,1029158,1030,1028128
12874,Agustín Rodríguez,42,2985700,9175103394578076,363,4724532,1254017,126,1253891
12875,Nahuel Rodríguez,59,2872900,7157389920038366,453,6063119,3218176,32182,3185994
12876,Adrián,63,4959200,5011548628288137,670,8779433,4334195,4334195,0
12877,José David Romero,64,2490000,7621492291317779,422,4940569,201942,20195,181747
12878,Lachlan Rose,27,4168000,5749929888681093,377,6382279,209091,209091,0
12879,Jack Rose,53,3343500,6628605849816190,456,6564676,2418694,0,2418694
12880,Martin Ove Roseth,57,1841300,5510487461322484,376,4332275,2634373,0,2634373
12881,Francesco Rossi,50,4654300,6863457579604395,554,7875557,3860016,3861,3856155
12882,Tim Rossmann,45,414200,3630476806894883,169,1286676,727633,0,727633
12883,Sean Roughan,38,4389400,3709418633156837,422,7406433,4850758,0,4850758
12884,Tate Russell,52,2414400,5661288036287037,337,4640086,4614334,4615,4609719
12885,Rijad Sadiku,67,4590400,9750076267683065,639,8725067,6418737,642,6418095
12886,Hussain Salem,37,1055900,9334388452272362,169,2021114,1891162,190,1890972
12887,Edilson Salinas,65,1577500,7690875537478841,349,3645731,27572,0,27572
12888,Daniel Samek,39,1641900,7091539091828401,228,2856716,475742,475742,0
12889,Alex Samuel,51,4680700,8167614518354345,474,6802659,5632956,56330,5576626
12890,Sidi Sané,60,3240400,7074287225133234,444,5974569,506745,507,506238
12891,Noa Savignac,24,4543000,7591698829172650,369,6397737,6275758,628,6275130
12892,Toby Savin,28,1925900,5217631395831127,169,2723850,773418,77342,696076
12893,Benjamín Schamine,54,1194900,4197094730711805,309,3001121,2657135,26572,2630563
12894,Tate Schmitt,51,1516900,3167596525034468,289,3460265,1139734,113974,1025760
12895,Florian Schock,40,1971400,8268195716373003,283,3847075,1563533,15636,1547897
12896,James Scott,38,3086100,4621598216015116,343,4872380,3537197,0,3537197
12897,Dante Sealy,42,4147800,7866623026906880,471,6681181,6078385,0,6078385
12898,Alexis Segovia,26,2834700,6612758806669358,264,3999472,523337,52334,471003
12899,Dennis Seimen,48,3764900,5563602500949885,453,6862238,3025887,30259,2995628
12900,Shin Chang Moo,51,4206000,9646033691806703,488,7396145,2023439,2024,2021415
12901,Artur Siemaszko,26,2432300,4641310962926141,252,3612764,2284181,0,2284181
12902,Kevin Silva,52,3128000,4652805973624968,389,5512559,5506253,550626,4955627
12903,Facundo Silvera,69,3265900,9249783534934677,572,7182201,91086,91086,0
12904,Amrinder Singh,47,2379900,8787853273759373,328,4049173,3600224,361,3599863
12905,Bipin Singh,37,4338800,4336433788477944,460,7013914,1089749,1090,1088659
12906,Chinglensana Singh,54,3727100,7482455860754522,495,6676395,5286716,0,5286716
12907,Anton Skipper,48,1384900,3475564921528596,240,2731894,1805828,18059,1787769
12908,Philip Slørdahl,50,1453600,4123499938109725,270,3078496,1102095,111,1101984
12909,Tobias Slotsager,69,494400,4785949592841011,321,2449831,781114,78112,703002
12910,Harry Smith,26,4944600,4249724964695260,398,6856235,946407,94641,851766
12911,Julio Soler,27,2530500,4152115062629948,253,3827377,2637959,0,2637959
12912,Łukasz Sołowiej,47,1397600,5271046062717340,257,3066037,1184969,1185,1183784
12913,Leon Sommer,49,3175700,8342154006072447,458,5941001,585086,58509,526577
12914,Song Ju Hun,43,4782900,7283613778301647,476,7912858,2989901,298991,2690910
12915,Song Long,70,338800,6195332940796920,356,2798475,1509281,151,1509130
12916,Pape Souaré,41,4157300,8609507142430975,480,6983522,1604735,16048,1588687
12917,Macauley Southam-Hales,36,2441400,8471899115617986,298,3922327,3680972,368098,3312874
12918,Ole Springer,35,690000,5497417112578663,103,1037307,975934,9760,966174
12919,Konrad Stępień,66,4685700,8466928595378012,614,8397156,7002449,0,7002449
12920,Jonas Sterner,59,4556400,7257277680945145,536,7843158,6620677,662068,5958609
12921,Fin Stevens,31,559400,6888921249612108,89,808831,153567,0,153567
12922,Ryan Stirk,65,1603100,4510444223421828,345,3553327,3447693,344770,3102923
12923,Relu Stoian,63,4561100,4331391662706863,648,8894144,7220573,0,7220573
12924,Igor Strzałek,61,313600,9699856401285143,277,2231052,808532,0,808532
12925,Yasir Subaşı,65,4992800,7093192332798964,671,8469000,4775448,4775448,0
12926,Jonathan Svedberg,59,4507400,6994530765062313,606,8349694,2345358,235,2345123
12927,Tomasz Swędrowski,37,4933800,4538813495491891,425,6549461,1608372,0,1608372
12928,Przemysław Szur,59,3460000,9906076496229497,448,5982710,3541395,0,3541395
12929,Patryk Szwedzik,24,1421900,9512436158439731,134,1896105,1138624,1139,1137485
12930,Diego Tapia,26,635100,8411341296062754,91,917351,37336,0,37336
12931,Ted Tattermusch,26,594100,4500326856752259,77,755242,127144,1272,125872
12932,Fábio Tavares,32,1692900,6730906642223133,163,2315496,652110,653,651457
12933,Jon Taylor,60,1194800,6766301447294396,275,2829155,1392880,140,1392740
12934,Christian Theoharous,62,3221700,9141844466267312,492,6018770,1780204,1780204,0
12935,Titouan Thomas,58,2308800,7963966721022916,422,5251764,2082342,20824,2061518
12936,Scott Tiffoney,29,4341400,3366061532532970,417,6901338,2788547,0,2788547
12937,Denis Tomic,64,744900,4572442184471462,307,2802323,333630,0,333630
12938,Tong Lei,24,535100,4096408934374597,71,709781,172308,1724,170584
12939,Gonzalo Torres,41,4298900,5982033398144430,479,7046941,5683310,56834,5626476
12940,Shilow Tracey,35,4032200,4368186615236927,381,6063946,5929409,59295,5870114
12941,Robin Tranberg,70,2030400,5420895449279596,490,5329888,5084444,0,5084444
12942,Mai Traore,56,4098300,8003032064691232,466,6858239,6209950,0,6209950
12943,Nick Tsaroulla,40,4545400,4013793349110639,556,7858001,5840690,0,5840690
12944,Rayhaan Tulloch,33,2800000,5577062449196317,269,4106752,693291,6933,686358
12945,Artemijus Tutyškinas,56,3400900,8029127631615159,465,6805603,4017254,0,4017254
12946,Nik Tzanev,57,627300,6074358557084632,303,2695482,1040692,0,1040692
12947,Dario Ulrich,62,1113300,5660125176420634,353,3201846,637250,637250,0
12948,Laurin Ulrich,35,2524500,7322265847617431,297,4015392,3981529,39816,3941713
12949,Bernhard Unger,22,1910700,8247585392710875,181,2844138,1848466,184847,1663619
12950,Christoph Urdl,66,791800,3485247074014083,302,2966790,2797782,2798,2794984
12951,Javier Uzeda,51,2841000,8712977648131074,393,5516449,702695,0,702695
12952,Anthony Uzodimma,50,1828200,7552221151123071,299,3494803,901799,0,901799
12953,Sebastián Valdéz,50,1260800,9474770115272912,275,2868692,789638,7897,781741
12954,Jack Vale,42,1512500,8487899626937943,247,2877696,402134,40214,361920
12955,Cristhian Valencia,28,2534100,8542894726723408,229,3769535,1504737,1505,1503232
12956,Rikelmi,38,812600,9882700763695433,154,1547497,1276520,0,1276520
12957,Rein Van Helden,63,4873700,7993476404470093,570,8509752,8345710,835,8344875
12958,Josue Vargas,56,2973500,9047290085071898,448,5704063,4937625,4938,4932687
12959,Robin Velasco,47,1734400,7134324747522803,279,3243020,890036,890036,0
12960,Nishan Velupillay,41,2229400,8252783778225258,254,3605611,1504072,151,1503921
12961,Fabricio Vidal,34,4497800,3258554678312339,410,6778022,1229807,123,1229684
12962,Jair Tavares,44,3854700,8431770800029581,416,6042911,4816702,4817,4811885
12963,Benjamín Villalta,44,2057900,8906780872418107,283,3870283,3159151,0,3159151
12964,Santiago Visentin,31,812900,6690118403773517,108,1227747,1025026,10251,1014775
12965,Kostyantyn Vivcharenko,67,720600,7511625432638392,338,2873293,2195762,219577,1976185
12966,Robin Voisine,60,2733000,6581699916910818,497,6383578,1900202,1901,1898301
12967,Eric Voufack,59,2768600,4691540901337419,451,5601525,753697,0,753697
12968,Romeo Vucic,53,4221600,7200264914226278,497,7074631,3910753,0,3910753
12969,Sebastian Wade,34,3323300,8320928367812241,331,5523269,5146734,514674,4632060
12970,Simon Walde,61,3821800,5778769625835516,537,7233712,1111558,0,1111558
12971,Falah Waleed,58,3685300,6962874864778197,493,7102024,1528537,1528537,0
12972,Bobby Wales,51,4358800,8961718537827393,478,6991915,6569289,6570,6562719
12973,Silvan Wallner,22,2028800,4802265702479347,138,2360376,365456,36546,328910
12974,Reuell Walters,31,3486900,7908556676969568,334,5683885,68389,6839,61550
12975,Wang Jianming,51,1145900,6307515222586773,250,2627716,1216021,12161,1203860
12976,Wang Song,48,2546500,9123196606444382,345,4377407,1742638,1743,1740895
12977,Wang Wei,63,1380200,6750138451944660,375,4170779,2115075,211508,1903567
12978,Lukas Wedl,46,4998800,7906922758358794,540,7864749,5620725,56208,5564517
12979,Jordi Wegmann,57,443400,4963198162297697,240,2102464,24781,0,24781
12980,Shaun Whalley,55,2000100,8080885384725489,368,4006429,2835178,284,2834894
12981,Felix Wienand,42,4151800,8218842420887268,519,7141039,339995,339995,0
12982,Josh Williams,43,1739800,8133331115777387,267,3261392,2554172,0,2554172
12983,Dylan Williams,37,687000,8299820123150330,151,1444893,25699,2570,23129
12984,Tomasz Wójtowicz,61,1745000,8889345288570924,390,4428669,418656,4187,414469
12985,Matty Wolfe,39,2775600,9939576361230327,347,4554134,188910,1890,187020
12986,Xu Xin,26,4882500,8481197109735928,461,7007092,4257697,0,4257697
12987,Xu Haoyang,67,1705000,3144577457463408,370,4071833,1281432,1282,1280150
12988,Yang Yiming,36,3337500,6561332126626625,353,5282416,3205986,3206,3202780
12989,Yao Junsheng,44,4639100,5990572069764461,501,7478706,3009238,300924,2708314
12990,Nathan Young-Coombes,55,4745100,7902763646585915,540,7817615,5852295,0,5852295
12991,Ali Youssef,23,4136100,3007317148060711,322,5638392,5435480,54355,5381125
12992,Yuan Mincheng,65,4850600,3526258434399160,665,8774859,1039491,1039491,0
12993,Sean Zawadzki,42,707500,4955012041810105,195,1675038,1605471,161,1605310
12994,Karim Zedadka,60,4318800,7617213665549256,641,7972431,2704212,2704212,0
12995,Zhang Yufeng,46,1083600,6303617064794860,226,2605056,2560515,0,2560515
12996,Zhang Jiaqi,45,4810800,9437679698482272,492,7478186,4825537,4826,4820711
12997,Zheng Long,24,3317300,6453647260728986,282,4470612,1407196,141,1407055
12998,Zhong Jinbao,65,2579600,5369362314050297,519,6097264,3731375,37314,3694061
12999,Sahal Abdul Samad,64,4806500,5741434573772345,624,8689933,1212680,122,1212558
13000,Sabit Abdusalam,53,4103600,5522664413723806,557,6990073,4680676,4680676,0
13001,Kelvin Abrefa,48,3570900,3382301838483578,434,6454606,1464082,1465,1462617
13002,Mohamed Achi,45,3119700,3669579919894943,430,5744694,3222314,0,3222314
13003,Jaime Acosta,35,1155400,5422302127625794,160,2007492,902626,9027,893599
13004,Emile Acquah,31,3182300,6793660680007606,277,4547238,2512235,25123,2487112
13005,Rio Adebisi,59,4070200,3139371780179426,517,6972606,6514988,65150,6449838
13006,Samuel Adeniran,53,3411700,6843655195859350,495,6865830,2680023,26801,2653222
13007,Jonathan Afolabi,43,1440900,5020816319897645,260,3169025,2766120,276612,2489508
13008,Brian Emo Agbor,51,2647200,9524811684050520,375,4872082,480746,0,480746
13009,Ayman Aiki,63,1323800,4230460790624379,312,3361872,2911174,2911174,0
13010,John Akinde,38,3772500,4252476197980177,363,5750820,4903261,4903261,0
13011,Abdulmalek Al Ayeri,69,2362000,9727057909148584,483,5271866,441824,4419,437405
13012,Yazeed Al Bakr,61,589500,3646012154422061,279,2521401,1498889,150,1498739
13013,Mohammed Al Baqawi,27,3609400,4550220004518894,320,5203810,2881719,28818,2852901
13014,Abdulrahman Al Barakah,24,3548600,6015513046979355,283,4666640,3540395,3541,3536854
13015,Zaid Al Bawardi,65,2689800,4000920253257531,491,5745427,4678769,46788,4631981
13016,Ahmed Al Ghamdi,46,4230600,8371188930779068,536,7129237,3649001,0,3649001
13017,Hazaa Al Hazaa,45,2478400,8035547383133648,342,4646283,4070906,0,4070906
13018,Hamad Al Jayzani,70,502500,5165556264453702,349,3028845,1766503,176651,1589852
13019,Fahad Al Jumayah,26,2517200,9594047486039376,197,3414380,3381894,338190,3043704
13020,Khaled Al Kaabi,52,1792900,4263559830778284,333,3533079,1911724,191173,1720551
13021,Saad Al Nasser,37,3885800,4764730174854673,398,6464059,2597744,2598,2595146
13022,Nasser Al Omran,22,1081700,4020180879915314,74,1177698,480708,481,480227
13023,Omar Al Owdah,40,2361700,4335755957079612,316,4242155,2526130,25262,2500868
13024,Mukhair Al Rashidi,63,2934500,9997850375155849,425,5533251,1740267,17403,1722864
13025,Fahad Al Rashidi,65,2463200,4566928265883214,457,5218352,251824,0,251824
13026,Ahmad Al Ruhaili,57,3817300,8818457692132587,514,6957496,1133294,1133294,0
13027,Abdulaziz Al Shahrani,65,4975200,6216410666938406,626,8103058,2370391,0,2370391
13028,Abdulmalek Al Shammari,46,3765800,7751272988470540,437,6345539,1075487,1076,1074411
13029,Mansour Al Shammari,42,2315000,9803440675451070,308,3931290,1653177,16532,1636645
13030,Hassan Al Shamrani,33,1856700,8296324045186542,219,3096285,337337,33734,303603
13031,Sultan Al Shamsi,49,1064400,4818908083471576,253,2585253,1964341,1965,1962376
13032,Abdulkareem Al Sultan,50,336000,7244822262423057,198,1477015,219225,0,219225
13033,Habib Al Watyan,46,2934100,6094149009553913,392,5516117,1757630,1757630,0
13034,Ali Al Zubaidi,51,2793800,6920015905704474,405,5092468,2657475,0,2657475
13035,Mohamed Al-Taay,62,3168400,4016661004327758,482,6243522,581642,581642,0
13036,Adrián Alcaraz,31,2234000,4915316993667343,232,3176181,1107956,11080,1096876
13037,Oliver Alfonsi,31,1426300,9301252121665692,200,2643545,2427556,0,2427556
13038,Mauricio Amaro,36,1424600,4681183685866153,244,2932126,624822,0,624822
13039,Lukáš Ambros,66,3670200,4303419759472871,574,7350600,2158333,0,2158333
13040,Alexander Ammitzbøll,23,2469200,6902810023217215,202,3538811,402448,403,402045
13041,Joe Anderson,55,1964200,4180534759003078,370,4385104,3658707,3658707,0
13042,Doru Andrei,26,432200,3850572875288702,53,441270,187262,1873,185389
13043,Stredair Appuah,27,2035500,9889958910775086,201,2944685,1270023,1271,1268752
13044,Juan Arias,56,4443900,7856298864033860,548,7680848,3221631,323,3221308
13045,Juan David Arizala,60,1469100,4320579360972444,327,3778972,56379,5638,50741
13046,Haitham Asiri,70,3491900,8468919120945876,570,7310991,6036468,0,6036468
13047,Abdulquddus Attiah,27,2847800,7946359461322615,226,3799907,3553619,3553619,0
13048,Axel Atum,38,1747300,9029181544001715,230,3068464,1915381,19154,1896227
13049,Keanin Ayer,40,2571800,6260963812913643,308,4293156,468742,0,468742
13050,Kwadwo Baah,47,2818000,5827168526723593,390,5088763,1294085,1295,1292790
13051,Onurhan Babuşcu,51,4936700,4771766266290686,564,8650676,5325977,53260,5272717
13052,Fin Back,39,3665700,4582992214146710,397,5811917,4956860,0,4956860
13053,Mio Backhaus,57,3307900,8100270611184220,463,6218520,4954530,496,4954034
13054,Elkan Baggott,38,556500,6066003260210762,136,1212280,901357,0,901357
13055,Owen Bailey,34,3500700,4009410218863678,362,5571899,4427562,44276,4383286
13056,Matt Baker,55,2835300,8865853422675891,412,5401130,1546313,1546313,0
13057,Ellery Balcombe,23,1047100,7049342613996908,120,1532307,551770,552,551218
13058,Giovani Bamba,55,1178100,7429798163296621,273,2772225,369557,370,369187
13059,Paweł Baranowski,39,2805900,8872518832744465,318,4936605,1902780,19028,1883752
13060,Hugo Barbet,55,832600,9032798595399467,234,2213640,989285,990,988295
13061,Ben Barclay,54,4591400,4679047118925521,597,8524762,6263958,0,6263958
13062,Daniel Barden,39,4556700,8906146368491231,469,7093974,4515413,452,4514961
13063,Williams Barlasina,47,2670900,5494798688556786,391,4815001,4067400,4067400,0
13064,Ryan Barnett,35,3637600,3126532028187872,394,5991723,4317525,432,4317093
13065,Diego Barrera,30,1256500,4169703926919971,154,1830355,178979,178979,0
13066,Hamza Barry,25,782200,6497578685044474,67,842836,832278,832278,0
13067,Jakub Bartosz,49,1119700,7281329857366030,241,2595930,865599,866,864733
13068,Teddy Bartouche-Selbonne,56,706200,9237282159391336,281,2517940,418920,419,418501
13069,Harry Beautyman,62,3894600,5360235313132161,577,7753384,570715,57072,513643
13070,Miguel Ángel Becerra,56,1524400,6672537999539313,291,3257475,3021599,3021599,0
13071,Edvin Becirovic,53,1936900,5730869241710294,322,4018279,1924289,0,1924289
13072,Yassin Belkhdim,24,2459300,9410741183074487,213,3420902,3084002,0,3084002
13073,Edgar Ramón Benítez,53,525900,6474883295472720,249,2054366,934212,934212,0
13074,Scot Bennett,47,3472800,3097969075455097,457,6691924,610147,611,609536
13075,Florian Bianchini,61,1199200,4787927859417894,335,3332930,2518660,0,2518660
13076,Huseyin Biler,52,1303400,7900965635650829,235,2622339,1397944,1398,1396546
13077,Nicholas Bilokapic,31,3385500,8932045782653395,346,5301335,2096733,2097,2094636
13078,Nicolas Binder,47,1868700,3886666690164796,298,3323006,1893954,190,1893764
13079,Nathan Bitumazala,27,3858100,9923884499852622,339,5429796,273354,274,273080
13080,Shane Blaney,46,4794100,4787947286854228,508,7975566,2616869,26169,2590700
13081,Malachi Boateng,38,3923100,6120507717977366,418,6411275,2553340,0,2553340
13082,Ben Bobzien,48,1488500,6567145826135896,255,2909479,2187729,2187729,0
13083,Ștefan Bodișteanu,56,2564100,9542326328859709,391,5173150,664198,66420,597778
13084,Pietro Boer,60,4781000,7235503682776855,571,7876923,4017073,401708,3615365
13085,Matthew Bondswell,26,3906700,9523841357386878,338,5697266,5313715,0,5313715
13086,Elias Bördner,40,1095500,4035951249259533,182,2136674,431507,4316,427191
13087,Nemanja Bosančić,44,3856700,4129420376672634,455,6670300,2655383,0,2655383
13088,Franci Bouebari,41,3663800,6056246086336518,409,5972487,1360859,1360859,0
13089,Jordan Bowery,33,3884200,8264632991426365,369,6141941,5413391,54134,5359257
13090,Ronan Boyce,60,2405500,3589107295522258,396,4907600,2618877,261888,2356989
13091,Mustafa Burak Bozan,57,1522300,4070865320460811,302,3299104,3029815,302982,2726833
13092,Roko Brajković,40,2677900,9410136695324645,326,4676476,211381,21139,190242
13093,Jamie Brandon,25,1773500,6260601208521145,164,2439667,2174596,2174596,0
13094,Max Brandt,58,2396500,5658005187430793,413,4714221,3799534,3799534,0
13095,Ciaran Brennan,37,1582000,4970680255244986,212,2760588,1748715,1749,1746966
13096,Lachlan Brook,61,639500,7513258939997245,305,2773686,439764,4398,435366
13097,James Brown,42,3341200,3080272423906645,399,5675082,4830223,483023,4347200
13098,Mohammed Bu Sanda,45,1926400,6210706054479714,295,3638364,1083791,109,1083682
13099,Tarek Buchmann,68,4767500,4594680927825616,715,10212172,9980712,0,9980712
13100,Aleksander Buksa,32,3972300,6230582348651019,388,6321351,625855,62586,563269
13101,Harry Burgoyne,54,4165800,4045925722218679,523,7091931,5263995,5264,5258731
13102,Kendall Burks,52,1041600,6083568359230916,272,2713393,1725130,1726,1723404
13103,Finley Burns,51,3037500,6056415488777680,450,5839894,3960811,397,3960414
13104,Luke Byrne,59,4625100,3837735453306607,635,8888645,5138194,5139,5133055
13105,Joaquín Cabrera,56,2054000,5827140876871349,360,4463066,609577,609577,0
13106,Damián,30,4991700,8428181059805371,440,7414350,4797787,0,4797787
13107,José Aamet Calderón,57,3114100,6301205116335082,496,6793469,6792962,679297,6113665
13108,Joe Caletti,58,2919100,9066945753711563,432,5496423,3524040,35241,3488799
13109,Ousoumane Camara,30,4012600,8300220321072177,398,6260013,4092534,410,4092124
13110,Dean Campbell,33,361200,4708244983047677,103,729258,471846,0,471846
13111,Phillip Cancar,62,3305200,7394201427052427,461,5873079,3957474,3958,3953516
13112,Valentín Carboni,63,3018000,4161141637132911,491,6041226,4093273,4093273,0
13113,Nico Carrera,67,2953000,6377508306671915,574,6272742,3497092,349710,3147382
13114,Luis Armando Castro,33,1573400,7650097897983793,190,2489234,433172,0,433172
13115,Juan Cruz Cerrudo,45,4988000,8308454465620587,539,7793612,1379412,0,1379412
13116,Youssef Chaib,53,3229600,8981801830072965,475,6174694,1015380,102,1015278
13117,Kegs Chauke,62,2637900,7720146731174288,440,5108579,4190793,0,4190793
13118,Choi Chul Soon,40,2138800,9262198944278096,282,3625187,1600102,0,1600102
13119,Choi Young Eun,46,365800,7552509109380141,192,1590477,1112887,11129,1101758
13120,Mirza Cihan,70,4030800,7079923256935515,646,8713176,5488993,548900,4940093
13121,Momo Cissé,41,3687200,5184884957480012,374,5608923,1108293,1109,1107184
13122,James Clarke,46,3202100,8693594462009615,420,5726946,5576005,5576005,0
13123,Max Cleworth,57,3721900,6791682578816034,560,7385649,3994971,0,3994971
13124,Liston Colaco,61,4421200,3309176563808819,564,7875078,7459544,74596,7384948
13125,Ethan Coleman,35,394100,9919979029059218,121,1024388,611575,61158,550417
13126,Ciarán Coll,56,2497400,3025657146600670,397,4826449,2398265,0,2398265
13127,Kamil Conteh,65,3651900,6146864850317833,521,6461754,1895446,18955,1876491
13128,Cameron Cook,25,1631500,9103435212682584,160,2472086,2130959,21310,2109649
13129,Grégoire Coudert,33,1774600,3194954299603504,174,2601216,1897419,18975,1878444
13130,Vaughn Covil,61,4426600,9302695309279941,572,7324337,5493817,5493817,0
13131,Trae Coyle,57,1823600,8384755496066161,416,4491540,3712700,3713,3708987
13132,Tristan Crama,69,1083500,7545157562225374,398,3729706,1052827,1052827,0
13133,Filip Čuić,37,2799300,7414199721393849,318,4530087,1630954,1630954,0
13134,Pontus Dahbo,25,932200,9795068116760636,79,1086546,1033303,10334,1022969
13135,Matty Daly,70,3232700,4997654084841917,606,7451320,6205188,6205188,0
13136,Ronan Darcy,52,4674800,3295321138058514,588,8262005,1998859,200,1998659
13137,Mattis Daube,26,4875400,4803254940438819,457,7647686,5932200,5933,5926267
13138,Jacob Davenport,65,3567300,3507204492466165,545,7224375,820539,821,819718
13139,Jake Davis,38,2578700,8035705274960926,289,3837884,2538760,2539,2536221
13140,Filipe de Carvalho,44,1862900,8111944361748026,269,3588394,2226346,222635,2003711
13141,Ryan De Havilland,24,962100,6156353756725468,70,966583,117169,1172,115997
13142,Nils De Wilde,62,3006600,4441954830058436,484,5923021,2698494,269850,2428644
13143,Laurenz Dehl,65,2976500,5472826523903607,538,6602052,3751008,0,3751008
13144,Emeric Depussay,35,872600,9595012184085481,146,1549978,1314042,131405,1182637
13145,Matt Derbyshire,34,3967800,4926879513738339,365,6098819,4466705,4466705,0
13146,Jacopo Desogus,34,2213500,8158098079263274,222,3027812,1842872,1843,1841029
13147,Adam Devine,43,880100,6055242152853610,184,1855166,869947,86995,782952
13148,Terry Devlin,46,1844500,5841128838148508,277,3424658,3358151,336,3357815
13149,Lassana Diabaté,54,981300,4759467827620486,277,2594027,2185094,2185094,0
13150,Mamadou Diakhon,59,3912200,5341902547287677,524,7231813,6349802,0,6349802
13151,Samba Diallo,44,4639600,4550734472690661,500,7661363,297016,0,297016
13152,Papa Amadou Diallo,42,3034400,5488621818796077,362,5305300,4539092,0,4539092
13153,Daan Dierckx,37,525400,3630499601422977,130,1095446,22447,225,22222
13154,Elijah Dixon-Bonner,70,3414000,4935864245346470,541,6766499,4453184,446,4452738
13155,Noah Dodeigne,40,3731700,9141408448167414,383,6183294,4716807,472,4716335
13156,Jota Pereira,55,4113400,6882666382471658,571,7190715,2146920,214692,1932228
13157,Patryk Dragon,30,1623300,6349689071208571,200,2724021,1697807,0,1697807
13158,Aaron Drinan,58,2064700,6586247394174245,406,4745128,655250,0,655250
13159,Jack Duncan,67,4928900,9583751183966710,662,9589781,1181315,119,1181196
13160,Zach Duncan,37,2085900,5414496485107621,258,3728099,2799413,2800,2796613
13161,Eldin Dzogovic,24,2390900,5508435870015025,174,3377972,2353228,2354,2350874
13162,Jake Eastwood,68,3729300,5149714825433746,601,7669309,1577690,1578,1576112
13163,Michee Efete,62,3982200,5338906055966455,508,7622754,5094707,0,5094707
13164,Abo Eisa,49,4302300,5797680429562112,505,7409797,1389132,13892,1375240
13165,Omar El Sawy,49,3164100,9268152849381838,461,6376658,5594467,55945,5538522
13166,Ole Enersen,55,4408500,4520309261340024,519,7088184,6978090,6979,6971111
13167,Jacob Eng,49,1283100,6322490261046144,250,2995700,2734003,2735,2731268
13168,Jusef Erabi,43,1478700,7829625134609908,246,2810905,1157087,0,1157087
13169,Tjark Ernst,43,3349800,7057245926746362,399,5584323,123291,0,123291
13170,Lucas Escobar,43,1689200,6150058578322971,272,3244610,2495588,0,2495588
13171,Shane Farrell,66,4878500,6606132348364424,758,9461502,5584272,0,5584272
13172,Stefan Feiertag,37,2583900,4386336848756248,279,4237403,2799199,2799199,0
13173,Mattia Felici,38,4743800,4365142173954534,499,8173652,7694817,7695,7687122
13174,Michał Feliks,32,347200,5765018653135194,78,536544,475820,0,475820
13175,Feng Zhuoyi,63,909200,5421416631980377,364,3508574,1312014,132,1311882
13176,Max Fenger,37,2455100,6043329198207233,277,3934325,1184925,118493,1066432
13177,Ramzi Ferjani,68,3465100,7713910473190235,544,7283608,1769098,17691,1751407
13178,Seriton Fernandes,43,2013600,8814526163723963,296,3774924,1368924,13690,1355234
13179,Manuel Ferrel,30,1567400,9514292957237540,172,2171512,1485655,0,1485655
13180,Alin Fică,48,3565500,8882525423421093,475,6491899,5231974,0,5231974
13181,John Patrick,70,1644600,7393362839778778,410,4153831,428124,4282,423842
13182,Scott Flinders,46,2444700,7355072303042561,299,4010435,1835389,183539,1651850
13183,Louis Fortin,37,2853400,4268699676948893,308,4120540,309187,310,308877
13184,Robin Friedrich,56,2128800,3895945332077068,395,4528225,2874349,28744,2845605
13185,Tom Gaal,39,4856900,6825188786297660,546,8308444,5792108,0,5792108
13186,Tony Gallacher,46,3183100,8650627946640261,395,5334199,3457333,0,3457333
13187,Quentin Galvez-Diarra,44,1475100,3059145717572131,261,2992804,1402357,140236,1262121
13188,Gao Tianyu,33,2707200,4690707025271866,286,4263475,1575893,1576,1574317
13189,Ambroise Gboho,67,4174500,3287974756552313,650,8290480,3516972,351698,3165274
13190,Herman Geelmuyden,42,1998200,4130888411242536,281,3522249,2018046,20181,1997865
13191,Max Geschwill,31,4498400,4680230913259368,403,6572613,6232566,62326,6170240
13192,Alex Gilbert,38,2971100,4270861253477152,298,4510520,2256521,2256521,0
13193,Ciaran Gilligan,58,363500,7271602629112780,263,2153871,2005032,2005032,0
13194,Samuel Giovane,27,2218300,8118727957999347,216,3024107,2467455,2468,2464987
13195,Julian Gölles,35,1943400,5052651446408674,234,3315171,2625806,0,2625806
13196,Matías González,45,4139000,6536648896296106,414,5982524,4844035,485,4843550
13197,Dani González,23,2797600,5482701296722030,272,4483525,2819572,2819572,0
13198,Owen Goodman,42,1358600,4564833130100312,268,2916773,1562367,15624,1546743
13199,Will Goodwin,33,1193400,7246823091452387,167,2067752,1551126,1551126,0
13200,Dennis Gorka,27,2438900,5844300047916606,200,3087981,1747661,174767,1572894
13201,Danny Grant,42,3276200,6352405198586235,349,5240696,4619351,0,4619351
13202,Aaron Greene,45,3646600,3076960637603601,437,6035554,2914847,292,2914555
13203,Kostandinos Grozos,67,2011700,7047573508719898,431,4856631,4226779,0,4226779
13204,Fabio Gruber,45,2545500,4862477572638902,289,4172285,2847927,284793,2563134
13205,Gu Bin,70,1302900,9643558905232584,394,3972853,2895442,28955,2866487
13206,Braian Guille,57,2412700,6240146975830338,374,4641737,3474081,3475,3470606
13207,Gustavo Santos,23,4389000,6097066502433782,342,6283333,2793576,2794,2790782
13208,Peter Gwargis,38,1309300,9505713044611584,186,2298941,1285196,12852,1272344
13209,Justin Haak,24,2800900,4654251767549860,228,3744443,2173702,0,2173702
13210,Antwoine Hackford,52,1448200,7455685888062456,337,3713989,1515989,0,1515989
13211,Wojciech Hajda,36,489200,3673433942950375,116,1047146,255792,2558,253234
13212,Han Chan Hee,41,1433200,9624195222064440,226,2805115,2213896,221390,1992506
13213,Han Seung Gyu,36,755200,9871270841103189,147,1457590,166093,167,165926
13214,Moritz Hannemann,43,4729800,4732480604536220,468,7147871,6937409,6938,6930471
13215,Mattes Hansen,58,1058400,9032709891281050,301,3032313,2779689,27797,2751892
13216,Kornelius N. Hansen,69,2420400,5245039453609130,490,5944919,186866,186866,0
13217,Yassine Haouari,47,1002200,6159344536715409,229,2313636,1505276,150528,1354748
13218,Kian Harratt,53,2272100,3928949825873134,348,4307713,3193345,31934,3161411
13219,Abdullah Hawsawi,58,3927800,3764108902089818,536,7434426,2378845,238,2378607
13220,Cian Hayes,27,1042400,9204558722648832,116,1424114,485969,486,485483
13221,Justus Henke,70,2925700,5598123055287825,483,5615641,2159734,21598,2138136
13222,Matías Hernandez,68,4849900,8900876415197461,612,8500795,6274355,628,6273727
13223,Jack Hinshelwood,22,2085500,3844702202181408,175,2768898,1192858,1192858,0
13224,Jordy Hiwula,53,1800300,7385313701698915,307,3925803,81431,8144,73287
13225,Jason Hoffman,59,718100,6783236455438945,238,2152729,1135144,0,1135144
13226,Will Hondermarck,41,1048000,5387283446875671,162,1827253,747004,74701,672303
13227,Kevin Höög Jansson,61,1857600,5437595343814923,400,4110577,3387350,0,3387350
13228,Charly Nouck Horneman,62,4832000,7990821923771687,670,9182164,4281546,42816,4238730
13229,Hou Sen,30,2101700,6665964591730092,213,2999171,163595,163595,0
13230,Mark Howard,38,1906600,4444146320533382,281,3543994,574582,575,574007
13231,Ryan Howley,61,3122900,8758638120067427,465,5782618,4945921,0,4945921
13232,Niall Huggins,22,3706300,4512618552764069,299,4977320,3719119,0,3719119
13233,Reece Hutchinson,34,1949000,6596832153298361,220,3211379,499983,5000,494983
13234,Fabricio Iacovich,65,4005100,3292761900999248,570,7987815,3094092,0,3094092
13235,Arijon Ibrahimović,54,840600,3048504261827040,246,2414167,2335042,234,2334808
13236,Denys Ignatenko,53,1642200,7606030574501909,309,3633257,190765,0,190765
13237,Pedro Gomes,24,320500,9927346803600931,33,194492,63629,0,63629
13238,Richard Iriarte,62,3962500,5957259723843553,599,7454287,6177055,61771,6115284
13239,Felix Irorere,35,4012500,4221310482402900,435,6295535,3554481,3554481,0
13240,Christian Jakobsen,64,1031800,9596785098285664,330,3397739,1531559,1531559,0
13241,Lewis Jamieson,66,1898900,7139041081087434,386,4361871,745869,0,745869
13242,Jang Jae Woong,28,2957800,6607463651089539,222,3825515,784584,0,784584
13243,Jang Seong Won,28,4171500,8111150750268892,361,6016786,3866916,38670,3828246
13244,Justin Janitzek,55,2181700,7166407685648670,362,4515636,1220419,122042,1098377
13245,Vasile Jardan,25,3620400,9008771081795426,296,5094562,2199793,2200,2197593
13246,Andres Jasson,23,4299600,7142362870887489,367,5732911,562155,0,562155
13247,Alassana Jatta,68,4762300,8741887234652286,673,9187171,7517457,0,7517457
13248,Lars Larsson Jendal,44,3470200,4918487214688299,411,5948681,5523534,553,5522981
13249,Jonas Jensen-Abbew,30,1602900,5177844561293612,160,2264431,2164560,21646,2142914
13250,Ryan Johnson,62,2927800,4075961539886467,420,5494583,422887,0,422887
13251,Louis Jones,54,3767000,9284329627173491,473,6477221,4140882,0,4140882
13252,Pat Jones,67,316800,5005288340174353,293,2349492,1464745,146475,1318270
13253,Yahya Kalley,28,4913900,6626224897525974,419,6591056,3463514,3463514,0
13254,Abu Kamara,63,1980900,7639713033144312,390,4361883,525905,526,525379
13255,Bobby Kamwa,33,2550000,8987204955268865,236,3429537,2031229,204,2031025
13256,Chris Kane,26,4032000,8590452040563768,330,5721291,963303,0,963303
13257,Markus Karlsson,66,1271600,3817593189522367,399,3928994,2082863,0,2082863
13258,Kazper Karlsson,59,3973500,3221448681235353,510,6513872,2226533,2226533,0
13259,Scott Kashket,47,3073900,4354596494748210,379,5579867,3001356,0,3001356
13260,Sean Kavanagh,30,4341000,5593728634705286,414,6769670,6110598,0,6110598
13261,Al-Amin Kazeem,63,4007900,4468507684590395,609,8057952,7033562,0,7033562
13262,Jack Keaney,64,2221700,8537472042250917,409,4897957,20254,20254,0
13263,Ruairi Keating,26,2428800,4597455255394888,254,3406747,1851814,185182,1666632
13264,Amadou Keita,34,948400,6880742179194664,140,1551158,18120,18120,0
13265,Deandre Kerr,64,4924200,9165692229191605,584,8503464,4516882,0,4516882
13266,Rok Kidrić,48,3086200,8245053385464926,371,5297193,49313,49313,0
13267,Ben Killip,67,1505500,8971403029177356,373,3738763,1133411,0,1133411
13268,Kim Woo Suk,51,1624900,4672122283345088,343,3718418,1273280,127328,1145952
13269,Kim Gyeong Min,28,1998100,8239222936339347,218,3224784,1003777,100378,903399
13270,Kim Shin Jin,37,3709500,3723673900608136,388,6302646,2994844,0,2994844
13271,Kim Tae Hwan,44,816700,6045852418716552,174,1703940,1102490,111,1102379
13272,Benjamin Kimpioka,37,4894200,4704964756054791,491,7735544,3235228,0,3235228
13273,Eli King,49,4513600,8179850762424677,488,7183530,5072294,0,5072294
13274,Jeppe Kjær,37,4847300,5203764273683514,497,7316617,3960223,3960223,0
13275,Mike Kleijn,46,982700,6789018186753173,200,2044818,1829768,1830,1827938
13276,Daniel Klein,56,2053800,7729739478138548,410,4717235,2497408,2497408,0
13277,Pascal Klemens,33,2229500,4101002689823084,258,3652473,1946525,1947,1944578
13278,Ben Knight,30,703800,4126246580369577,88,1028910,375916,0,375916
13279,Michał Koj,41,2148700,5071170614572932,277,3764332,349468,34947,314521
13280,Mert Kömür,29,3213900,9852799646781410,281,4743176,1254591,1255,1253336
13281,Stefan Korsch,49,1606800,4034366549270463,310,3441215,3168261,317,3167944
13282,Christ Kouadio,67,1256300,4099465117608412,373,3556175,1671662,0,1671662
13283,Damjan Kovacevic,45,2966200,6576964845881640,358,4944907,4111329,412,4110917
13284,Marco Krainz,34,429200,6823134963667179,79,632902,497886,0,497886
13285,Kreshnik Krasniqi,57,4109600,3638078291499564,541,7664823,1260376,127,1260249
13286,Jonas Krumrey,67,4441600,5773082030506891,545,8279511,1463739,147,1463592
13287,Theodore Ku-DiPietro,65,2690000,3622881986254601,501,5896225,3928741,393,3928348
13288,Pascal Kuiper,36,4456600,5058789768371084,440,7181064,1889787,18898,1870889
13289,Willy Kumado,55,2397700,4105169543534853,436,5142155,3536727,0,3536727
13290,Amir Kurdi,28,2706400,4946594589041133,276,4168640,2603334,2604,2600730
13291,Bram Lagae,40,2640900,5163081109305984,320,4490569,2515426,0,2515426
13292,Juan Larios,33,4753200,3618632079113647,493,8044946,6362177,0,6362177
13293,Barry Lauwers,48,1083400,7207472725830562,224,2392880,514270,514270,0
13294,Nico Lawrence,42,3226000,3460515715859608,388,5542145,876867,87687,789180
13295,Théo Le Normand,48,4905500,4875975864068467,509,7875943,2752712,27528,2725184
13296,Lee Ho Jae,67,1657300,8684580791419607,370,4178119,3943329,3944,3939385
13297,Lee Sang min,60,1558900,9769373862998027,325,3567634,2569982,257,2569725
13298,Lee Keun Ho,32,2641600,4655447074100675,291,3976896,383893,0,383893
13299,Lee Jong Sung,51,3122400,8363620422818246,485,5805327,3673714,0,3673714
13300,Jayson Leutwiler,69,3853100,7256128628233523,573,7380470,15466,1547,13919
13301,Joe Lewis,56,1556100,6712141977174072,359,3705054,789056,789056,0
13302,Li Huayang,38,785800,7828149370975385,170,1610184,1175091,1176,1173915
13303,Li Yuanyi,29,4854200,8923575897766472,391,7369734,250261,0,250261
13304,Lorenzo Libutti,57,720800,4487998043896109,271,2455428,1793784,1794,1791990
13305,Yann Lienard,36,1546600,5031868169399621,205,2498307,2167100,217,2166883
13306,Lin Longchang,61,2628600,6429133624660182,425,5490996,879056,0,879056
13307,Wojciech Lisowski,48,3440700,7197543803941712,436,6100423,2033879,203388,1830491
13308,Liu Ruofan,26,4634800,6464996756095086,366,6521851,5539568,554,5539014
13309,Aboubacar Lô,37,4077700,9006037449887316,405,5802883,5577096,5577096,0
13310,Scott Loach,43,2384700,6018012510180927,284,4095954,734761,0,734761
13311,Élysée Logbo,50,3023700,3005129573760139,444,5828120,5384807,5385,5379422
13312,Albin Lohikangas,63,3730800,7511830078174156,584,7434462,244714,0,244714
13313,Jesús López,66,2915900,4732389483917872,513,6500641,519394,0,519394
13314,Mieszko Lorenc,48,4704400,9546032823764484,498,6966668,6228575,6229,6222346
13315,Johaneko Louis-Jean,47,973500,7315285113770873,212,2276345,2067778,207,2067571
13316,Evan Louro,28,781400,5338483402160568,98,1044206,559011,55902,503109
13317,Marcel Łubik,57,4654200,6189762294351309,582,8310523,5517567,5517567,0
13318,Yannik Lührs,22,4675200,8604454579091325,381,6929583,4869953,486996,4382957
13319,Alexander Lundin,42,1141100,3963264001210844,212,2344933,424287,424287,0
13320,Luo Xin,44,2801600,8818022177879766,352,4690022,4092151,0,4092151
13321,Sylwester Lusiusz,28,1997900,9095196966224125,214,2992157,1437416,1438,1435978
13322,Alexander Lyng,36,2404800,6724526623946776,281,3873765,1455698,145570,1310128
13323,Charles M'Mombwa,24,4255700,6833896084458362,340,6122510,1862019,186202,1675817
13324,Lewis Macari,24,2178900,6831063930524409,166,2616283,1908435,1909,1906526
13325,Sebastian Madejski,30,461800,9878158230046528,74,664566,388552,389,388163
13326,Mohamed Belhadj Mahmoud,33,1674100,7583299505930255,203,2803088,1055933,1056,1054877
13327,Navin Malysh,65,1240200,8190126040616421,338,3182609,1899485,0,1899485
13328,Josh March,32,679000,7301716627599583,132,1228238,23309,0,23309
13329,Francisco Marco,35,4496300,3456660937427328,428,7237517,1836880,183688,1653192
13330,Adnan Marić,37,3242200,7408300545734995,356,4981990,870204,0,870204
13331,Darragh Markey,38,3753300,5139690114761256,396,6606895,2438149,0,2438149
13332,Jahkeele Marshall-Rutty,70,1000200,7956862777979213,369,3425704,2689117,2689117,0
13333,Franco Martínez,49,3757800,8570617640920425,438,6194338,3412081,341209,3070872
13334,Boipelo Mashigo,35,2662300,9839571317404597,301,4067570,3926511,392652,3533859
13335,Ulrik Mathisen,44,1956000,9992648837127497,291,3759126,903859,9039,894820
13336,Faiz Mattoir,28,2404800,5783143868031606,226,3725620,1394779,0,1394779
13337,Pelle Mattsson,64,3179300,5181399171126821,532,6058963,2751963,0,2751963
13338,James Maxwell,45,4972300,5107868480920800,573,8810326,3071206,3072,3068134
13339,Derek Mazou-Sacko,51,3132500,6015923085325630,433,5525797,1368509,1369,1367140
13340,Declan McDaid,25,1196000,5475285900764050,106,1536428,886292,887,885405
13341,Callum McFadzean,37,998500,3639220466111996,191,2026726,829888,829888,0
13342,Jamie McGonigle,59,2667900,4949557904476452,478,5802667,1701582,1702,1699880
13343,Cameron McJannet,23,2335600,8970932087947175,220,3196969,1363026,137,1362889
13344,Shane McLoughlin,70,2839800,5160105596860107,478,5855498,4773511,477352,4296159
13345,Daylam Meddah,47,4782000,5038578462710742,536,7409347,2864473,0,2864473
13346,Elias Hoff Melkersen,50,3269000,5564420154115893,394,5348187,4013048,4013048,0
13347,Tomás Mendes,41,775100,8010578930619234,207,2122669,873377,8734,864643
13348,Diego Méndez,40,3017400,9804806164598044,358,5018752,2589065,0,2589065
13349,Juan José Mera,34,1030600,3789060461055855,174,1858371,901867,901867,0
13350,Kai Meriluoto,29,4855000,5212190871441915,496,7515865,3587206,359,3586847
13351,Sergio Mestre,29,4214100,8797501380935975,335,5668446,1150994,1150994,0
13352,Nicolás Meza,28,2225300,3859481589995634,238,3420321,1893484,190,1893294
13353,Kacper Michalski,56,1186600,9842910832766882,305,3242307,2294227,230,2293997
13354,Ole Erik Midtskogen,28,4228300,9321597166889069,390,6244254,2396892,23969,2372923
13355,José Miers,25,3467400,3267749502362537,293,4806604,3204956,32050,3172906
13356,Nicolas Milanovic,35,820600,3276247955424315,152,1584437,1419825,1420,1418405
13357,Noel Milleskog,31,1724100,7524118345498078,177,2434019,2115248,212,2115036
13358,Sorin Mogoșanu,29,4114600,4291813865128089,344,6116105,3994104,400,3993704
13359,Tomasz Mokwa,34,1556000,3895253009862265,204,2664968,962475,0,962475
13360,Vladislav Molchan,35,1445000,7823930949341922,185,2377038,1064992,106500,958492
13361,Nikolaj Moller,50,3930000,6700406390303473,487,7106119,1724617,1724617,0
13362,Thaddäus-Monju Momuluh,68,3637800,6659061359651594,592,7744330,1001891,0,1001891
13363,Madi Monamay,65,2442100,8943748732449120,420,5434139,3441819,34419,3407400
13364,Santiago Morales,45,1338400,9163714630546466,288,3252538,210025,0,210025
13365,Valentyn Morgun,34,4162400,3709309717026064,372,6538984,5217999,52180,5165819
13366,Sander Risan Mørk,30,1188100,9266119857079800,122,1644670,1065904,1066,1064838
13367,Shayden Morris,65,2514800,5309185340585450,417,5035012,4203690,4203690,0
13368,Bryn Morris,35,2645500,7700468642825582,271,3975136,435609,435609,0
13369,James Morris,35,319100,8973913206862256,75,558961,527030,0,527030
13370,Jack Moylan,65,3105500,7328263650541601,473,6021244,2088357,0,2088357
13371,Joaquín Muñoz,52,4926500,9028136283160168,564,7980181,831822,0,831822
13372,Leonhard Münst,28,3114600,9679283372539226,258,4126735,2534808,0,2534808
13373,Joe Murphy,45,646900,4355653606289465,170,1615298,13225,0,13225
13374,Noah Nadje,23,1470500,8743682374640094,150,2050262,564532,56454,508078
13375,Stav Nahmani,62,1922300,6665410003437784,385,4228736,3781244,3782,3777462
13376,Filippo Nardi,58,2231400,6531731254276471,376,4768918,1454376,14544,1439832
13377,Marco Nasti,47,1070200,9613298715597959,261,2619413,93215,0,93215
13378,Jefferson Nazareno,28,3223400,9990105865353781,250,4563257,1269907,12700,1257207
13379,Josh Neufville,69,2839500,3887275876674345,544,6590988,37715,378,37337
13380,Oumar Ngom,59,2327600,7377793767262907,400,4954312,1640094,164010,1476084
13381,Jonas Nickisch,42,758600,7855856208626992,157,1574290,706453,7065,699388
13382,Marc Nielsen,26,4863100,6583079283464211,388,7343405,3088881,0,3088881
13383,Vinícius Nogueira,64,4409700,6518484399090489,617,8321253,8082591,809,8081782
13384,Alexander Nybo,70,696800,3716001656098349,346,2863360,1687618,1687618,0
13385,Franklin Nyenetue,58,3951600,3990935632742379,492,7271264,2691662,2691662,0
13386,Stephen O'Donnell,42,2634300,4336899070772510,344,4748850,4649548,4649548,0
13387,Ryan O'Kane,24,3306900,6333680293763725,266,4686262,3067453,0,3067453
13388,Odel Offiah,70,4746800,7770119615636165,694,9385860,8581926,85820,8496106
13389,Mazeed Ogungbo,38,3273300,3875731185705809,374,5495290,5099735,0,5099735
13390,Oh In Pyo,26,561000,6725612578928015,47,525370,325164,326,324838
13391,Michael Olakigbe,25,2958400,8153665170485148,294,4671754,4518523,452,4518071
13392,James Olayinka,35,2031200,9116215274671483,209,2921150,2629827,0,2629827
13393,Bruno Bertinato,56,2983700,7973247182706345,398,5511746,5158267,5159,5153108
13394,Edu Borges,51,4046400,6868037319009861,515,7043550,126972,127,126845
13395,Jonas Olsson,23,418300,7780282288989948,17,142609,49393,0,49393
13396,Samed Onur,33,4630100,6718697461399235,490,7654722,7425473,7426,7418047
13397,Tyler Onyango,50,2655900,3133038432768170,365,4882383,781997,782,781215
13398,Leo Oppermann,33,674500,7314843492303166,128,1248178,148135,0,148135
13399,Louis Oppie,29,2146000,9240779716221690,225,3310015,2539005,25391,2513614
13400,Kristian Opseth,44,1474700,8989270207664977,249,2975764,1901182,190119,1711063
13401,Emmanuel Osadebe,46,4956400,6737198906647448,610,8557451,1804060,181,1803879
13402,William Osula,45,4845500,9278939115310627,563,7583221,6730339,0,6730339
13403,Aramide Oteh,52,2434100,8108151163537066,421,5188800,4355276,4355276,0
13404,Mansour Ouro-Tagba,64,3883900,3989218522739194,605,7440548,455841,456,455385
13405,Daniel Oyegoke,70,607100,4279093772447433,366,3186171,2685043,2685043,0
13406,Kamil Pajnowski,50,902600,5508404292639909,226,2061567,917265,917265,0
13407,Agustín Palavecino,31,493100,9842552416660012,92,808134,186638,186638,0
13408,Jan Paluska,25,1138600,9507966609581254,107,1503337,1437222,143723,1293499
13409,Pan Ximing,26,1530100,3562791849103294,151,2180123,1821043,1822,1819221
13410,Park Dae Won,38,4109800,7938525813998295,451,6472189,4463309,0,4463309
13411,Park Sang Hyuk,25,2129900,4930079225138451,174,3104983,692871,0,692871
13412,Luciano Peraggini,29,4763900,7791473835358960,419,6793983,791643,0,791643
13413,Leonardo Pérez,67,863200,4305245428867995,391,3710311,3162302,0,3162302
13414,Mateo Pérez,38,3522300,5267217061846489,424,6525179,2410999,2411,2408588
13415,Joakim Persson,53,2640100,3643539611193192,379,4750333,2059457,20595,2038862
13416,Ashley Phillips,52,2292100,4478065712609108,329,4207478,183260,184,183076
13417,Gabriele Piccinini,34,1919100,5529684254914472,194,2869363,997182,99719,897463
13418,Daniel Pik,67,3354500,3067516132557146,491,6444399,5708084,5708084,0
13419,Niccolò Pisilli,49,4590500,7855042031239685,565,8391539,1685989,0,1685989
13420,Markus Poom,30,4401000,6445238659158298,362,5859224,3515108,3515108,0
13421,Simon Power,47,4647800,4515647247899472,564,7630250,6297546,6297546,0
13422,Ralph Priso,58,4174900,6089748427127119,572,7148656,1662638,16627,1646011
13423,Jamie Proctor,22,1465500,7506200884955648,114,1944408,1330151,1330151,0
13424,Tymur Puzankov,33,335700,9376641941253918,96,732910,71055,711,70344
13425,Joshua Quarshie,59,1557600,8321954317794429,357,3694514,1129501,0,1129501
13426,Calvin Raatsie,46,2118000,5343361960554242,334,4229260,648497,0,648497
13427,Kacper Radkowski,40,3864100,8366302458594400,404,5768021,1798121,17982,1780139
13428,Asish Rai,31,3962600,4559285670269931,367,6191010,3248647,0,3248647
13429,Reshat Ramadani,36,2515700,4310878865598779,316,4294798,2817557,2817557,0
13430,Marco Ramkilde,56,2554000,3054697601691362,390,4830426,3100098,0,3100098
13431,Darío Ramos,51,705200,8433583705114078,267,2296636,1713899,17139,1696760
13432,Greg Ranjitsingh,68,2920300,4905402711578008,580,6525244,2828635,283,2828352
13433,Kevin Rauhut,31,1561800,7835725621160511,207,2741738,1415259,0,1415259
13434,Connell Rawlinson,56,3081200,3799748659256509,499,6329514,3626395,3626395,0
13435,Sean Rea,37,3698500,9873575901468800,389,5729503,3548359,355,3548004
13436,Arthur Read,41,1553200,5387641833929247,261,3078709,2191566,21916,2169650
13437,Hugo Redón,25,447000,5941339702932146,34,312522,14450,145,14305
13438,Josh Reid,50,1431800,3859553981323326,258,3056428,364070,0,364070
13439,Charlie Reilly,70,4439700,4178628604723764,592,7896963,2847920,0,2847920
13440,Jay Rich-Baghuelou,51,845900,6606262139792114,245,2351898,2182194,0,2182194
13441,Magnus Riisnæs,70,4092500,7449750967579724,672,8613507,4018531,401854,3616677
13442,Milan Robberechts,43,2247100,9604705149908135,280,3654329,1791404,1791404,0
13443,Finlay Robertson,39,2735600,5104323002202553,335,4781489,919983,0,919983
13444,Fernando Rodríguez,69,3751500,8536740882388866,580,7579581,7363488,737,7362751
13445,Robin Roefs,54,838400,8388064386893690,276,2499776,1747361,175,1747186
13446,Danny Rogers,39,3071600,3679606694242754,346,5314150,1539443,15395,1524048
13447,Tomás Romero,48,482200,4339392248126611,218,1863669,816228,8163,808065
13448,César Romero,41,4292600,7788781478595593,416,6228750,4317684,432,4317252
13449,Jake Rooney,27,2922000,9674824580051011,260,4267310,3249826,325,3249501
13450,Marius Ros,68,4437800,8663899668430997,676,8080627,7671306,7671306,0
13451,Fabio Rosales,64,1827100,9992463453751533,432,4930788,3760217,3760217,0
13452,Joseph Rosales,24,677900,7834506517839838,55,628942,405097,406,404691
13453,Romario Rösch,44,2381000,3490867557511427,310,4012172,3927580,39276,3888304
13454,Nils Rossen,60,3206800,5994564544848530,524,6361861,1001989,10020,991969
13455,Iulian Roșu,55,3316600,5417386648040601,425,5826980,1325156,0,1325156
13456,Davy Rouyard,24,4952100,4512823458099494,352,6618907,6427914,0,6427914
13457,Aaron Rowe,45,1372000,7694976875231086,254,2907840,2083492,0,2083492
13458,Zak Rudden,28,1707200,3122811662717174,149,2397108,1993207,200,1993007
13459,Jacen Russell-Rowe,47,2311800,3542144107749200,308,4401912,4212617,0,4212617
13460,Salazar,45,1461200,5138375369109472,272,3081396,2837931,28380,2809551
13461,Nathan-Dylan Saliba,47,4142200,3720280110954479,537,7526529,4615800,0,4615800
13462,Max Sanders,37,508300,5699319790058296,123,1074520,429065,0,429065
13463,Tom Sang,44,1608400,6999869310372574,271,3385257,2717178,0,2717178
13464,Facundo Sanguinetti,65,3124600,7468879722916035,465,6091129,989882,9899,979983
13465,Tom Sanne,45,1907300,4227562119861965,287,3530070,135079,1351,133728
13466,Romain Sans,60,1991400,4206618105343189,404,4837203,935340,93534,841806
13467,Giacomo Satalino,67,3234900,9127935522841635,491,6258574,4515509,0,4515509
13468,Antonio Satriano,38,3673600,6871909989818650,381,6090045,333451,0,333451
13469,Nikolas Sattlberger,55,3339500,3674449372978275,476,5912754,973756,974,972782
13470,David Savic,31,725400,6613159721576895,131,1324262,665795,0,665795
13471,Leon Schaffran,36,3571800,7744725675996932,347,5902870,2696334,0,2696334
13472,Tobias Schättin,58,1638600,9873599205106014,330,3865661,3056547,0,3056547
13473,Sem Scheperman,44,540400,6257964583782258,150,1381528,40470,40470,0
13474,Arne Schulz,68,588800,3346434431508347,344,2954228,1256316,12564,1243752
13475,Joshua Schwirten,52,4170600,5103869412946342,520,7306771,1073325,10734,1062591
13476,Cedwyn Scott,46,4866400,5577782868693515,544,7588451,3598485,359849,3238636
13477,Jack Senior,59,2215700,6392617390821192,427,4657950,2208590,220859,1987731
13478,Jong-min Seo,40,1920900,9556504985076863,259,3510053,2081921,20820,2061101
13479,Sorin Șerban,62,1684600,9503107479168926,384,4359288,2052787,2052787,0
13480,Femi Seriki,59,4769800,8196363982632960,603,8019374,7773905,777391,6996514
13481,Charlie Setford,56,789100,8619449238183720,225,2086707,1248130,12482,1235648
13482,Tyrese Shade,66,4240400,6043133993127166,588,7918495,3511600,3512,3508088
13483,Max Sheaf,61,1973300,8073394150948345,384,4338055,1568856,0,1568856
13484,Shi Liang,40,4532600,3302777739452190,445,6972030,2502513,2503,2500010
13485,Georgios Sideras,41,2421100,7088335794134825,321,4313717,3509506,3509506,0
13486,Berna,26,1288300,8304248443544266,126,1887597,43463,43463,0
13487,Hugo Oliveira,62,4878800,4603025740952810,715,9733643,7377164,738,7376426
13488,Vinicius Mello,41,2631800,5991768322619120,299,4115910,985299,986,984313
13489,Aidan Simmons,57,687500,9033936030373803,256,2376953,1000773,1001,999772
13490,Toby Sims,63,2447400,9243019577491174,384,4745947,3444015,345,3443670
13491,Manvir Singh,38,4903100,5939820517733696,500,8239479,4136239,41363,4094876
13492,Jeakson Singh,70,3694100,4397116305389512,584,8026891,1633390,164,1633226
13493,Viljami Sinisalo,58,4094200,9764883226475020,554,7414403,3758411,3758411,0
13494,Jacques Siwe,55,3939400,3090448765780101,507,6981037,6648882,0,6648882
13495,Adam Smith,60,4251400,8347505450153838,619,8222079,3804108,38042,3766066
13496,Cammy Smith,22,3769000,3037975496315654,319,5438780,9272,9272,0
13497,Matty Smith,55,3247500,7453429884375171,407,5889489,662095,663,661432
13498,Frederic Soelle Soelle,31,4170100,3484438933826205,415,6737996,4087926,4087926,0
13499,Erwin Softić,70,2097200,7777141912199772,476,5051073,950144,950144,0
13500,Yann Songo'o,36,1537600,3103156283997799,188,2463745,2164476,2165,2162311
13501,Lucas Soto,31,1266700,4110683092227984,148,1994350,1080843,109,1080734
13502,Deji Sotona,40,1143400,3094380789355400,201,2238738,877666,0,877666
13503,Omar Sowunmi,50,3640000,6189536114130292,479,6244160,4789075,479,4788596
13504,Martin Spelmann,22,1799800,8791650609072682,168,2441909,1181552,11816,1169736
13505,Brodie Spencer,29,1155900,7266838176310453,108,1427861,368563,0,368563
13506,Toni Stahl,48,674700,9665418671011921,217,1864549,615770,0,615770
13507,Dominik Steczyk,52,2220400,5090241282133907,363,4511273,500799,501,500298
13508,Mateusz Stępień,45,2042900,7292014592426446,271,3567795,565446,565446,0
13509,Jarne Steuckers,44,2289000,8526391663017521,326,4443038,241168,0,241168
13510,Jakub Stolarczyk,32,4097100,7287157651924633,413,6385133,1849243,185,1849058
13511,Lennart Stoll,35,4431500,3700127044928303,405,6465580,5793626,0,5793626
13512,Georg Strauch,53,4115300,6055374117571874,491,6876883,849581,84959,764622
13513,Sun Guowen,39,4175100,5029026820733908,482,7514365,3599095,3600,3595495
13514,Finn Surman,57,4830200,4799050073467905,636,8651477,719489,0,719489
13515,Wadi Ibrahim Suzuki,26,3419900,7258130847772612,287,4411922,2025826,2026,2023800
13516,Óskar Sverrisson,37,4740100,4166930734856478,454,6863410,5203962,5204,5198758
13517,Kamarai Swyer,70,3325000,8306392656717609,549,6618739,3003007,30031,2972976
13518,Ilias Takidine,39,4499200,7352412243957700,496,7154153,4844852,484486,4360366
13519,Christos Talichmanidis,39,1575800,8760070234482557,240,2895809,135973,1360,134613
13520,Sander Tangvik,60,457400,4937950590402949,224,1763236,1392116,0,1392116
13521,Simon Thomas,25,1064800,3774776143754261,98,1366771,409657,410,409247
13522,Adam Thompson,43,4201600,5507221693006521,418,6543630,5115572,5116,5110456
13523,Kosi Thompson,22,3186800,4618398388747491,270,4407042,3501097,0,3501097
13524,Ross Tierney,60,3618600,8942366772278198,517,6461637,5655917,566,5655351
13525,Callum Timmins,47,3337300,8950246050168969,431,5933831,3734537,3734537,0
13526,Emir Tintiş,26,3556900,4278049759837663,305,5005848,3294358,3294358,0
13527,Dawid Tkacz,26,999000,8233434994825373,119,1505317,343163,34317,308846
13528,Darell Tokpa,65,4555100,6505458406315697,663,8951476,8820917,0,8820917
13529,Keke Topp,68,2881400,6970533686835461,472,5951216,1326547,13266,1313281
13530,Louis Torres,47,3142200,9832429130184753,423,5504515,2235474,22355,2213119
13531,Juan David Torres,36,2297400,3507773316926386,256,3512997,54649,547,54102
13532,Samson Tovide,70,3429100,5433460647268910,588,7290099,4884081,4884081,0
13533,Nick Townsend,28,1222400,9984404578975598,157,2090522,1201140,12012,1189128
13534,Jacob Tratt,25,2552800,6081718196940599,208,3425621,41549,4155,37394
13535,Jake Turner,64,2038600,4778784458807734,440,4796870,2052102,206,2051896
13536,Kris Twardek,25,1170500,6019593759269279,105,1469481,184066,185,183881
13537,Takashi Uchino,56,3545300,5910419672325330,497,6098513,279532,2796,276736
13538,Leonardo Buta,54,1981800,3515183055481662,333,4078249,3141261,3141261,0
13539,Kacper Urbański,57,4835500,9938344467248838,613,8757169,5451970,0,5451970
13540,Diego Valdivia,69,4390800,4083689802859525,642,8843888,8727845,0,8727845
13541,Jochem van de Kamp,61,1884100,6914813190799804,384,4266895,911243,911243,0
13542,Bas Van Den Eynden,63,3851000,6064517987693893,535,7204416,6542972,6542972,0
13543,Javier Vargas,35,4773800,8686151982144961,503,7601637,3183909,0,3183909
13544,Diego Vasquez,46,3667900,8275898155070846,438,6425423,5859061,585907,5273154
13545,Anibal Vega,44,1667800,8979723882563152,241,2915408,2323439,232344,2091095
13546,Samuel Velásquez,57,1055800,7135754785752364,287,2866723,1430183,0,1430183
13547,Rik Vercauteren,69,4866400,7056560538219890,659,8709417,3669079,367,3668712
13548,Deian Verón,49,1101600,8579771040811942,292,2953063,1941734,194174,1747560
13549,Marc Vidal,53,606700,9200709947374533,210,1712958,1669311,1670,1667641
13550,Robert Voloder,39,1598800,7341851442740479,220,2552671,2367750,237,2367513
13551,Nazar Voloshyn,24,1293100,3520901985620864,87,1489732,1052339,106,1052233
13552,Leo Walta,66,4773600,9136694249212736,633,8359811,4093993,4093993,0
13553,Wang Yi,34,3528800,7902376003612949,356,5453967,1639774,163978,1475796
13554,Wang Qiuming,33,3002400,5154985132550489,312,5038595,2443304,2444,2440860
13555,Wang Jie,42,4218100,6993763467322746,467,7504232,2055631,206,2055425
13556,Wang Peng,48,4426800,9876927381118218,537,8390008,2385826,23859,2361967
13557,Keith Ward,43,3808800,5526876843512489,479,7142823,4559324,0,4559324
13558,Billy Waters,70,3335500,6642006500127303,632,7359991,761957,761957,0
13559,David Watson,54,4662000,3475202538979750,574,8190889,411541,4116,407425
13560,Lasse Wehmeyer,36,4180700,9275888367932508,396,6457314,5599910,5600,5594310
13561,Michael Weier,38,2877100,9663940308587831,284,4167901,3003667,0,3003667
13562,Nana Welbeck,39,2471400,3214190687046901,295,4082259,53362,534,52828
13563,Moritz Wels,66,4503500,8487486562627753,608,8511563,3428897,0,3428897
13564,Zain Westbrooke,42,2916500,8123575010530041,363,5208935,3490069,3490069,0
13565,Corey Whelan,42,3441400,7755994831609621,357,5867484,4326301,4327,4321974
13566,Joe White,32,2650900,7063202013708438,269,4216604,3248886,32489,3216397
13567,Aaron Wildig,45,1904900,6706674613056511,317,3904643,1457757,1457757,0
13568,Adam Wilk,67,2826900,4025702944878370,507,6158710,5198718,519872,4678846
13569,Tyreke Wilson,36,3853700,5589697220123884,372,5822451,2397630,23977,2373653
13570,Patrick Wood,54,1168200,9777054933279097,300,3065685,2452182,2453,2449729
13571,Will Wright,33,3830700,3313019843521713,354,5489962,2621608,262161,2359447
13572,Roman Yakuba,65,1198700,3603285434243519,316,3071492,1534522,153453,1381069
13573,Yang Shiyuan,45,1001400,3235495740211581,215,2103469,458483,45849,412634
13574,Darren Yapi,27,1534300,4233486436651963,139,2122924,1449916,0,1449916
13575,Irakli Yegoian,64,2943700,9884562192578129,525,6218353,4536458,4536458,0
13576,Gerard Yepes,41,1024500,5210351352520510,201,2061534,1371736,1372,1370364
13577,Johannes Yli-Kokko,46,476300,9965955164276534,221,1914652,701827,70183,631644
13578,Yu Hai,62,1326900,3018975897914041,323,3494489,1238943,1238943,0
13579,Yun Il Lok,67,4933500,8552670961678839,688,9706626,4507481,0,4507481
13580,Yun Young Sun,26,498100,8972650561106485,61,553619,407893,407893,0
13581,Ibrahim Zaid,34,1495600,7550069263469134,188,2357338,686899,0,686899
13582,Patryk Zaucha,60,1574300,4353878907370499,331,3711828,1680160,0,1680160
13583,Aaron Zehnter,23,1807000,5834771976443043,182,2830945,893020,893020,0
13584,Viktor Zentrich,61,3693000,6166059646109291,528,6739711,5847538,0,5847538
13585,Zhang Yuan,66,1557500,8158568921414828,411,4175200,2531699,254,2531445
13586,Zhang Wentao,39,3453400,8416210019431015,412,6094995,3492149,3493,3488656
13587,Zhao Yuhao,61,1670600,9530954818813117,378,3941064,1336082,134,1335948
13588,Zhao Bo,52,2396100,9080399442496161,371,4369140,960495,960495,0
13589,Melvin Zinga,70,4344800,8471596035025631,654,8619567,3208456,320846,2887610
13590,Valon Zumberi,46,1911500,7551353892448199,308,3699180,1903228,191,1903037
13591,James Abankwah,63,4465900,9780214121295988,625,8144819,7838485,78385,7760100
13592,Nelson Abbey,44,3257100,4022158599534992,414,5403295,4188812,4188812,0
13593,Ifunanyachi Achara,33,2307900,8062047988971751,253,3690137,2324097,0,2324097
13594,Hakeeb Adelakun,22,4444900,9170456482457393,387,6304477,1931204,1931204,0
13595,Albion Ademi,65,4684600,3156290497562031,700,9239224,760072,761,759311
13596,Miliciades Adorno,60,2585300,9239114482314174,453,5130637,2957681,0,2957681
13597,Oskar Ågren,55,4248100,8687676978184788,578,8589479,6409732,0,6409732
13598,Abraham Aguinaga,46,421700,9220905057924246,180,1538792,66623,0,66623
13599,Sören Ahlers,59,2288600,5760634860930389,386,4729496,257431,0,257431
13600,Lukas Ahrend,27,2671200,5561566461528363,244,4056984,1689864,1689864,0
13601,James Akintunde,69,3801300,3446418622390170,529,6810189,90994,0,90994
13602,Abdulrahman Al Dakheel,57,2709800,8694970902956092,405,5545183,1803212,181,1803031
13603,Hussain Al Eissa,65,2068700,9268085768699303,394,4463005,3488877,3488877,0
13604,Hamed Al Ghamdi,60,3761700,7315903043869379,516,7250321,6783035,6783035,0
13605,Mohammed Al Ghamdi,63,1750800,8393248384855018,360,3940982,2649799,0,2649799
13606,Marwan Al Haidari,65,4569000,4562583079098278,611,8429206,6199274,0,6199274
13607,Fahad Al Hamad,56,4068700,3511257309770857,497,6991435,1075993,107600,968393
13608,Saeed Al Hamsal,22,3132700,3291676902704784,229,4117057,2114807,2115,2112692
13609,Abdulaziz Al Hurabi,52,3935200,9789782071212317,514,6631118,4491701,44918,4446783
13610,Riyadh Al Ibrahim,50,3918200,8541675236662706,472,6561568,206253,20626,185627
13611,Fahad Al Johani,37,4936000,4584663384556195,537,7969572,6327523,632753,5694770
13612,Awadh Al Nashri,54,3978700,8946488777318994,504,7363951,36501,366,36135
13613,Hussain Al Nowaiqi,50,3908800,3007281597173536,522,7310605,3079790,0,3079790
13614,Radhi Al Otaibi,32,1970400,5659650953526898,248,3161068,1733267,173327,1559940
13615,Abdullah Al Owayshir,52,4503900,4531632728860699,598,8298876,5596025,5596025,0
13616,Mohammed Al Qarni,26,3286900,3275767763722930,260,4607030,2378048,2378048,0
13617,Saad Al Selouli,40,3055700,9115773743349435,312,4440847,3951766,3951766,0
13618,Abdullah Al Shammari,39,753700,6367409820515304,200,1954923,594412,0,594412
13619,Patricio Albornoz,40,526600,7230157170621358,136,1240813,11036,0,11036
13620,Pedro Alemañ,51,4378900,7679154372335925,528,7743975,963962,9640,954322
13621,Anwar Ali,35,2288600,5399986899500834,249,3481899,238522,23853,214669
13622,Taylor Allen,22,632100,3635602777881867,69,767422,247228,24723,222505
13623,An Chan Gi,63,4017000,7785622160953560,558,7370396,937122,9372,927750
13624,Josh Andrews,55,1259500,7271119181914409,284,3082823,439009,0,439009
13625,Ryan Andrews,64,1477900,5230366914805965,381,4272451,3069772,0,3069772
13626,Lee Angol,53,2844900,8965232361684304,414,5668755,1574669,15747,1558922
13627,Joey Antonioli,64,1413600,5379507348226559,365,3882042,766665,7667,758998
13628,Oliver Arblaster,41,3564800,4706737843756246,410,5552874,5099251,509926,4589325
13629,Steve Arnold,25,358500,9921182032914026,49,337583,153051,154,152897
13630,Vladimir Arsić,67,1827400,4865708463808832,470,5041863,4714352,0,4714352
13631,Christalino Atemona,52,2197500,3672918091514215,361,4548001,4149905,0,4149905
13632,Sam Austin,43,459700,6619222370299650,189,1497698,904258,0,904258
13633,Loick Ayina,31,750600,3341069033336448,99,1002961,529774,0,529774
13634,Bae Jun Ho,52,1755300,7900423194377290,318,3768139,2627102,2627102,0
13635,Marcus Baggesen,55,4552000,3805321338553919,530,7123071,6815337,0,6815337
13636,Junior Balbuena,26,2244900,3817971003435430,220,3555868,958295,9583,948712
13637,Arad Bar,41,3266000,3755940705668830,379,5492007,3082749,0,3082749
13638,Shean Paul Barbosa,54,4264200,5052262161414603,508,7563006,6578633,0,6578633
13639,Sam Barnes,23,3068500,8996300281522638,245,4250531,3683953,369,3683584
13640,Jay Barnett,43,1011500,7317240677658549,196,2069737,1443877,14439,1429438
13641,Josh Bauer,27,3403100,8072274498942475,355,5028605,4506591,4507,4502084
13642,Theo Bergvall,25,903700,5889480606311206,87,1047775,813776,0,813776
13643,Medon Berisha,47,554100,7167677730901672,230,2003470,1812660,181266,1631394
13644,Florentin Bloch,59,2120100,6487744770101910,339,4064995,2032688,20327,2012361
13645,Divaio Bobson,43,1936000,4384855051328978,291,3538816,807930,0,807930
13646,Mathéo Bodmer,35,4988000,5778801968519570,450,7638738,5486662,5486662,0
13647,Donny Bogicevic,54,1455000,7290160107551157,305,3197387,985946,986,984960
13648,Tolaji Bola,70,2671000,7054653093257906,507,6013092,5340265,535,5339730
13649,Hugo Bolin,50,2892000,8697281845686342,364,5211803,4764412,4765,4759647
13650,Yoan Bonny,48,1022500,9590866907837011,232,2339421,190625,190625,0
13651,Seán Boyd,33,4046700,6267962819403933,409,6393800,769583,7696,761887
13652,Richard Brindley,30,2594100,3186195517612242,258,3783572,2125122,2126,2122996
13653,George Broadbent,31,638700,3621613637858549,106,1061261,583800,0,583800
13654,Lewis Brunt,69,433700,4932212870770545,303,2600356,490640,491,490149
13655,Borna Buljan,45,4607000,4066718197427570,559,7965061,5657206,0,5657206
13656,Harvey Bunker,60,3588500,6656567062732105,497,6606673,4701588,470159,4231429
13657,Yeray,59,1227400,8141062841720010,300,3060016,862116,862116,0
13658,Drissa Camara,31,4185800,8956006720496859,392,6536847,5569542,557,5568985
13659,Tyreece Campbell,22,2043100,8903845315202646,151,2662659,36612,0,36612
13660,Adam Campbell,55,1394100,6301351213586257,320,3119081,1735704,17358,1718346
13661,Ramón Cansinos,36,3317800,5575504397102810,334,5252825,1854821,185483,1669338
13662,Milton Cantero,64,2896400,7999650356560414,483,6329475,4921055,493,4920562
13663,David Cawley,67,852300,7220571853851393,311,3021498,917138,9172,907966
13664,Vic Chambaere,26,753300,6114228708077232,93,1073752,80843,0,80843
13665,Chang Feiya,60,4448100,9289128521772529,601,8078477,4999213,0,4999213
13666,Ellis Chapman,64,2995400,7545348476900162,494,6074029,1658610,16587,1642023
13667,Chen Wei,40,2069400,8101330664336595,298,3993143,2191706,21918,2169788
13668,Chen Zhechao,62,920700,3519223451659430,281,2484689,1843168,185,1842983
13669,Daniel Chesters,32,3249500,7634763899401343,330,5540484,3274811,328,3274483
13670,Cho Soo Hyuk,42,3777300,6296293882545037,452,6486587,1921709,192171,1729538
13671,Choi Jae Hyeon,30,4428700,5035468918625785,375,6584198,201692,20170,181522
13672,Sebastián Claure,36,3095600,9975814462580056,363,5086854,3387830,3388,3384442
13673,Barry Coffey,49,3547100,9425261628068002,443,6246885,3002872,301,3002571
13674,Josh Coley,66,4246300,4553414323511036,608,7974797,6880037,689,6879348
13675,Giordano Colli,50,1805300,6903058931019170,344,3949915,2193797,219380,1974417
13676,Amario Cozier-Duberry,40,809800,5382806565898647,213,2030780,602222,0,602222
13677,Michael Craig,22,4227000,7822713378119539,375,6197110,3728396,373,3728023
13678,Henry Jon Crosthwaite,29,2414100,6734992568033670,250,3709872,1497283,14973,1482310
13679,Marian Danciu,59,3016100,7398090618570475,420,5591231,5126089,512609,4613480
13680,Prabir Das,23,554700,3796064234037310,39,438352,124650,0,124650
13681,Gyan de Regt,65,4396700,7943524046795467,592,8318860,781438,7815,773623
13682,Celestin De Schrevel,64,2494800,3412389315522504,439,4971513,4218185,4219,4213966
13683,Dennis De Sousa Oelsner,39,2795900,5749936236794605,361,5157173,1741673,174168,1567505
13684,Kas de Wit,42,1567900,4453199026590806,284,3388259,2411443,242,2411201
13685,Charlie Delgado,52,4651500,6263854860948519,587,8704351,4872891,48729,4824162
13686,Mathias Delorge,36,2776400,3240748914257881,297,4504774,3057761,3057761,0
13687,Matthew Dennis,23,4788100,7166473381318695,369,6420036,2176458,0,2176458
13688,Thorben Deters,23,1235300,7941841799732205,136,1843576,325504,0,325504
13689,Reece Devine,70,2910200,7262397872049402,468,5543223,4962405,4963,4957442
13690,Elsinho,52,4187000,6090676126271693,511,7620485,1103644,0,1103644
13691,Maximilian Dietz,41,1086400,9368502987233983,234,2524616,2097768,209777,1887991
13692,Ibrahim Digberekou,44,4866400,8825637818518698,559,8183517,6116556,611656,5504900
13693,Dong Yu,30,4873500,9801944087380138,437,6728109,5102047,5103,5096944
13694,Jacob Dowse,67,3562300,9798512690207287,559,7399097,3168405,3169,3165236
13695,Paul Doyle,60,4862600,6492153013965393,622,8574535,8358769,836,8357933
13696,Mark Doyle,41,3412600,6594797126826305,376,5497678,4374469,437447,3937022
13697,Freddie Draper,64,3342100,7486874965917900,547,7082993,699830,699830,0
13698,Cameron Duke,47,2098300,3160078216526605,319,4009258,3309112,0,3309112
13699,Cosmin Dur-Bozoancă,30,3966500,5859657204715379,392,6052855,1306860,130686,1176174
13700,Ryan Edmondson,29,4869500,9403786863771523,466,8094087,7440602,74407,7366195
13701,Vetle Walle Egeli,33,2371000,7655662262575538,296,4245428,3392603,0,3392603
13702,Kelvin Ehibhatiomhan,37,832400,8628872892280678,170,1826831,227366,227366,0
13703,Julian Eitschberger,40,1567200,5754412184300120,224,2775255,92776,0,92776
13704,Deji Elerewe,31,4659100,9004853718597123,441,6897629,6459962,0,6459962
13705,Will Evans,44,4715300,6667674632749136,458,7061252,2057589,2057589,0
13706,Erkan Eyibil,70,4064000,3266725722433596,581,7337381,3319355,0,3319355
13707,Raphaël Eyongo,22,3766100,7929171774613986,287,5095153,1939030,1939030,0
13708,Mats Facklam,69,2981200,6102615575986276,583,6883885,6481119,6481119,0
13709,Fallou Fall,48,1841700,9621873127779660,282,3297062,979544,0,979544
13710,Fang Jingqi,56,3693000,5148715244973849,520,6456137,3342738,334274,3008464
13711,Amin Farouk,70,1299900,8294247563551860,410,4243848,691696,692,691004
13712,Rory Feely,55,392300,4409434980679716,264,2016631,1348474,0,1348474
13713,Frank Feller,65,1314800,8080547271142195,377,3546551,1816406,181641,1634765
13714,Tom Fellows,50,3109900,3997166812778619,427,5541245,206171,0,206171
13715,Feng Boyuan,61,2982500,4347369744408117,520,6225748,661756,0,661756
13716,Matias Fernandez-Pardo,69,2004500,4386406283643287,477,5030857,3657165,36572,3620593
13717,Matías Ferreira,68,2424200,9517428777563999,465,5590506,3402860,341,3402519
13718,Ronan Finn,59,620600,7916136681383613,247,2093951,1768799,17688,1751111
13719,Maciej Firlej,37,2680700,9913600469419068,298,4380252,3096804,3096804,0
13720,Gonzalo Flores,56,3852100,6376732653295112,514,6605270,5436630,544,5436086
13721,Iván Flores,24,2661000,9043155002192467,254,3863251,3358825,0,3358825
13722,Ezequiel Forclaz,63,4615800,6665450788321721,598,7639616,6311180,631118,5680062
13723,Harry Forster,32,394100,6888307390199596,80,588587,585965,585965,0
13724,Juan Alexander Franco,34,893500,5732261110196216,160,1717108,882775,88278,794497
13725,Marlee François,57,740600,4358636030860750,290,2597988,2205561,220557,1985004
13726,Tyler French,24,383200,9509018455793224,34,239620,138946,139,138807
13727,Gan Chao,62,1563900,8884996031757209,369,3858958,3579266,358,3578908
13728,Gao Di,47,3152600,4013612112998215,449,6099849,2357893,0,2357893
13729,Javi Garrido,30,4726900,8061912048957109,432,7254293,1612838,161284,1451554
13730,Tom Geerkens,31,2417100,4835899334711801,266,3912916,779462,0,779462
13731,Romeo Giovannini,50,3186300,9361623667527015,402,5742081,1593641,15937,1577704
13732,Santiago Gómez,59,1359200,7071058175428282,367,3991259,1810671,1811,1808860
13733,Yoni Gomis,24,783100,9748413637354179,81,954162,103652,1037,102615
13734,Enso González,53,1064000,9362132499764816,299,2720349,229210,0,229210
13735,Villiam Granath,52,922600,9091791161105658,237,2364318,8162,0,8162
13736,Anthony Grant,24,1203400,7282683289386097,111,1655069,1068965,106897,962068
13737,Josh Grant,42,3725000,8208657253413830,414,5567908,65205,0,65205
13738,Jacob Greene,66,468000,4635673640852389,338,2826881,2344069,235,2343834
13739,Shane Griffin,24,3240000,9262432677132974,301,5170076,4704371,4704371,0
13740,Axel Guessand,41,331200,7049287031452496,128,957230,346377,0,346377
13741,Stefano Guidotti,53,4410500,9233429071355376,525,8040062,4779160,4779160,0
13742,Luca Günther,67,591100,6529082712866681,308,2457561,2428783,242879,2185904
13743,Guo Hao,32,3717500,9320045606678474,350,5891057,1762151,176216,1585935
13744,Guo Quanbo,23,2905000,6703403890960610,278,4437978,3953724,396,3953328
13745,Kurtis Guthrie,39,503800,8833357035007709,159,1353993,762118,762118,0
13746,Julian Halwachs,34,3346600,9651027882048445,372,5013493,4539210,0,4539210
13747,Ciaron Harkin,43,1531100,3013305447965309,271,3223329,42291,423,41868
13748,Sam Hart,59,3125100,8981669194976248,422,5470374,3661733,366174,3295559
13749,Islam Hawsawi,53,4023300,5059238956137937,569,8042439,679416,680,678736
13750,Naif Hazazi,69,4348800,6951635746606327,619,8523623,4331536,0,4331536
13751,Gustavo Hebling,36,3945900,9029552466962498,452,6888912,1332576,1333,1331243
13752,Bryan Hein,32,3796000,8218418186425731,348,5841802,2034945,0,2034945
13753,Grant Horton,58,1957200,4623912107868164,392,4275145,1198970,120,1198850
13754,Bryce Hosannah,40,1927500,9654327733341618,247,3300892,315307,3154,312153
13755,Huang Ruifeng,68,1561500,6610186556007441,395,4241430,134210,135,134075
13756,Danny Hylton,35,4126200,9489625602996097,360,5776381,360640,36064,324576
13757,Mehmet Ibrahimi,37,4112900,9883455594911480,404,6492086,1615376,1616,1613760
13758,Ahmed Iljazovski,69,4739100,8637705143537108,750,8983721,5752534,5753,5746781
13759,Joachim Imbrechts,44,909400,6988221400081461,234,2294821,900464,90047,810417
13760,Nassim Innocenti,27,536300,7108298233287550,61,604031,44757,448,44309
13761,Kyle Jameson,60,4167000,6859720444678944,535,7414230,7042984,704299,6338685
13762,Piotr Janczukowicz,38,2032700,4134774490963328,263,3589842,3393628,3394,3390234
13763,Luka Janeš,67,2604100,9849054757511606,526,6277449,4897561,48976,4848585
13764,Rijk Janse,55,3165800,3754895112356316,453,5741857,5103720,51038,5052682
13765,Seedy Jarju,31,4209200,4271584477143631,373,6198337,4960881,0,4960881
13766,Connor Jennings,31,540600,8488163813569840,123,1084794,608145,6082,602063
13767,Nicolas P. Jenssen,51,1554900,9774628971578007,253,2851841,7984,7984,0
13768,Darnell Johnson,55,1961900,8874116414235215,331,4038380,2436891,2436891,0
13769,Carl Johnston,63,2472300,8862999338335876,435,4745613,3754419,375442,3378977
13770,Callum Jones,48,3431600,4423479907111948,407,5721090,4067469,406747,3660722
13771,Luka Jovanović,42,4251200,5506108247009211,496,6590444,5544423,55445,5488978
13772,Preston Judd,69,654000,3192073874685474,361,3118060,591789,59179,532610
13773,Jung San,63,2004000,6580888641866158,440,4937812,453908,0,453908
13774,Junior Zé,47,735500,6883118533362841,218,2147851,343675,0,343675
13775,Stipe Jurić,63,2605100,5041090997044516,470,5476280,4491728,0,4491728
13776,Vishal Kaith,22,3615200,8180567384076062,318,5723243,1387356,13874,1373482
13777,Vedat Karakuş,30,2064600,3711091898440808,229,3416875,474366,474366,0
13778,Sam Karssies,59,4150900,8863588231784443,597,7908161,7076631,0,7076631
13779,Brandon Kavanagh,45,791700,3545540275186785,215,2173221,1282637,1283,1281354
13780,Ciarán Kelly,26,3380400,7664122057380840,325,5052917,3866989,386699,3480290
13781,Joey Kesting,38,1043400,9796914837941400,187,2108462,1873946,18740,1855206
13782,Harmanjot Khabra,39,1779900,9101557076872066,255,3445437,2898799,290,2898509
13783,Ekrem Kılıçarslan,22,3608200,6302749571762191,291,5158234,3242934,325,3242609
13784,Kim Dae Jung,52,3938700,5264940541595140,459,7199825,5998110,599811,5398299
13785,Kim Gyeong Jae,51,529400,7860977735378362,198,1786439,1600709,160071,1440638
13786,Tim Kips,67,4383500,3906687638063864,620,8072772,1283039,1284,1281755
13787,Paddy Kirk,28,3056800,8651464590264846,277,4896206,3001461,301,3001160
13788,Joe Knowles,57,1509500,7481012928507811,291,3246073,3124028,3124028,0
13789,Michał Kołba,22,3803000,6877319751046671,288,5184684,4452130,0,4452130
13790,Paul Komposch,66,710100,9900730498368813,344,3084533,963559,96356,867203
13791,Kaloyan Kostadinov,52,2762500,3662968240225633,448,5774720,4948380,4949,4943431
13792,Tim Köther,45,4923000,4127632002947580,538,8772025,2804654,0,2804654
13793,Kevin Kouassivi-Benissan,45,3336600,8239966791348302,377,5538946,1051252,1051252,0
13794,Thérence Koudou,68,3640100,8393339498034368,606,7614476,5885655,5886,5879769
13795,Léandre Kuavita,30,4992700,9748959970484655,415,6933751,4121267,4122,4117145
13796,Julian Kudala,44,4388600,5167657142603479,499,7510261,4152683,4152683,0
13797,Ashique Kuruniyan,50,4073300,7091502849976309,490,7020797,4482647,449,4482198
13798,Daniel Kyerewaa,42,3155900,6843574386278198,407,5835832,2188276,2188276,0
13799,Ziyad Larkeche,33,1704500,8007117363975047,210,3043196,368095,0,368095
13800,Lucas Laux,48,2972500,5576077650424816,428,5269518,4623366,46234,4577132
13801,Caolan Lavery,61,2152900,6944325720912751,422,5047329,1530338,154,1530184
13802,Lee Jae Won,63,1435300,6065659869873442,338,3549917,1305720,131,1305589
13803,Jürgen Lemmerer,27,2415000,4583962591715032,231,3318427,817635,818,816817
13804,Harry Leonard,39,338800,5192834151352511,150,1192258,406789,40679,366110
13805,Jakub Letniowski,70,2115100,3872147064511249,414,4385983,4375214,0,4375214
13806,Paul Lewis,27,2570300,4479552293846502,213,3394393,867402,867402,0
13807,Li Peng,40,2637200,3178046496617342,356,4795246,19957,19957,0
13808,Liao Chengjian,27,2534700,3735201516419891,255,3686597,1201113,1202,1199911
13809,Lin Chuangyi,33,4627700,5088315629373897,461,7658514,4563584,0,4563584
13810,Lucien Littbarski,24,4862700,9826567772420369,432,6989668,5130833,513084,4617749
13811,Liu Huan,36,1421500,4985042546672181,207,2539530,525019,0,525019
13812,Kyran Lofthouse,26,3727700,7554476692347318,365,6270444,5431792,544,5431248
13813,Tommy Lonergan,52,650100,8727118088372349,230,2137877,1138275,114,1138161
13814,Adam Long,49,2310600,3222174515659361,353,4485820,1176432,11765,1164667
13815,Louis Lord,62,705300,5667398727894417,307,2581615,1694209,169421,1524788
13816,Mehdi Loune,41,1353100,6300590238526229,214,2356760,454808,0,454808
13817,Joe Low,65,1184700,3510271456470270,370,3427387,2619105,2620,2616485
13818,Matt Lowe,23,375600,3480395528174760,52,361555,359860,360,359500
13819,Ma Xingyu,66,951200,6564751478286396,320,3267437,3059541,0,3059541
13820,Harvey Macadam,67,2940800,8187096318070044,492,6072292,4931782,493179,4438603
13821,Marcos Machuca,44,1217800,5522193201156931,209,2464515,931157,0,931157
13822,Montader Madjed,52,1643000,7760002153485880,325,3500555,2611802,0,2611802
13823,Abdullah Majrashi,65,4712400,4249456260180666,671,9018182,4128712,4128712,0
13824,Mohammed Majrashi,43,2303900,5575702469177979,298,4264960,4230899,4230899,0
13825,Jovan Malcolm,59,2160200,5188627952128070,386,4626224,2298489,0,2298489
13826,Connor Malley,64,2043600,8540824194721652,483,4880205,3161537,3161537,0
13827,Luka Marić,67,723400,7062354075963063,330,3064196,1318761,1318761,0
13828,Fabio Markelic,22,2193100,7869831620058872,168,2831578,1346044,134605,1211439
13829,George Marks,29,1600200,8228547437046395,181,2369079,1415367,1416,1413951
13830,Marley Marshall Miranda,32,1352100,7614770875967071,165,2127925,943245,94325,848920
13831,Jayson Martínez,23,3656600,9544476884099691,296,5292146,2110674,2110674,0
13832,Jonny Maxted,28,4174400,3727100337348820,336,6213280,5064033,506404,4557629
13833,Liam McAlinden,39,1569600,3928124107398226,255,3091236,507613,5077,502536
13834,Connor McAvoy,69,2767000,6391334476837487,484,6439202,4389003,4390,4384613
13835,Adam McDonnell,67,822000,3645744034912484,282,2794623,812269,813,811456
13836,Shane McEleney,53,2897700,5452810449027232,381,5261920,147556,147556,0
13837,Oisín McEntee,40,911400,6612743246215606,179,1964553,1084965,0,1084965
13838,Ryan McLean,34,1618300,3418999239286118,204,2870962,1228882,1229,1227653
13839,Gustavo Medina,56,4767200,7808674627260850,598,9058138,915870,915870,0
13840,Max Melbourne,55,3430100,4850322295286145,496,6407110,3279635,3279635,0
13841,Kelvin Mellor,29,4939300,4982914947301365,452,7922898,2949240,294924,2654316
13842,Jordan Meyer,63,4762100,3481057423106058,632,8547616,8028635,8028635,0
13843,Oualid Mhamdi,66,3913500,3491003934720446,547,7826425,6013090,60131,5952959
13844,Lennon Miller,39,4010400,7496090369746883,426,5924293,638298,0,638298
13845,Min Seong Jun,54,4640500,9584266844590146,615,8634265,8533590,8534,8525056
13846,Danilo Mitrović,49,1436000,4678447214094226,249,2748107,2736176,2736176,0
13847,Stuart Moore,37,2400400,4457840981316845,336,4418350,45417,45417,0
13848,Jordan Morán,54,2320300,3549817036761603,384,5000376,1300599,1300599,0
13849,Junior Morias,26,1157200,5075913754728221,116,1566705,50147,502,49645
13850,Franklin Mosquera,44,2049300,6717913722643699,291,3471116,1014440,0,1014440
13851,Juan Mota,66,2801200,4615781090850844,463,5731746,4350108,43502,4306606
13852,Baptiste Mouazan,34,2797000,8581620717845094,247,4100276,1166877,1167,1165710
13853,Moha Moukhliss,58,4202900,3212157535679651,512,7171572,5117161,51172,5065989
13854,Hayden Muller,27,1924800,3646122016310376,167,2459977,77162,0,77162
13855,Andreas Murbeck,59,2263000,3626204278045532,393,4654729,1893109,189311,1703798
13856,Myeong Joon Jae,42,3226200,8024397835691445,351,5461323,148020,149,147871
13857,Mohammed Naji,36,3244100,6435475703183810,381,5553229,2803849,2804,2801045
13858,Christopher Negele,38,2392400,8234955039902245,296,4194532,638014,639,637375
13859,Elliot Newby,60,4937900,9571752204238335,677,8936325,8434414,8434414,0
13860,Sanders Ngabo,44,1355600,8475163105991185,274,3129421,1893268,189327,1703941
13861,Chinwendu Johan Nkama,43,2636300,3062583740451055,315,4388228,3698554,3699,3694855
13862,Musah Nuhu,54,2309300,4698229490430992,391,4828319,1712499,171250,1541249
13863,Djenahro Nunumete,39,3481100,3699058728408761,337,5621662,5574074,558,5573516
13864,Connor O'Riordan,49,2073400,9576734052373168,344,3941137,1707768,0,1707768
13865,John-Joe O'Toole,31,2956600,9378889160658434,305,4759692,342106,342106,0
13866,Wilmer Odefalk,67,4393100,3633777553825485,650,8528610,7573951,0,7573951
13867,Niklas Ødegård,70,1464400,5933859464606226,373,3833258,2553310,255331,2297979
13868,Abraham Odoh,62,3392700,8969632212409192,544,6922666,3422193,3422193,0
13869,Jonas Oehmichen,37,396400,8525758017891819,99,792430,300721,301,300420
13870,Isaac Ogundere,53,1087300,9732289022182526,251,2455669,259756,0,259756
13871,Oh Jae Hyuk,39,2323200,9959177088986314,310,4126179,1403210,1403210,0
13872,Bernardo,39,1128700,5007553138681836,213,2366794,2050894,205090,1845804
13873,Matti Olsen,24,2690100,4977029330045750,215,3619339,1634041,1635,1632406
13874,Richie Omorowa,67,4807700,4970391006780944,643,8652276,6793693,0,6793693
13875,Ibrahim Osman,59,664300,3942351152903888,261,2256090,1467853,1467853,0
13876,Silas Ostrzinski,70,3777500,3357021396346287,565,6937918,3683072,0,3683072
13877,Nick Otto,51,3449400,3880012452924671,504,6287055,4784647,0,4784647
13878,Aston Oxborough,47,1184400,4983165692676754,267,2563219,705712,70572,635140
13879,Mark Oxley,56,2263800,8007639921281646,375,4744941,2598867,0,2598867
13880,Paik Sang Hoon,67,1816700,3870358183992676,395,4254200,2709592,270960,2438632
13881,Seb Palmer-Houlden,42,1499900,5585632329404877,206,2433493,456106,4562,451544
13882,Elliot Panicco,46,1243800,9549563475073432,280,2907667,2732189,0,2732189
13883,Abel Paredes,38,2172900,3178760618087170,280,3556174,3051980,0,3051980
13884,Park Byung Hyun,47,544700,4225704756506059,185,1542758,1434877,144,1434733
13885,Juan Peinipil,67,3591200,7311402479672817,596,6792881,2574693,25747,2548946
13886,Aldair Peña,27,4682400,6185874459141849,428,6575371,3619615,361962,3257653
13887,Leon Pöhls,41,2077600,9759910932238537,279,3373675,2937786,0,2937786
13888,Markus Ponath,41,2946000,4801249727697681,318,4407514,3597016,0,3597016
13889,Bruno Portugal,54,1966700,7687394047205823,380,4392203,1358959,0,1358959
13890,Rekeil Pyke,63,2735500,9287676218631123,454,5678104,2438047,2439,2435608
13891,Elidon Qenaj,39,4541200,3061779478667530,508,8263969,8152248,81523,8070725
13892,Harry Ransom,34,848300,5561170166470964,144,1612396,1323187,13232,1309955
13893,Justin Rasmussen,66,4534900,4304581995272498,642,8093929,827617,0,827617
13894,Thomas Rausch,39,3326800,5906375548250704,329,5537204,4813542,48136,4765406
13895,Oregan Ravet,68,2406500,3258400595762470,543,6506899,3585543,359,3585184
13896,Maikel Reyes,31,1690700,5443710152311921,179,2577885,2575175,25752,2549423
13897,Tyler Roberts,32,3016100,7159432168901185,351,5111047,772318,773,771545
13898,Lucas Rocrou,59,2418500,6243372297437797,436,5584407,1707310,1707310,0
13899,Lenny Rodrigues,25,1161200,4521228668906332,105,1480038,357700,358,357342
13900,Luis Carlos Rodríguez,48,2571500,3624995223054160,347,4559969,4175505,0,4175505
13901,Franz Roggow,39,1120300,3310012872670987,157,1734327,1185016,119,1184897
13902,Camilo Romero,46,2864200,5829078823276780,397,5406952,4501299,4502,4496797
13903,Abraham Romero,59,4718400,3283182488867934,609,9311489,6474755,647476,5827279
13904,Matthieu Rongier,42,1890400,4728776492840121,269,3642306,1219266,12193,1207073
13905,Dayle Rooney,49,1328500,9807418154056608,269,2995783,869052,0,869052
13906,Tom Roufosse,62,4433300,9647712225529861,642,8361359,5548926,0,5548926
13907,Tobias Rühle,30,4214000,8776622494186936,360,6345821,3770053,3771,3766282
13908,Michael Ruhs,36,3414700,7900715113608405,367,5397483,4190120,420,4189700
13909,Fabian Rüth,67,4610000,7616577504226101,618,8353680,7031932,7031932,0
13910,Gaoussou Samaké,47,3800400,3036459361922082,489,6541701,63398,63398,0
13911,Jack Sanders,41,2022600,4513035137124199,263,3516542,22692,0,22692
13912,Harvey Saunders,51,3192300,8251362411960004,457,6276604,4487741,4487741,0
13913,Moritz Schulze,54,3757800,9872811095505820,480,6293261,2231997,0,2231997
13914,Philipp Schulze,59,4882700,5232399981691617,617,8748788,5469750,5469750,0
13915,Brady Scott,45,3729100,6288925941638735,461,7129915,4369190,0,4369190
13916,Ryan Scott,57,2591100,3588546736165221,409,5190431,2547133,0,2547133
13917,Sean Seitz,65,1093900,4999224654515728,379,3857850,674854,674854,0
13918,Eniss Shabani,56,2597100,5673714224986031,395,5166519,1993377,200,1993177
13919,Simon Simoni,58,2062800,8009024801375793,366,4355797,800917,801,800116
13920,Roshan Singh,42,1088300,4886132461206964,178,1911875,709032,0,709032
13921,David Skubl,66,2126400,4062442598530281,450,5363160,2849506,0,2849506
13922,Sam Slocombe,48,375600,5090742979141048,206,1516387,970748,97075,873673
13923,Noah Smith,56,4913800,3572608152420069,559,7811166,4450404,44505,4405899
13924,Tunmise Sobowale,60,1866500,9184869811078344,372,4452931,1533135,1533135,0
13925,Mads Søndergaard,36,2815000,6691944079336055,331,4904654,117850,0,117850
13926,Momodou Lamin Sonko,53,3496100,6150838328486838,455,6657818,3646358,365,3645993
13927,Hugo Sotelo,32,4681000,7173165020686240,418,7437622,4108195,0,4108195
13928,Michał Stachera,38,648900,9009086118039508,148,1402334,666284,66629,599655
13929,Veit Stange,39,1752600,3572701630691962,246,3042131,2680349,26804,2653545
13930,Dušan Stojinović,66,4353100,8678449264970862,634,8771972,6829882,68299,6761583
13931,Matteo Stoppa,42,2096100,5835399514485828,314,4184488,3108738,0,3108738
13932,Jannich Storch,65,3203300,9121927626191115,565,7147206,1758491,175850,1582641
13933,Jack Stretton,26,1101300,9932353402616316,124,1609986,1598577,1599,1596978
13934,Stefanos Stroungis,62,2780100,8003346908882602,447,5574585,5148480,0,5148480
13935,Samuel Stückler,67,1629100,9164058127522314,441,4494558,120033,120033,0
13936,Daniel Stynes,67,3971300,8405017060673544,569,7032312,5558387,5559,5552828
13937,Tan Kaiyuan,24,2544900,4468972808394518,224,3973585,2127974,2127974,0
13938,Kyle Taylor,63,1761900,7014047151286085,403,4682964,456219,45622,410597
13939,Max Thompson,61,3270400,5311020873236375,479,5950792,3669126,366913,3302213
13940,Paul Tschernuth,22,1658900,7310170058895630,125,1881138,1819813,182,1819631
13941,Dilyimit Tudi,37,2092200,6206893557710330,256,3400587,2116768,2117,2114651
13942,Răzvan Udrea,61,685000,8237740170142804,256,2375561,569244,0,569244
13943,Eric Uhlmann,55,4683400,8542237016159403,551,7928454,1193148,119315,1073833
13944,Andrei Ureche,33,3492100,8317695081103210,344,5014563,4466649,44667,4421982
13945,Peter Urminsky,27,4774900,7162511152725053,452,7444579,185335,185335,0
13946,Finn van Breemen,31,632400,3235772466567081,122,1226408,77002,77002,0
13947,Harry Van der Saag,35,4524100,4332793914171161,489,7970618,5132340,0,5132340
13948,André Vásquez,38,4371400,9480563144406003,484,7243205,4726240,4727,4721513
13949,Santino Vera,55,3224100,7822790934152904,433,5512937,636392,0,636392
13950,Emiliano Viveros,23,2323300,4196267417276423,228,3589924,373643,3737,369906
13951,Brad Walker,39,3276200,3676581694760883,384,5644671,1499317,149932,1349385
13952,Joshua Walker,59,2468800,7120723084659099,434,5065640,1692588,1692588,0
13953,Oscar Wallin,66,1326800,9270566715283956,395,3803789,261189,262,260927
13954,Wang Zhen'ao,36,820100,6464836030796436,155,1609713,29594,2960,26634
13955,Wang Jianan,30,659400,6900172302469406,117,1158675,539759,0,539759
13956,Wang Zhifeng,61,4092900,7297145723090254,538,7465256,3813143,38132,3775011
13957,Stanisław Wawrzynowicz,26,3132600,9640766390478932,297,4571671,3112329,311233,2801096
13958,Wen Jiabao,32,3869600,4611006116949230,428,6247870,2048585,2049,2046536
13959,Colm Whelan,26,4759700,3617668461547332,426,7451497,3948836,0,3948836
13960,Kevin Wiethaup,25,2277600,3513833563718400,208,3293618,2326616,2327,2324289
13961,Filip Wilak,41,3684800,9652165706376422,374,5639539,1140265,0,1140265
13962,Dean Williams,25,1733800,9079038818114539,163,2506050,1050729,10508,1040221
13963,Daniel Wilmering,30,695200,7970898728857726,106,1057021,786618,0,786618
13964,Bennet Winter,24,2657100,8842214514659032,231,3599418,794773,794773,0
13965,Allan Wlk,33,1743500,4236097694682426,207,2790497,2037487,0,2037487
13966,Lucas Wolf,54,2807000,6449542803331840,416,5093701,3059944,0,3059944
13967,Jordan Wright,33,4736700,6875069610447153,420,6878054,6838362,6839,6831523
13968,Florian Wustinger,61,806100,9510869012959552,254,2326067,1213417,0,1213417
13969,Xu Yougang,59,2464700,3679821684000736,402,5051179,629648,6297,623351
13970,Josef Yarney,47,3197400,4447157320726908,348,5189712,4924902,49250,4875652
13971,Mohammed Yasir,26,3933500,6060167669197152,348,6087354,3255601,325561,2930040
13972,Ye Chugui,60,4690500,7467193470430546,608,8592385,4853626,4854,4848772
13973,Yin Congyao,67,3911200,8479661362351150,583,7614512,944149,945,943204
13974,Yue Xin,65,3476200,5092116265916427,491,6422889,6222186,623,6221563
13975,Cristhoper Zambrano,50,1845100,4454913494029736,324,3809008,456485,457,456028
13976,Offrande Zanzala,38,864300,4796609759733156,198,1991067,1403105,141,1402964
13977,Ulaş Zengin,55,1517600,4107814099115087,353,3829181,1181441,11815,1169626
13978,Zhang Yuan,42,2443200,9033567790004431,360,4633933,553976,553976,0
13979,Zhang Chong,37,4897300,9737057003831458,493,8021130,135090,13509,121581
13980,Zhang Gong,54,3873700,5933595630288276,483,6477299,2137260,0,2137260
13981,Zheng Zhiyun,52,1686000,5232483814539363,335,3719609,2372751,237276,2135475
13982,Massimo Zilli,31,2043100,4822373182970222,235,3512550,3070772,308,3070464
13983,Jovan Zivkovic,27,1463800,7958948744144867,136,1956792,1429743,142975,1286768
13984,Alexis Zorrilla,32,3627300,8474771321847714,382,5820993,3950115,39502,3910613
13985,Zou Dehai,61,564800,7396652076828966,297,2425169,2380334,238034,2142300
13986,Ethan Zubak,27,1964700,8828592914867483,176,2605212,1633751,16338,1617413
13987,Azeem Abdulai,33,3931000,5636854184985741,433,6711599,6282805,6282805,0
13988,Sławomir Abramowicz,35,3415500,6120265656924256,354,5234674,4066771,407,4066364
13989,Eli Adams,54,3153000,9910350962012308,415,5172230,3534159,353416,3180743
13990,Tayo Adaramola,64,1291200,4687833458313421,348,3543489,2409010,241,2408769
13991,Korede Adedoyin,40,940900,7649877580325386,176,1913105,195949,196,195753
13992,Daniel Adshead,51,2167000,4739612995812401,333,4121872,1333698,133370,1200328
13993,Daniel Aguirre,53,1323500,5353322619759449,294,3069357,2838741,284,2838457
13994,Saleh Al Abbas,39,4691500,4829069593962466,531,7246660,1421670,0,1421670
13995,Mansour Al Bishi,50,3289200,4238830626795093,407,5732045,3062255,3062255,0
13996,Abdulelah Al Bukhari,67,438000,5761386781301134,306,2342851,273822,0,273822
13997,Hazzaa Al Ghamdi,45,999300,7907765548018320,236,2430240,754570,754570,0
13998,Nawaf Al Harthi,52,2194800,8537676252095328,363,4318752,2738553,273856,2464697
13999,Saad Al Khayri,48,1836200,9565882189847763,301,3624494,1643917,16440,1627477
14000,Hassan Al Majhad,66,3048100,7788342803157400,489,5571761,1018110,1018110,0
14001,Yahya Al Najai,41,3256500,7380729496229219,368,5082933,1142095,0,1142095
14002,Raghid Al Najjar,47,4878700,7388786460687554,531,8567841,8309259,0,8309259
14003,Ibrahim Al Nakhli,28,4926800,9472988857348684,425,7317241,3607123,360713,3246410
14004,Abdulkarim Al Qahtani,22,2677900,6137851477197334,244,3723056,2817077,0,2817077
14005,Muhannad Al Qaydhi,47,1814700,8440899174205043,284,3596748,70102,0,70102
14006,Nawaf Al Qumairi,45,3267900,8258483268158563,441,5961706,811774,811774,0
14007,Mohammed Al Qunayan,69,595800,6573690858430508,328,2752725,1791057,1791057,0
14008,Mohammed Al Saeed,25,4699500,8300477243573132,353,6530174,4381460,438146,3943314
14009,Rakan Al Shamlan,70,422800,5538864451512713,372,2775358,2708822,0,2708822
14010,Khalid Al Shuwayie,52,2068900,3978050574539832,345,4244733,695500,69550,625950
14011,Mohammad Al Thani,69,974100,5034273176881095,381,3487469,3113073,31131,3081942
14012,Fawaz Al Tryes,54,2620200,8715641016210237,436,5516541,4534724,0,4534724
14013,Gabriel Alfaro,27,361800,9567607406332382,83,637346,237645,2377,235268
14014,Scott Allardice,37,3103000,5513711077571064,322,4783705,4006673,4006673,0
14015,Felix Allgaier,56,4747900,5363207829676984,666,8554253,2239172,0,2239172
14016,Hugo Álvarez,25,343100,9873713261599730,37,244727,80766,808,79958
14017,Alejandro Ampuero,30,4708400,5834422162700696,387,6968569,1884559,0,1884559
14018,Ionuț Andres,47,2548900,5993014409959180,329,4363386,2589925,25900,2564025
14019,Bent Andresen,53,4659700,6924547359454452,561,8231564,7781649,779,7780870
14020,Hamza Anhari,54,552500,3329825588977803,232,1923411,247195,0,247195
14021,Louie Annesley,52,817800,5746906643045602,263,2553491,1277487,12775,1264712
14022,Alessandro Arioli,58,3956600,9534768747944192,547,6826965,1957436,1957436,0
14023,Luca Ashby-Hammond,65,4765400,7910776204828983,662,9054578,1920580,0,1920580
14024,Josh Austerfield,55,2620200,7281339632450520,410,5372614,795823,7959,787864
14025,Theo Bair,27,1017100,6393440158685270,108,1460257,2866,0,2866
14026,Nicolas Bajlicz,25,3013500,8778837160372243,267,4215435,4206230,421,4205809
14027,Geraldo Bajrami,27,947000,8647690100896895,116,1315167,1132579,0,1132579
14028,Johan Bakke,37,2010200,9301762702897089,258,3406752,1577233,157724,1419509
14029,James Ball,23,1657400,5766528132020063,141,2243277,835317,83532,751785
14030,Ibrahima Sory Bangoura,35,4897400,9616781181376090,466,7938976,7670942,7670942,0
14031,Bao Yaxiong,31,4226000,3176184388764348,408,6028730,2550421,2551,2547870
14032,Alonso Barría,34,616200,9564259473984227,105,1096497,646307,0,646307
14033,Daniel Bassi,29,891600,3935117563874105,131,1420838,1247350,0,1247350
14034,Alessio Besio,64,2243900,5089765114498917,381,4718295,4510465,0,4510465
14035,Joel Bichsel,61,1951000,6974205367070612,385,4653630,340042,0,340042
14036,Matteo Bignetti,40,4411700,8761477955055230,440,6756424,1124607,0,1124607
14037,Hendry Blank,59,1122300,4316185820312377,304,2822500,1993859,19939,1973920
14038,Aaron Bolger,36,428800,7235823582993968,131,1105690,338863,3389,335474
14039,Rowllin Borges,51,4713900,8561703514295592,604,7897920,3205505,320551,2884954
14040,Rudy Boulais,53,3579300,5915668303653530,489,6195485,4719798,4720,4715078
14041,Ryan Brennan,55,3117300,7804414579567167,402,5713045,1248443,125,1248318
14042,Milosz Brzozowski,67,4577400,7086908347451917,658,8687208,8660631,866064,7794567
14043,Marcel Bykowski,62,2514600,7563845612389127,432,5391628,2095022,0,2095022
14044,Amadou Camara,55,2497600,8033447906470868,392,5304411,5274797,52748,5222049
14045,Jessel Carneiro,52,916400,6264507635070249,278,2585675,780229,781,779448
14046,Harvey Cartwright,32,4811500,4567419580446939,463,7081315,1108996,110900,998096
14047,Robert Castellanos,62,2751000,9330305367508361,466,5471706,2485908,2485908,0
14048,Joshua Cavallo,27,2863800,6043941849420139,255,3905460,521884,0,521884
14049,Antonio Ceza,56,3579000,5055775120568785,521,7107688,4084562,409,4084153
14050,Vladislav Cherny,64,2159300,6403637313567411,416,5001906,3316963,3316963,0
14051,Choi Cheol Won,22,2408100,4195984688219222,157,2695328,131876,1319,130557
14052,Choi Bo Kyung,52,2020400,7698129858054098,377,4399447,1893518,190,1893328
14053,Machop Chol,62,3849700,8498773621579126,485,7465676,5959018,0,5959018
14054,Alessandro Circati,55,3913300,7265659776456333,507,6990447,2134849,2135,2132714
14055,James Clarke,22,3170000,5521325483090293,224,4057314,3184162,3185,3180977
14056,Jahmari Clarke,26,4375600,4422802314684621,393,6747993,3047312,0,3047312
14057,Nicolai Clausen,22,4795800,8016365343984793,342,6203702,4778999,4779,4774220
14058,Miloš Ćoćić,28,3786700,9370550193499150,349,5748186,1479774,1480,1478294
14059,Stefan Colakovski,45,4520500,4801378391952472,515,8008993,4220096,423,4219673
14060,Reece Cole,69,4694600,4118674093634255,672,8700683,5724189,5724189,0
14061,Charlie Colkett,28,1808700,8751659979396407,206,2695973,1048092,10481,1037611
14062,Fin Conchie,59,3414300,3498170358183657,493,6331212,4919938,492,4919446
14063,Mihai Constantinescu,67,4604900,3582436441271336,670,8860611,4907622,491,4907131
14064,Sonny Cox,31,4403800,5966830577246721,398,6493574,5509258,550926,4958332
14065,Niklo Dailly,58,3371100,9754855113354390,521,6670895,6512197,0,6512197
14066,Sam Dalby,27,3765000,5097237568516852,297,5249599,2854247,2854247,0
14067,Vontae Daley-Campbell,41,1564000,8263701182378789,215,2530973,1562209,1562209,0
14068,Harvey Davies,60,2684600,8721424612828694,442,5453728,999069,100,998969
14069,Tjay De Barr,51,4856600,7324052156648648,557,8301371,6121987,6122,6115865
14070,Noah De Ridder,54,372800,9373578715190545,250,2057185,747609,747609,0
14071,Max Dean,23,461600,4829147136260406,51,490255,107669,10767,96902
14072,Gary Deegan,48,2456200,9719402975122499,382,4824082,3118956,3118956,0
14073,Allan Michaël Delferrière,44,4314700,6767465775128997,500,6964836,3791431,37915,3753516
14074,Alper Demirol,58,4550600,6409919256275764,554,7308293,5513137,55132,5458005
14075,Will Dennis,62,1685300,4631041901433545,337,3677032,3470414,3471,3466943
14076,Baïla Diallo,22,1528100,8314139117001185,118,1846034,270987,270987,0
14077,Eric Dick,63,2769500,4072098384521558,496,5866410,1665541,0,1665541
14078,Tim-Justin Dietrich,42,4390100,3835231485352219,451,6980574,4449910,4449910,0
14079,David Djiama,24,2494600,9126582840034952,206,3242594,1106322,111,1106211
14080,Dong Yanfeng,51,2351100,3628073323575544,371,4726835,2015526,2015526,0
14081,Colin Doyle,32,1649700,7371646913915591,217,2771737,1255998,125600,1130398
14082,Dawid Drachal,30,3489900,5711869700947615,368,5966602,4053693,405370,3648323
14083,Virgil Drăghia,36,3830000,7560359197678748,383,5954538,1878344,188,1878156
14084,Dylan Duffy,46,1811100,3484690471881339,315,3718315,1072586,10726,1061860
14085,Stephen Duke-McKenna,61,3597000,8230245847925457,568,7554724,5396427,53965,5342462
14086,Olivier Dumont,34,3246300,6500754611594895,372,5359283,2971235,2972,2968263
14087,Jordan Eastham,50,2310000,7737071415697629,365,4468435,3387560,338756,3048804
14088,Matthieu Epolo,38,3614600,5567775973433468,349,5684571,4296765,42968,4253797
14089,Marcelencio Esajas,37,4505300,7816041717498973,447,7343375,912212,913,911299
14090,Romain Esse,55,3707200,6879398813622480,566,7625026,5685716,0,5685716
14091,Emmanuel Essiam,63,1335000,9865791774478461,339,3551735,1272778,12728,1260050
14092,Kieron Evans,63,3576700,8263538370477516,509,6844483,3643636,3643636,0
14093,Bobby Faulkner,48,2284900,3248619933060541,349,4334015,3584911,3584911,0
14094,Fei Yu,67,4560800,4612137595251907,683,9577808,3046257,305,3045952
14095,Feng Boxuan,57,785400,4217939711054719,244,2424392,803339,8034,795305
14096,Gabriel Fermin,63,4869400,6087627959762541,560,8039702,6863994,0,6863994
14097,Raynier Fernandes,34,1788600,3569350579395108,216,2702609,588513,58852,529661
14098,Brahian Fernández,43,3286700,4463718795797829,359,5265010,3230138,324,3229814
14099,Marcelo Fernández,37,2698500,7101675046879147,261,4062885,2316734,23168,2293566
14100,Germán Fernández,48,516300,4678199346503925,178,1582486,68306,68306,0
14101,Will Fitzgerald,59,4140300,4381798413175358,568,7790221,2787377,0,2787377
14102,José Alfredo Flores,66,3976200,3706956186062130,615,8012570,5826178,583,5825595
14103,Ibrahim Fofana,22,4049800,3093107637804804,358,5516636,4539437,4540,4534897
14104,Samuel Folarin,58,3591700,3586950841129729,472,6802632,4516984,4516984,0
14105,Adam Foley,67,4781400,7905743715921887,617,8748958,3606396,36064,3570332
14106,Ian Fray,36,1373400,8010503481912634,208,2332516,272693,272693,0
14107,Macklin Freke,24,1358200,5381463603391764,108,1695378,118869,0,118869
14108,Gustav Friberg,46,4013500,3788245195539514,474,6814313,682135,682135,0
14109,Pascal Fuchs,39,4776100,8332498336835661,465,7744304,6181185,0,6181185
14110,Gan Rui,65,4492500,4745965881975965,611,7705979,3309170,3310,3305860
14111,Gao Tianyi,45,4570000,6957398361706524,511,7979088,218994,218994,0
14112,Gao Huaze,33,3482800,7936029488213563,335,5102718,901813,9019,892794
14113,Milton Garzón,25,3872700,3676183300755088,303,5057441,3601402,36015,3565387
14114,Antoine Gauthier,53,2139400,3756727986722317,378,4532230,1026441,102645,923796
14115,Dario Ndubuisi Gebuhr,39,4956400,5579070343438840,511,8424558,5285153,528516,4756637
14116,Geng Xiaofeng,55,892800,9560686376095966,312,2975918,557618,55762,501856
14117,Łukasz Gerstenstein,51,4398900,6700431617889469,559,7451174,344136,345,343791
14118,Darius Ghindovean,54,2906100,6041329501927407,448,5937532,985082,985082,0
14119,Ally Gilchrist,45,841700,3324198423697469,193,1968428,1811869,1811869,0
14120,Prabhsukhan Gill,41,1209600,8910702388452813,225,2470212,1741885,174189,1567696
14121,Zak Gilsenan,36,2855000,4263205061408614,321,4611634,4532475,0,4532475
14122,Michael Glück,61,2231000,6456682318748343,394,4968574,144664,0,144664
14123,Mauro Bandeira,47,848700,3345635782181884,189,1885625,1444006,14441,1429565
14124,Archie Goodwin,24,879900,8779249709869105,95,1203187,90701,0,90701
14125,Adam Grinwis,26,330100,4179286353480522,47,330428,110085,110085,0
14126,Felix Gschossmann,68,3091200,4246161165198337,515,6315621,5670464,568,5669896
14127,Gui Hong,35,1810100,7571973279815122,218,2926031,2286040,22861,2263179
14128,Max Hagemoser,24,1728100,8091770956945205,124,2151116,1827728,0,1827728
14129,Han Seok Jong,68,1566000,7046253370310294,405,4406975,2231946,2232,2229714
14130,Jayden Harris,38,1243100,4698503326818975,189,2296734,430378,431,429947
14131,Lucien Hawryluk,27,4666900,9286372479113777,418,6593849,1096144,1096144,0
14132,Tom Hendriks,40,2792000,6091948014134179,356,4956077,1143685,1143685,0
14133,Andreas Hirtlreiter,60,1540800,6807819148252812,399,4218865,1118962,1119,1117843
14134,Sam Hornby,29,398500,8164121483772342,68,516477,352391,353,352038
14135,Kristoffer Hoven,35,4483200,5359770302102544,454,6816381,2773071,0,2773071
14136,Sam Howes,37,2165700,4707482012430760,263,3546685,1261095,126110,1134985
14137,Kyle Hudlin,29,1185000,5876705722369453,140,1721292,95073,0,95073
14138,Rhys Hughes,47,452400,4319099044792594,207,1628263,1477019,0,1477019
14139,Alex Hunt,66,4298500,3375363471370203,628,8507789,2924309,292431,2631878
14140,Mackenzie Hunt,62,3530000,4404635948504169,510,7038111,1493869,0,1493869
14141,Hwang Hyun Soo,32,3194100,6057692346668476,280,5036227,1627170,16272,1610898
14142,Dragoș Iancu,70,3435200,4710283005251491,596,7437152,1867227,1868,1865359
14143,Im Dong Hyuk,27,2213700,7169984765793851,184,3145052,1349969,0,1349969
14144,Zeidane Inoussa,35,3322600,9993252768935717,313,4832737,3985440,0,3985440
14145,Robin Jalving,22,1519400,4895609137183603,126,2136672,1214179,121418,1092761
14146,Saikou Janneh,62,4215300,9001582496329758,581,7969128,6974194,69742,6904452
14147,Jocelyn Janneh,43,4852700,5795800400741803,555,8197604,1931401,1931401,0
14148,Zach Jeacock,68,2412400,9289480692627896,423,5456913,2833562,28336,2805226
14149,Malcolm Jeng,66,2387300,6281772200878421,450,5327960,989210,990,988220
14150,Teddy Jenks,56,604700,5387486552916121,284,2356111,1488490,1488490,0
14151,Kacper Jodłowski,46,2576500,8089738810950440,365,4797484,797049,79705,717344
14152,Sebastian Joffre,35,1078400,6929506936108115,181,2070764,1427286,0,1427286
14153,Alexander Johansson,66,356200,5502096871749970,344,2747899,1989309,19894,1969415
14154,Travis Johnson,28,2358200,3483457318739676,201,3385107,337520,33752,303768
14155,Charlie Jolley,28,2050600,8668097093209068,218,3141934,161348,162,161186
14156,Joo Young Jae,32,489100,8617561198682303,101,926215,570264,571,569693
14157,Jaze Kabia,62,3252900,4532845365033493,447,5837770,3200068,0,3200068
14158,Dylan Kadji,57,1261000,7003127528152836,342,3183338,757218,757218,0
14159,Lucas Kåhed,65,1058800,7588162433388939,307,2841795,1402210,141,1402069
14160,Djawal Kaiba,63,495800,7689707350902605,270,2121881,978374,97838,880536
14161,Robin Kalem,28,2690900,3641959607229101,239,4192434,1435760,1435760,0
14162,Conor Kane,66,778300,5625660713336681,282,2421023,52724,52724,0
14163,Yusuf Karagöz,46,4519000,6448305679917097,507,7728987,1457662,1458,1456204
14164,Laxmikant Kattimani,53,1785900,4359068869249752,358,3865422,1785913,0,1785913
14165,Conor Keeley,66,1378000,3572116501023277,375,3810255,1392113,140,1391973
14166,Stijn Keller,49,4083000,9315404594521168,489,6770872,6659723,0,6659723
14167,Aljoscha Kemlein,53,2928100,5084276614366979,448,5699863,3067308,30674,3036634
14168,Logan Ketterer,42,3536000,6668896924896203,420,5688984,4213144,0,4213144
14169,Rafiq Khaleel,30,2609500,8252977937090644,264,3704260,124330,1244,123086
14170,Kim Seung Sub,39,4286500,6454408175051076,461,6650654,2578365,25784,2552581
14171,Kim Keun Bae,44,4104200,7222229661993388,450,7030839,5707199,570720,5136479
14172,Gabriel Kirejczyk,32,4553900,8302649574177711,408,7306578,683867,684,683183
14173,Stefanos Kittos,46,3512200,7550006767132110,404,5411766,3013989,0,3013989
14174,Bartosz Klebaniuk,60,4058700,6143934612798026,519,7235164,830699,830699,0
14175,Davino Knappe,58,961000,9816544484354598,317,3125050,1640555,16406,1624149
14176,Paul Koller,26,3688000,3945822198220554,314,5087332,1322158,0,1322158
14177,Marcel Köstenbauer,28,4465700,9503525648812919,369,6391527,1460238,0,1460238
14178,Louis Köster,33,1338600,6838493549640740,182,2442025,706568,707,705861
14179,Mustafa Kourouma,46,4831800,3774879677507887,508,8327944,1212957,121296,1091661
14180,Jaiden Kucharski,67,4878900,6178161698938625,639,8544369,895877,0,895877
14181,Nishu Kumar,27,3118700,8179309821190781,269,4708820,1079698,10797,1068901
14182,Phurba Lachenpa,46,1760400,8354067897207099,287,3680183,1930792,1931,1928861
14183,Danny Lafferty,26,2798300,4247727162337101,268,4203065,1131070,11311,1119759
14184,Alessandro Lai,41,1378200,5734950496510209,214,2596481,939214,93922,845292
14185,Qasem Lajami,32,933100,5114218920672583,145,1680074,657807,65781,592026
14186,Wojciech Łaski,70,4345200,3452650004571527,621,7821870,7755221,0,7755221
14187,Kian Leavy,52,1201800,9761973899874266,277,2917268,2302407,23025,2279382
14188,Jakub Lewicki,47,3244200,3652929124612409,466,5949373,5576285,0,5576285
14189,Li Hong,40,978200,5183073529843301,177,1798267,1044681,10447,1034234
14190,Li Hailong,29,3902700,5691171867075167,324,5580458,2081871,2081871,0
14191,Frank Liivak,41,1764100,4653381609578623,236,2935601,2197125,0,2197125
14192,Gustav Lindgren,25,1318500,8460122424437349,148,1986026,1424645,1425,1423220
14193,Filip Loftesnes-Bjune,48,4048400,9611177165574760,498,6840217,5694660,570,5694090
14194,Jez Lofthouse,67,4787900,7505526679036032,683,9088101,2174915,0,2174915
14195,Andy Lonergan,56,1121700,9602842716560778,315,3235912,641373,64138,577235
14196,Long Wei,67,4237100,9944621787297619,627,8206376,4059937,0,4059937
14197,Don Deedson Louicius,69,3819200,4727547802018688,557,7321539,7037964,0,7037964
14198,JJ Lunney,67,4119200,9637604167117057,638,8147778,1931867,194,1931673
14199,Dennis Lütke-Frie,54,591200,6196290157996018,229,1949495,618254,619,617635
14200,Maeng Seong Ung,26,3655800,6835712679902193,290,4920792,215634,215634,0
14201,Will Mannion,66,1451900,4731663944475720,387,4030130,2655623,0,2655623
14202,Leo Mätzler,40,2774500,8750235071019918,330,4387868,851784,0,851784
14203,Noah Mawene,60,3935900,9960135157003584,523,7673395,7256510,0,7256510
14204,Jerry Mawihmingthanga,34,2694700,9181497236514979,264,3672423,3003937,301,3003636
14205,Charlie McCann,34,4494300,6184981067846313,416,6496754,6175577,0,6175577
14206,Jason McClelland,61,4814600,7273412609224258,650,9017117,2762484,2763,2759721
14207,Robbie McCourt,39,2788400,5676798877971251,330,4742169,94778,0,94778
14208,Jordan McEneff,69,619500,9095338574073544,281,2338493,2139965,213997,1925968
14209,Tom McGill,25,4565900,7665301248261392,398,6584627,6411630,0,6411630
14210,Jay McGrath,63,4460900,7167333362195217,578,8000701,1321788,133,1321655
14211,Luke McNicholas,70,2081100,3230052546635973,511,5539333,4260633,0,4260633
14212,Omar Megeed,48,1688600,9907753564624923,277,3502947,2190118,219012,1971106
14213,Matthew Meier,49,4026900,5387032278415313,443,6314003,2731152,2731152,0
14214,Paul Mensah,29,2327900,7309764988644609,269,3726612,2766862,0,2766862
14215,Naeem Mohammed,42,3834500,9424799852294872,389,6282223,5233301,0,5233301
14216,Gavin Molloy,27,4005800,7598526366886651,328,5728507,5679532,568,5678964
14217,Alex Monis,41,4655700,5018167865565264,482,7428629,2761651,0,2761651
14218,Bader Monshi,41,859100,8807708516114037,191,1873156,1026017,10261,1015756
14219,Niall Morahan,68,3338100,7623552893039842,528,6839062,6055497,0,6055497
14220,Andrew Moran,53,4034500,8181686676546922,478,7172563,7152885,71529,7081356
14221,Liam Morrison,67,4124400,9208699085558571,595,7571337,7376830,73769,7303061
14222,Jaly Mouaddib,54,2639200,6162779226898942,387,4575955,3262079,327,3261752
14223,Jacob Muir,64,3370600,9230811711169647,538,6926425,80356,804,79552
14224,Jamie Mullins,62,3617000,7030849601453390,550,6862145,4949897,4950,4944947
14225,Cristóbal Muñoz,68,3907500,3065451349936343,578,7858693,6321381,632139,5689242
14226,Eric N'Jo,28,1539900,8258124183688508,155,2180798,796325,0,796325
14227,Halicharan Narzary,62,1628900,3348007341632033,380,3890073,3229128,0,3229128
14228,Stephan Negru,60,3762500,5927869100145209,460,6439094,6022188,0,6022188
14229,Serge Ngoma,44,1483000,6644207193608339,281,3106834,1424434,1424434,0
14230,Abdulaziz Noor,29,4460000,3658063890368398,385,6001312,1363263,1363263,0
14231,Runar Norheim,40,3357200,9064812379118464,339,4978483,654658,0,654658
14232,David Norman Jr.,66,2591700,6402184279626214,481,6192921,1786831,178684,1608147
14233,Mitchy Ntelo,58,844700,5646059446586355,292,2610808,2448970,2449,2446521
14234,Jim O'Brien,41,1785700,3102471367024732,222,2811667,1318771,132,1318639
14235,Gatlin O'Donkor,49,1306400,5524703061360389,260,2801511,2089199,0,2089199
14236,Gino Olguin,62,718500,8849990908176347,331,3007211,2100441,2100441,0
14237,Nicolas-Bernd Oliveira,26,454000,4157197513934105,60,488823,186481,0,186481
14238,Filip Olsson,65,1665200,4973149521570091,367,3895236,3551418,355142,3196276
14239,Oskar Opsahl,50,4945100,6725680015267078,591,8468569,5756606,0,5756606
14240,Danilo Orsi,36,1043700,6861971641827666,171,1822112,987497,988,986509
14241,Lorenz Otto,33,1800000,5496559944941614,211,2864529,529690,0,529690
14242,Tunde Owolabi,41,2826300,9750536090053821,338,5018280,3001925,3002,2998923
14243,Andrea Padula,56,981500,7076902581669889,288,2827182,706174,706174,0
14244,Dan Panait,52,2582100,7164095158379943,429,4920267,3186380,3186380,0
14245,Ishan Pandita,47,2496500,9686060525272015,362,4773120,686563,0,686563
14246,Park Chu Young,69,2218300,8213266840670464,442,4697185,150735,0,150735
14247,Stefan Parkes,46,2597500,8597235946816872,358,4398296,529297,52930,476367
14248,Alex Parsons,49,3422200,4399265049209940,460,6418461,4152949,4152949,0
14249,Alem Pasic,28,4264100,4840475695188128,431,6542675,2207559,221,2207338
14250,Sebastian Pasquali,44,1043500,3908562579126575,179,2013734,1019942,102,1019840
14251,Ben Paton,49,2402600,3260006398690359,348,4640580,4500741,450075,4050666
14252,Adam Petersson,61,4377800,6233611426573376,579,8229484,1997366,0,1997366
14253,Alexandre Pierre,38,814100,5984554842254420,185,1891225,328123,0,328123
14254,Finlay Pollock,61,3036000,4924970382939209,467,6223623,4707991,471,4707520
14255,Alexandru Pop,22,875800,5721378953555804,86,1022926,72262,72262,0
14256,Kristian Popovic,29,3231900,8750073275933959,290,4318170,954036,954036,0
14257,Freddie Potts,52,892100,5874760439367070,212,2113065,1700629,1700629,0
14258,Jacob Pryts Larsen,49,4163100,9347769280502312,496,7015118,1426515,14266,1412249
14259,Fotis Pseftis,67,2030200,8086171117874626,389,4496421,1778053,178,1777875
14260,Ahmed Qasem,36,4261500,5187617732822478,421,6697467,5369864,0,5369864
14261,Ghjuvanni Quilichini,51,4041000,5077491951192446,466,6519007,1476307,14764,1461543
14262,Abdullah Radif,28,1789100,4795211806246799,145,2127170,799647,0,799647
14263,TP Rehenesh,46,4605800,6428077945532370,499,8220219,4451435,4451435,0
14264,Jan Reichert,31,3521700,9666658795906479,314,5131286,1377751,1377751,0
14265,Thomas Rekdal,57,3990400,7824862406852598,577,7614356,4744587,4745,4739842
14266,Justin Rennicks,44,2438800,7328150070042971,327,4157333,3839667,0,3839667
14267,Laldinliana Renthlei,40,2441400,5085677015862338,300,4274568,1704381,0,1704381
14268,David Richards,26,1203100,5163321026248735,104,1396000,105540,105540,0
14269,Alessandro Riep,67,3688400,5893175120051104,600,7883455,4453303,4453303,0
14270,Alex Robertson,61,2807700,8421824689372871,441,5664849,57764,57764,0
14271,Zach Robinson,24,4437400,7664329303706634,384,6070368,2843678,2843678,0
14272,Jack Robinson,28,2094800,8266012015957973,196,2801994,2771661,278,2771383
14273,Alex Rodríguez,56,824600,7873857590993131,249,2473366,481451,48146,433305
14274,Víctor Rojas,42,3321800,8785773769200306,421,5851815,2810057,2811,2807246
14275,Vilmer Rönnberg,48,1293200,6935699950710332,278,3128576,2311684,2312,2309372
14276,Håkon Røsten,48,2861900,3700316210734877,407,5098606,4016656,40167,3976489
14277,Hormipam Ruivah,26,2928800,4741078506808846,263,4311117,901822,0,901822
14278,Andrei Rus,27,2424700,9947594058018867,240,3453395,868855,0,868855
14279,Adam Saldaña,46,1677400,4753101767347093,254,2931708,2915327,2915327,0
14280,Dilan Salgado,67,1653200,9237119725691723,431,4572401,2156187,2157,2154030
14281,Sais Santibáñez,59,3776900,5677898255179905,474,6341785,3430712,344,3430368
14282,Marcel Schantl,22,1456500,3695377545649387,88,1543496,1174425,0,1174425
14283,Fabian Scherger,69,3621600,8461416031483938,549,6957415,2645017,265,2644752
14284,Julius Schmid,54,3720900,6142657683413049,538,7203966,6675743,6675743,0
14285,Philipp Schulz,56,4017900,4638300061813498,485,7135013,4915343,492,4914851
14286,Joel Senior,31,3107100,3159136118887701,281,4582481,3670489,0,3670489
14287,Laurens Serpe,69,4066900,5253372608317122,640,7751532,7112336,71124,7041212
14288,Shi Yan,62,1374200,5294508860080319,364,3852493,3245914,32460,3213454
14289,Udanta Singh,41,3610400,5622557462178907,415,5942598,1473091,14731,1458360
14290,Mehtab Singh,66,476600,7440081321288084,291,2490931,1183340,119,1183221
14291,Naorem Mahesh Singh,58,1188600,5129200973301241,340,3584643,1994591,200,1994391
14292,Filipe Sissé,59,1570200,5655999238765178,349,3754905,2496832,24969,2471863
14293,Henrik Skogvold,44,1413400,7937331663336916,249,2889617,2873849,288,2873561
14294,Jerry Skotadis,45,1107900,8402033933929301,246,2522152,45292,45292,0
14295,Kacper Skwierczyński,63,484100,3358147658793871,284,2376580,1790196,180,1790016
14296,Andreas Smed,67,2304600,4158193417694002,438,5070260,325974,0,325974
14297,Tommy Smith,62,2478400,3807018706359272,463,5596634,2981914,2981914,0
14298,Tom Smith,57,4490700,3893839853318652,563,8062868,7189476,0,7189476
14299,Mark Spenkelink,48,1212800,9527583571481064,241,2793706,216869,0,216869
14300,Mason Stajduhar,60,430400,6271349236577218,245,2017813,1105421,110543,994878
14301,Apostolos Stamatelopoulos,70,1327600,7386138171074259,410,3917571,1006447,101,1006346
14302,Harry Steele,29,3598600,4290025742637216,334,5241570,4504427,45045,4459382
14303,Maksim Stjopin,68,3683500,6206862308209336,610,7189811,6839179,0,6839179
14304,Josh Stones,27,951000,5009610113170072,105,1360709,1246060,1247,1244813
14305,Su Yuanjie,25,1131500,5865087448939193,116,1441374,1249641,12497,1237144
14306,Yahya Sunbul,50,1384600,9466670696652016,283,3094350,2913708,2913708,0
14307,Jakub Szymański,63,1308800,6395946416875809,348,3632939,342963,3430,339533
14308,Karol Szymański,56,1000500,8110274233240212,257,2361009,2165571,0,2165571
14309,Joel Tabiner,42,4761000,9955476083086882,435,7459957,3000843,0,3000843
14310,Deepak Tangri,31,3542500,7488690164444870,358,5318887,3341741,0,3341741
14311,Ollie Tanner,23,2082600,7000302041284183,184,2886783,2790174,2791,2787383
14312,Omar Taylor-Clarke,35,4441100,4694095725753199,463,7331094,4058797,4059,4054738
14313,Róbert Thorkelsson,25,3980100,3142292377898509,329,5696596,3810856,38109,3772747
14314,Elliot Thorpe,44,1101400,7770177279725879,207,2442805,1570794,0,1570794
14315,Thijs Timmermans,66,2816500,9417719593503509,464,5647420,252976,2530,250446
14316,Cătălin Țîră,28,1615200,5479169039108942,145,2097256,215934,21594,194340
14317,Ask Tjærandsen-Skau,38,3002000,4317668955229889,324,5078076,3824740,383,3824357
14318,Sam Todd,59,1155900,6781694209721696,354,3322943,2463729,24638,2439091
14319,Hubert Tomalski,56,3068100,6093179783407101,434,5623387,1532005,1533,1530472
14320,Fabio Torsiello,39,1309900,3652899986474541,220,2407819,7468,0,7468
14321,Ángel Vaca,30,2379100,4104947160453967,225,3457281,2177585,2178,2175407
14322,VP Suhair,53,2130300,9208498959296530,382,4899402,4555395,4555395,0
14323,Andreas Vaher,29,2099600,3692680622016322,215,3103410,2760568,276057,2484511
14324,Javier Vallejos,66,3032800,5932065180082309,515,6246868,5279681,528,5279153
14325,Miguel Angel Villarroel,40,3879900,7107650803504797,433,6419330,5720757,0,5720757
14326,Lars Villiger,60,4653000,9223156858153707,647,8800129,20921,210,20711
14327,Niko Vukancic,69,2146100,3460600022393705,419,4944316,3433411,3434,3429977
14328,Aurel Wagbe,31,4235600,3395573358777047,385,5894176,2181730,219,2181511
14329,Charlie Webster,63,3128100,3024008630422821,510,6787865,6311802,0,6311802
14330,Miles Welch-Hayes,62,1113300,4451606018331692,317,3145707,2099713,0,2099713
14331,Max Wendt,51,355400,8967456333434308,229,1845135,1129302,112931,1016371
14332,Amund Wichne,70,3346400,9381776076979515,608,7185086,3797019,379702,3417317
14333,George Wickens,39,4192100,7175115986492614,502,6680287,2587481,2587481,0
14334,Adam Wikman,26,1374500,7577083167099208,148,2122330,21491,215,21276
14335,Zac Williams,50,1170500,6959848189494563,270,2774556,2305229,0,2305229
14336,Mauricio Willimann,37,1560800,9752580983690110,207,2607419,2291827,229183,2062644
14337,Donovan Wilson,30,4086600,7179450308583435,352,6144819,3589672,0,3589672
14338,Nathan Wood,49,4078900,9628303265494753,496,7086724,4155908,41560,4114348
14339,Krzysztof Wróblewski,62,999400,7953112444377682,375,3601223,2927697,29277,2898420
14340,Xie Weijun,35,1275300,5800540730608244,165,2075182,146121,1462,144659
14341,Xu Haofeng,36,2668800,7950686828500872,315,4447294,1739955,1740,1738215
14342,Yang Mingyang,62,581200,4933372580596827,333,3022268,540831,540831,0
14343,Yang Zexiang,63,1979800,7333240677776544,401,4655409,4168120,4168120,0
14344,Yang Boyu,67,2341500,4830647847367181,438,5038929,4841251,0,4841251
14345,Karifa Yao,55,763100,6426746186049731,222,1998752,1806185,0,1806185
14346,Jake Young,45,4297000,5518331422887235,479,6835567,2550861,2550861,0
14347,Griffin Yow,60,2088900,4100581894818191,363,4344287,681089,68109,612980
14348,Zhang Li,31,4540600,4363447418522551,421,6904577,5864709,5864709,0
14349,Zhu Ting,50,4392700,8779466777941590,535,7457070,2203933,220394,1983539
14350,Petar Zovko,49,3506200,4579354414148563,450,6584365,916785,917,915868
14351,Hassan Abu Sharara,36,3703700,7343023907219083,365,5514349,748455,0,748455
14352,Mihai Adăscăliței,27,3701500,4624302062073592,314,5254429,200998,0,200998
14353,Corey Addai,33,4716000,6455093229541469,394,6167929,1930841,0,1930841
14354,Nathaniel Adjei,56,4213900,9276590633671337,557,8147792,5243530,5244,5238286
14355,Jesper Adolfsson,24,2937700,3004286202245484,264,4477233,3091966,30920,3061046
14356,Jonathan Ægidius,43,3028000,9262768005437671,378,5004873,3577367,0,3577367
14357,Malek Al Abdulmunem,64,1537700,8533004637257363,328,3727163,3220205,0,3220205
14358,Thamer Al Ali,70,321200,7729973391013849,378,2896660,2383439,0,2383439
14359,Ahmad Al Habib,27,4370700,3875446536192509,395,6720205,3837947,383795,3454152
14360,Yousef Al Harbi,55,1898400,6620858810856744,370,4078263,1476321,1476321,0
14361,Abdulrahman Al Harthi,51,1908500,9609933626983905,341,3826505,2830622,28307,2802315
14362,Sultan Al Manthari,27,1105900,4221367142395797,103,1374581,895782,895782,0
14363,Ahmad Al Mohaimeed,70,3048600,9855401356564434,530,6330669,4918355,0,4918355
14364,Mohammed Al Oufi,34,3691800,8626195692728807,386,6031771,2436795,0,2436795
14365,Noor Al Rashidi,38,1063800,3329971032290409,198,2091622,812995,81300,731695
14366,Abdulrahman Al Riou,24,2096100,4972160014019220,170,2672528,342641,3427,339214
14367,Abdullah Al Shammari,37,1393500,6063844458717671,206,2661681,585053,586,584467
14368,Abdullah Al Yousif,65,4864300,9268778205447124,671,8966754,4414153,4414153,0
14369,Nicolas Alavoine,53,2164800,9531044027450482,366,4436145,1042411,0,1042411
14370,Noah Allen,40,2129500,4548475091804017,273,3487970,2739635,274,2739361
14371,Ilyas Ansah,25,3095200,7860670680435053,269,4770774,1636973,16370,1620603
14372,Rob Apter,57,305400,6676183068354769,240,1783899,149453,1495,147958
14373,Maleace Asamoah,37,4976800,3999120505549080,522,7981383,5894414,590,5893824
14374,Zach Awe,56,3838200,5582099727384836,547,6907219,4559375,0,4559375
14375,Bilal Bafdili,23,2561800,7092619397320865,220,3756031,726469,72647,653822
14376,Yunus Bahadır,61,4101100,6673596338967075,574,7340617,3319281,33193,3286088
14377,Samson Baidoo,33,1438900,6229322918995117,179,2306534,664942,0,664942
14378,Jonathan Barden,49,4242700,3768369096709016,472,7297143,3040976,0,3040976
14379,Davis Bautista,56,2049200,8992699632059647,344,4263481,4157918,0,4157918
14380,Alaa Bellaarouch,32,1122600,3808986758925405,119,1476253,38319,0,38319
14381,Luca Bendel,58,4152200,4252536281961333,584,7966865,7364097,0,7364097
14382,Adam Ingi Benediktsson,29,1616000,7522543013164602,196,2774400,1841109,1842,1839267
14383,Denis Benga,55,4833500,5900828166571341,618,9146493,2178633,2179,2176454
14384,Matt Bersano,27,3760100,8567970903660937,351,5715313,4152949,0,4152949
14385,Tyler Bindon,67,4262200,4266618320441461,591,8175038,3344175,0,3344175
14386,Vladislav Blănuță,51,454700,6898061375219087,221,1932274,1813538,0,1813538
14387,Marc Bombardó,46,322700,7017958081035830,171,1301212,372775,37278,335497
14388,Pedro Borges,56,1298700,9133559847866168,291,3149831,2796102,27962,2768140
14389,Raphael Borges Rodrigues,60,3313700,5769840304327681,438,5641436,4700753,471,4700282
14390,Théo Borne,33,2116800,3936026949551518,251,3473298,2515893,25159,2490734
14391,Ousseni Bouda,47,1757300,9621379054922345,319,3707116,2071066,2071066,0
14392,Johan Brannefalk,54,3484500,9564130754505977,509,6291642,3106871,310688,2796183
14393,Harry Brockbank,38,2169200,4228999177967309,278,3585175,1802662,0,1802662
14394,Charlie Brown,61,1781600,6727675429938895,412,4580457,3766732,37668,3729064
14395,Lukas Browning-Lagerfeldt,24,1405600,5068764117216166,105,1643641,82686,8269,74417
14396,Daniel Bunk,37,1329200,4157980642689704,189,2343520,463682,464,463218
14397,Byeon Jun Soo,57,3340000,8658663029333013,426,6139811,5307554,530756,4776798
14398,Evan Caffrey,52,1297500,3362133365710328,340,3350505,3261963,32620,3229343
14399,Cao Kang,25,1647200,7246135425406630,167,2392104,585952,0,585952
14400,Juan David Carabalí,40,3329300,4836732550040272,431,6272381,2669875,2669875,0
14401,Jarrod Carluccio,26,787500,8386128227654700,75,940376,242645,24265,218380
14402,Conor Carty,40,1807000,6911817564162928,243,3056163,697082,698,696384
14403,Arnau Casas,45,1690600,4832196842686382,259,3227503,1604684,1605,1603079
14404,Orué Chacín,61,4540000,6789767739254549,679,8422907,5411234,5412,5405822
14405,Miguel Chaiwa,29,1474700,5132853800762109,147,2033766,247265,0,247265
14406,Taylor Charters,49,484200,3510111078742951,213,1887957,341722,341722,0
14407,Caleb Chukwuemeka,55,4136200,7953629830609628,525,7107413,1838552,183856,1654696
14408,Bobby Clark,48,1622300,7321519014617366,255,3311980,1612611,162,1612449
14409,Jayden Clarke,67,1404000,3211303617620899,416,4116532,3372777,3373,3369404
14410,Cian Coleman,70,3322600,3352531261428016,589,7589026,242553,0,242553
14411,Cameron Congreve,28,446200,9690242441940936,72,588349,509872,509872,0
14412,Dixon Contreras,35,3447100,9410852343959591,344,5206263,607904,0,607904
14413,Leon Cuk,28,2825800,5532462779570368,247,3919294,2641537,0,2641537
14414,Anders Dahl,34,4932600,7936896100082203,459,7627639,7038646,70387,6968259
14415,James Daly,38,3799100,4787021681771273,376,5559132,3919696,3920,3915776
14416,Alaín de Guzman,51,2628200,5435685780496488,384,4799575,1634107,163411,1470696
14417,Nils De Mol,62,1820400,4895855171957422,415,4466420,2365803,0,2365803
14418,Maurice Dehler,59,2755600,4698261166781796,403,4970903,2435960,244,2435716
14419,Martin Delavallée,35,1630300,8085376408931671,194,2825757,275465,0,275465
14420,Sada Diallo,65,3275300,4931397812232240,513,6535416,6507102,6508,6500594
14421,Gavin Didzilatis,42,3192200,9228284401801203,377,5114562,527303,52731,474572
14422,Ethan Dobbelaere,62,1738500,5538445866769028,413,4467205,3800867,380087,3420780
14423,Aibanbha Dohling,34,301200,5572170054144334,100,698085,419420,41942,377478
14424,Callum Dolan,59,4261400,5281537387795413,521,7495646,5258397,0,5258397
14425,Stephen Dooley,52,3486700,4012848748735959,439,5818043,376469,0,376469
14426,Jed Drew,54,1383900,5949621246854159,281,3123563,556272,55628,500644
14427,Antonio Dumitru,27,3539900,8255441744914690,295,4917540,3679056,3679056,0
14428,Adrian Durrer,57,1685900,8320355242443690,320,3651202,2893816,28939,2864877
14429,Maksymilian Dziuba,62,3293400,3218696898561740,586,7173278,866213,0,866213
14430,Yacine El Amri,57,1169500,9699457625335144,329,3389294,2172726,2172726,0
14431,Ziad El Sheiwi,63,888700,7016496071971686,335,3142315,1336237,134,1336103
14432,Luc Thomas Elsner,62,384600,3448730411690879,305,2500933,804422,80443,723979
14433,Aidomo Emakhu,32,1802800,6465012400760122,179,2584528,1370656,138,1370518
14434,Abdulmohsen Fallatah,22,384600,7644354032843121,39,270342,144398,144398,0
14435,Zack Farnsworth,32,2075600,9424035150057326,219,3031094,947519,948,946571
14436,Joshua Feeney,55,3776600,5994983708767867,502,6992471,5126061,51261,5074800
14437,Justin Ferizaj,24,1495300,9747410993489668,135,1934958,1565267,1565267,0
14438,Robert Filip,24,438700,3552651130309575,55,454036,400894,0,400894
14439,Shaqai Forde,56,874000,4563419232624594,241,2430112,1022970,1022970,0
14440,Justin Forst,26,2108200,6644106848015288,194,3025596,2095157,2096,2093061
14441,Pablo Gaitán,39,2315500,3740172795499549,311,4303374,493064,494,492570
14442,Patrick Gamble,36,2799800,7378834310188003,323,4566528,3439984,0,3439984
14443,Costin Ghiocel,61,3076300,4155218210395129,533,6488209,6378673,0,6378673
14444,Thomas Gillier,48,993900,8146527811742393,214,2327878,1974138,1974138,0
14445,Juan José Giménez,45,4408000,4686452851396534,536,7305122,2755994,0,2755994
14446,Jake Girdwood-Reich,32,3888900,6248448222949645,346,5690628,4156233,41563,4114670
14447,Grzegorz Glapka,42,463800,6589607658091648,135,1038398,639001,63901,575100
14448,Ricardo Gonçalves,52,1066300,9674175839705241,256,2625687,1219739,121974,1097765
14449,José González,69,2870900,9251421255324335,511,6087742,4715144,4716,4710428
14450,Ángel González,25,2618300,4134376063651493,218,3900893,3695213,36953,3658260
14451,Dani González,26,4376400,8311147761292263,396,5947484,5239883,0,5239883
14452,Will Greenidge,69,2120900,6527400779054142,474,5343967,1925461,192547,1732914
14453,Leon Grgic,50,3890900,9054627936334781,515,6942199,5617736,0,5617736
14454,Reo Griffiths,31,4904600,6056583596005266,484,7976625,6216918,62170,6154748
14455,Dylan Grimes,66,1618900,5712749489445856,379,4129997,3608302,3609,3604693
14456,Luis Guillén,34,1665300,3416863010661673,217,2728311,858041,858041,0
14457,Aaron Gurd,29,3227100,4669391344778552,352,5084101,3909888,39099,3870789
14458,Gabriel Haider,23,1018800,4009041430092188,105,1339307,91282,91282,0
14459,Pronay Halder,65,3579600,9096856782231349,520,7080965,5433250,0,5433250
14460,Oliver Hammond,30,2657200,8580268204925079,278,4221479,970933,0,970933
14461,David Harrington,49,2999000,7098669771124295,409,5785787,1123743,11238,1112505
14462,He Longhai,62,3940700,3806950826228403,534,7471155,2123005,2124,2120881
14463,Luke Heeney,64,4942900,7091001824694520,642,8835123,564974,0,564974
14464,Joe Hilton,57,2313200,5138819428891648,362,4897281,4742388,4743,4737645
14465,Oscar Højlund,55,2290700,6515624561147140,355,4377466,2445306,24454,2420852
14466,Florian Hoxha,43,4100700,5553133374717334,438,6770623,346860,3469,343391
14467,Jonathan Hutters,57,989400,3768019270392700,325,3032785,37145,0,37145
14468,Ethan Ingram,66,3875700,5001758457741217,573,7312940,685017,68502,616515
14469,David Irimia,58,4931200,6778430885219034,554,7910860,5474233,0,5474233
14470,Alexandru Irimia,44,427700,9440007028770601,166,1308888,850424,8505,841919
14471,Luke Ivanovic,29,3717500,8071085096265483,330,5548767,2692500,269250,2423250
14472,Will Jarvis,54,4533400,5854422914240575,573,8271183,3133380,0,3133380
14473,David Jaunegg,70,2154200,3501345767726316,510,5523755,2822106,0,2822106
14474,Jakub Jędrasik,51,1487800,5864761177215084,257,3010919,2892296,2892296,0
14475,Niklas Jessen,30,681600,5398741035206728,108,1077044,867184,86719,780465
14476,Ji Dong Won,34,4273900,6898565028874726,401,6856873,5760,576,5184
14477,William Kaastrup,52,3702100,5238284544524142,464,6672487,4680742,4681,4676061
14478,Dion Kacuri,37,2756400,9810694976034262,310,4687253,1014014,1014014,0
14479,Nils Kaiser,40,534300,5318346268330301,145,1276118,990320,100,990220
14480,Rahul KP,59,1767100,4447043065493513,400,4537527,932421,0,932421
14481,Adrian Kappenberger,43,4192300,3302242068121814,477,6966550,3223097,0,3223097
14482,İlker Karakaş,66,4490300,7751263126950838,595,8622600,5886979,589,5886390
14483,Lucas Kiewitt,54,4675200,7528431285076711,616,9303690,3495540,3496,3492044
14484,Kim Hyun Woo,25,2548900,6150736014839673,242,3553865,1620981,162099,1458882
14485,Kim Jung Ho,38,2966100,9181779858007685,333,4774410,1217268,121727,1095541
14486,Kim Ju Yeop,58,2155100,7771227115319809,420,4755329,3414979,0,3414979
14487,Kim Seung Woo,42,1014200,6455127956423747,172,1883654,104947,104947,0
14488,Kim Hee Seung,65,2117500,5164390370902665,363,4463634,2597347,260,2597087
14489,Henrik Koch,70,4475300,8979851874746481,656,8849323,7453617,7454,7446163
14490,Niko Koulis,56,4339200,6891822258914711,494,7442890,2648224,265,2647959
14491,Dion Krasniqi,38,2737300,4858073883255190,342,4784971,4207024,42071,4164953
14492,Maksym Kucheriavyi,63,4192800,4994140543014182,561,7692869,1861457,186146,1675311
14493,Ritwik Kumar Das,26,3753600,6196864471116062,347,5684918,974628,97463,877165
14494,Robert Kwasigroch,64,2988200,4193843688672488,499,6346866,1566876,1567,1565309
14495,Jojea Kwizera,28,2754300,5497955861624229,246,3814445,2471442,24715,2446727
14496,Jerry Lalrinzuala,45,2415600,7369905888864882,303,4177107,2525609,0,2525609
14497,Tor Erik Larsen,59,1417300,4654353066524264,370,3952714,734452,734452,0
14498,Tobias Lauritsen,24,656300,5207599879546878,55,683066,368752,36876,331876
14499,Lee Gi Hyeok,27,1891400,3007035153293891,190,2812599,691605,69161,622444
14500,Paul Lehmann,57,1775300,7763086328602284,336,3516948,820365,0,820365
14501,Li Shenyuan,36,2848700,4210778597976104,281,4232938,2941637,295,2941342
14502,Josh Lillis,48,3785900,5294813447722096,465,6818768,2405604,240561,2165043
14503,Liu Shibo,48,3625200,3451459166616156,426,5968784,4263371,0,4263371
14504,Liu Wei,54,3208100,5353633687884121,428,6066658,3957247,0,3957247
14505,Alessandro Lopane,23,1715900,3683313262916711,111,1957085,1690483,0,1690483
14506,Ali Loune,33,4240200,4086518438516352,394,6487853,708077,708077,0
14507,Ma Fuyu,45,3384300,5822995316368872,426,5875067,937586,938,936648
14508,Panashe Madanha,41,1668800,3156319054151113,228,2981463,1855086,0,1855086
14509,Ali Makki,39,4992000,6779713567753195,519,8647975,2865476,0,2865476
14510,Filippo Manfrin,48,4944000,8305658280084139,552,8044792,77032,0,77032
14511,Dominik Marczuk,68,1683500,9005988301603873,383,4149862,735265,735265,0
14512,Anthony Markanich,29,1219600,7686529554488213,163,2041014,1113308,0,1113308
14513,Filip Marschall,22,486700,4904378596420508,18,221712,17499,1750,15749
14514,Findlay Marshall,57,3103200,8448970830510776,458,5578876,5013126,0,5013126
14515,John Martin,29,2179800,6249253772564111,232,3297694,1472647,148,1472499
14516,Xander Martlé,28,558000,9772874544624710,90,813554,203437,0,203437
14517,Dario Marzino,29,384700,3474245596330591,79,661156,633174,634,632540
14518,Yegor Matsenko,70,4571300,9211168565244060,567,7923518,5598032,5598032,0
14519,Mirco Mazzeo,27,4819300,4803734609186284,376,7031858,181846,181846,0
14520,Reece McAlear,40,2910100,5484205224629526,341,4666658,1523113,15232,1507881
14521,Ben McCormack,26,2606400,5387390497150043,236,3894642,3483078,0,3483078
14522,James McManus,28,3881700,9304952100692101,358,5712407,2917530,2917530,0
14523,D'Mani Mellor,33,1787100,9861187536634189,224,2914143,2765060,2766,2762294
14524,Juliën Mesbahi,59,1036500,7140058593713128,341,3396919,2644716,2644716,0
14525,Cristian Mihai,67,1925000,5938820881380874,417,4338818,1476750,147675,1329075
14526,Harrison Minturn,51,2906100,4855804363872264,374,4694884,2734619,2735,2731884
14527,Hendrik Mittelstädt,57,3321900,9993657339132425,433,6250285,2409495,2410,2407085
14528,Diego Monreal,69,567300,4357186159296069,295,2545891,891958,892,891066
14529,Mu Pengfei,53,2116300,8271669175296246,365,4218059,3444498,0,3444498
14530,Divin Mubama,46,1846600,9343439801625453,246,3123218,115866,115866,0
14531,Miguel Muñoz,31,1063500,4852568108252251,124,1457770,699104,699104,0
14532,Christian N'Guessan,23,1364200,7278295267178349,119,1857489,909581,9096,900485
14533,Santiago Natera,66,720200,5468091082321996,337,2777314,781581,781581,0
14534,Blondy Nna Noukeu,56,1237100,4059309779938834,297,3162142,1944175,0,1944175
14535,Matthew Nocita,40,2229100,4512976715998319,317,3815326,618917,0,618917
14536,Jack Nolan,33,1072500,3544374006439594,146,1721687,1514037,0,1514037
14537,Nahuel Noll,54,3197700,6971298471126436,412,5497156,2044278,0,2044278
14538,Darragh Nugent,59,2365000,8989527166266325,408,5108187,1280318,1281,1279037
14539,Joe O'Brien-Whitmarsh,70,1048700,9473076105217779,344,3251879,1121144,1122,1120022
14540,Ollie O'Neill,43,2508300,5909262139670675,306,4615992,2728755,2729,2726026
14541,Karl O'Sullivan,56,3439100,8805860788145285,482,5924312,1625741,162575,1463166
14542,Marcel Oakley,43,372300,7684970194820832,134,1063624,266033,267,265766
14543,Idris Odutayo,35,2079700,5354188350788135,274,3745472,1135326,113533,1021793
14544,Krystian Okoniewski,47,921100,3874321459559582,250,2517710,882209,883,881326
14545,Chiel Olde Keizer,54,3563800,9819989091324016,442,6054203,4077038,0,4077038
14546,Gabriele Onesti,68,2436300,3837402022532859,496,5418653,3970622,397063,3573559
14547,Darius Oroian,36,4834100,3419312883956989,457,7151577,1171041,117105,1053936
14548,Jordi Ortega,54,3235300,3712146650251317,477,6621445,4539602,45397,4494205
14549,Benjamín Osses,34,1087300,9806606124488098,161,1918260,274641,275,274366
14550,Eren Öztürk,55,2413900,9190755855774446,393,4925675,4715353,4715353,0
14551,Gerardo Padrón,35,4402200,3562213985343815,412,6176630,2845422,2846,2842576
14552,Malte Påhlsson,32,3278700,7243747249572438,351,5620301,2935654,294,2935360
14553,Jasper Pattenden,30,3740200,7663747091929904,340,5456616,2753910,0,2753910
14554,Ayrton Paz,27,477800,3706250666579240,44,378318,154235,15424,138811
14555,Cameron Peupion,24,2431100,8134744365045181,217,3459169,681191,6812,674379
14556,Marcelo Pitaluga,26,2277800,4514138347257841,245,3600988,565464,565464,0
14557,Nikhil Poojary,54,1034000,4147000619487238,320,3040876,353540,0,353540
14558,Nicolas Popescu,27,3813800,5944034785262477,348,5602035,4525472,4525472,0
14559,Kacper Przybyłko,41,2016300,4123989076514895,296,4051467,2383429,0,2383429
14560,Andrew Quinn,28,2448300,6358673629325606,245,3927097,288038,0,288038
14561,Vinit Rai,58,2463800,8379867887940965,408,5068574,2134817,0,2134817
14562,Mandar Rao Dessai,65,1896400,3559258784892393,418,4790054,1444080,0,1444080
14563,Lewis Richards,31,419400,4489641289260200,98,774981,143772,1438,142334
14564,Luke Robinson,38,2569400,9283710458987494,278,3791076,2969424,29695,2939729
14565,Benjamín Rojas,34,2105200,9993750528409099,255,3357084,1339309,1340,1337969
14566,Jack Roles,28,3848000,8733455838667692,349,5660180,1645286,16453,1628833
14567,Yadegar Rostami,46,4074400,4783744616011456,515,7588675,6664456,6665,6657791
14568,Mats Rots,49,3827900,5306159723477308,487,6802604,566694,567,566127
14569,Jakub Rozwadowski,22,1992600,9754570897928887,172,2567357,1940617,19407,1921210
14570,Marco Rus,30,2789800,8879357623255902,261,4066800,3175469,31755,3143714
14571,Richie Sagrado,62,3579500,6775570282388947,525,7228883,4042897,404290,3638607
14572,Maxime Sainte,30,4740900,8513470807704291,435,7322593,6688405,669,6687736
14573,David Sala,25,3835300,6429382297111937,371,6200729,2285897,228590,2057307
14574,Abundance Salaou,27,4124200,3485674965305778,355,6255324,1342616,0,1342616
14575,Ángel Sánchez Chávez,38,4082500,4931113731795125,451,6557448,1501377,151,1501226
14576,Franco Schädlich,36,2206800,9167144449706367,297,4076099,1510461,152,1510309
14577,Johannes Schenk,33,4109800,7381211680666416,365,6006739,3143312,0,3143312
14578,Paul Schermer,54,1263000,3264975644304481,331,3391828,2098164,210,2097954
14579,Joël Schingtienne,35,4370100,9695204640945263,470,7552995,4272603,4272603,0
14580,Timo Schlieck,36,955100,5488807259971529,167,1741116,957680,0,957680
14581,Sam Schutti,56,444300,7733214562713920,231,1855542,130807,0,130807
14582,Nandhakumar Sekar,52,1993600,4320161648744873,288,3832348,3338600,3338600,0
14583,Sebastian Selin,37,4308700,4767524370512041,444,6997393,5053887,0,5053887
14584,Giovanny Sequera,54,4238200,4703001105363596,500,6936008,1026084,102609,923475
14585,Hussain Shaian,34,2424100,9015093434490752,282,4038312,2479070,24791,2454279
14586,Hitesh Sharma,52,3835800,8978194052981563,496,6783975,3351441,0,3351441
14587,Yeljan Shinar,64,1265100,3427091216503174,329,3479797,2329945,0,2329945
14588,Efe-Kaan Sihlaroglu,54,3562100,7855974198627402,506,6610757,3176053,0,3176053
14589,Luís Semedo,38,2319800,9674811654340629,276,3838856,2993546,2993546,0
14590,Sandeep Singh,25,2011500,5205865553124544,169,2638735,1527631,153,1527478
14591,Dheeraj Singh Moirangthem,68,3069000,6402755924785514,546,6548206,5350432,0,5350432
14592,Axel Sjöberg,48,934700,3042523835486466,214,2167818,1831643,0,1831643
14593,Herman Sjögrell,56,2247400,7633608565149306,396,4647014,4582733,4583,4578150
14594,Jordan Slew,65,3616800,6134284461842675,565,6756478,3350971,33510,3317461
14595,Oisin Smyth,44,1195400,7744892443992361,199,2300090,1205895,12059,1193836
14596,Fábio Jaló,53,4856600,6545184915548794,516,8076670,4793432,0,4793432
14597,Song Wenjie,52,4668700,5141554637351471,528,7893395,778921,779,778142
14598,Yannic Stein,22,1526200,7547590248620190,119,1726634,267477,0,267477
14599,Tobias Storm,29,2384500,3122578759843889,213,3361250,640323,0,640323
14600,Yann Sturm,66,3582800,9101543361595873,619,8020507,6765300,0,6765300
14601,Devin Sür,47,392200,4098556401989630,173,1330567,664684,0,664684
14602,Hannes Sveijer,61,1398700,4626860894808415,381,3833391,2292747,230,2292517
14603,Hubert Szulc,67,2912600,6971911462906903,563,6562404,6083962,0,6083962
14604,Georgios Theocharis,40,4498200,8315472026307112,456,7801627,5754725,0,5754725
14605,Sam Tickle,68,2095900,6223608227666143,389,4261456,3238567,32386,3206181
14606,Diego Torres,56,1380900,6878952160946233,337,3579775,1531112,0,1531112
14607,Madou Touré,30,4830900,4650515750998384,463,7109203,1666026,16661,1649365
14608,Atanas Trică-Balaci,68,4081000,5714187533734541,605,8048909,6388052,0,6388052
14609,David Udogu,28,1974300,6951044922636157,182,2639097,28166,282,27884
14610,Sascha Voelcke,66,306400,3428456928587125,250,2068233,565085,56509,508576
14611,Hugo Vogel,24,4430400,3039395030618947,346,6217878,2321883,233,2321650
14612,James Waite,30,2800400,7439988915027409,318,4184255,218902,2190,216712
14613,Jakub Wajman,70,2741300,6185173464479418,507,6168349,5860114,0,5860114
14614,Gabriel Wallentin,25,353200,7910430818388011,46,342260,200993,200993,0
14615,Joe Walsh,64,2066000,4645662665155792,410,5005812,467636,467636,0
14616,Steven Warnock,66,1948700,3532971313184536,426,4645313,3169395,3169395,0
14617,Evan Weir,45,2084200,6323374873951365,283,3695269,1348645,13487,1335158
14618,Jack Wells-Morrison,31,2532500,8019680886539639,274,4098290,2557755,25578,2532177
14619,Charlie Weston,27,1482100,8451083270789359,132,1983083,1312983,131299,1181684
14620,Joe Whitworth,43,449000,4574334711772098,143,1095641,246205,0,246205
14621,Will Wilson,36,4676500,3067277734160520,491,7182294,781052,0,781052
14622,John Ross Wilson,42,2052200,4816343775542286,298,3819267,2210170,2211,2207959
14623,Oskar Wójcik,54,2432100,7354964272156675,422,5276879,3167992,317,3167675
14624,Ben Worman,55,4043300,5740760678086131,548,7824253,7020482,70205,6950277
14625,Matthew Wright,50,619200,7025372124392385,219,1820434,1500831,150084,1350747
14626,Xu Dong,49,2875700,5151440205168548,363,5073047,452457,0,452457
14627,Xu Yue,49,3073400,5089683903414843,428,5873427,2602715,260272,2342443
14628,Yan Zihao,55,4687800,3870278780829407,542,7638188,1863004,186301,1676703
14629,Yang Yihu,59,2006900,7703292919059895,358,4280563,4196090,4197,4191893
14630,Yang Fan,34,3892100,7107902452972163,336,5586765,3632017,0,3632017
14631,Yao Xuchen,38,1468700,7878952428765258,213,2615838,623229,0,623229
14632,Yeom Ki Hun,69,3509100,8606785837239291,494,6518475,3330220,0,3330220
14633,Louis Zabala,58,1320200,4247430444281265,319,3168778,1074778,10748,1064030
14634,Saud Zaidan,69,660500,6916365107598235,349,3211442,1958781,0,1958781
14635,Luis Zeballos,61,4659000,8489018267471081,707,9159200,6542232,6542232,0
14636,Zhang Wei,38,1156200,5739018319110306,217,2215883,1581504,159,1581345
14637,Zhou Junchen,65,398400,8881238718425591,232,1994373,1017768,102,1017666
14638,Tobi Adebayo-Rowling,65,4622900,8650247194697718,583,8594010,3583637,0,3583637
14639,Leslie Adekoya,67,4354600,9659738413321568,604,8573025,701072,0,701072
14640,Hamad Al Abdan,64,1942200,3348403661586198,372,4245432,474301,4744,469557
14641,Hassan Al Ali,68,1168400,4153296400068965,423,4135146,2719208,0,2719208
14642,Basim Al Baqi,67,3400600,8181205475254150,535,6965923,3538457,3538457,0
14643,Bassam Al Hurayji,43,379800,3251563388255128,145,1163048,200117,0,200117
14644,Ziyad Al Johani,57,1910700,9222987225129869,310,3861412,768359,7684,760675
14645,Abdullah Al Shanqeeti,54,1516300,5972388350153166,317,3610894,21123,212,20911
14646,Abdulrahman Al Yami,41,1711000,5536825368606353,233,3092723,2223500,223,2223277
14647,Ethan Alagich,53,1545100,6618059943927734,307,3219845,1212456,121246,1091210
14648,Abdihakin Ali,49,3014000,7946040162661960,390,5310795,4074914,408,4074506
14649,Rahim Ali,48,3369900,9627629251433407,385,5786099,4915102,4915102,0
14650,Samuel Amo-Ameyaw,36,1878300,9979194066678141,233,3347546,1173564,1174,1172390
14651,Jacob Florentin Andersen,62,3474300,6667687635925046,455,6375882,321053,32106,288947
14652,Karoy Anderson,31,3415500,6966923066369743,329,5562476,3235652,323566,2912086
14653,Aske Andresen,38,3322400,3317411892295438,353,5656468,1570145,158,1569987
14654,Jaber Asiri,48,3219600,3423671200419554,434,5724539,2616474,2617,2613857
14655,Edison Azcona,61,2949500,6187052109269765,491,6088440,3646080,365,3645715
14656,Cammy Ballantyne,60,3435300,5257156248347137,546,7003795,2000670,2000670,0
14657,Kailin Barlow,23,3004200,8587393706362494,291,4689929,4352829,435283,3917546
14658,Dawid Barnowski,36,3693300,6203697743289787,339,5227406,860567,860567,0
14659,Aaron Basenach,68,2395900,4019845483504127,457,5509686,3830156,383016,3447140
14660,Ciaran Behan,44,873300,5928275991227843,242,2234063,1844966,185,1844781
14661,Alfie Bendle,69,1130800,5106988669911989,388,3688041,1474932,1474932,0
14662,Marvin Benjamins,25,3589600,4137814918733953,332,5228556,1896986,18970,1878016
14663,Kian Best,67,3988200,6327029597349110,612,8130673,6000566,0,6000566
14664,Victor Bezerra,53,803400,4197265425158563,244,2297799,338777,338777,0
14665,Jake Bickerstaff,25,1698800,8976148253701484,128,2141073,1956439,195644,1760795
14666,Isaac Boehmer,42,2365300,6178252537908055,291,4009392,3980646,399,3980247
14667,Luca Böggemann,61,2498900,4864668727857910,399,5213632,5102787,5102787,0
14668,Asbjørn Bøndergaard,33,2565900,3613856238181414,261,4078134,711289,712,710577
14669,Valentin Borcea,37,3348500,6167744521697993,344,4988745,878557,879,877678
14670,Caolán Boyd-Munce,64,3107600,5223546929690428,498,6323945,1361326,136133,1225193
14671,Richard Brush,37,3471200,8011832886703118,370,5208996,2044279,20443,2023836
14672,Stijn Bultman,40,2609300,8386145610087084,314,4378178,949724,949724,0
14673,Jonah Busse,39,3647700,7171935849614628,383,5505831,1263540,1264,1262276
14674,Santiago Castaneda,37,2692400,5235479588502470,297,4020259,2245592,0,2245592
14675,Jacob Chapman,28,1840900,8067553523967765,203,2963959,2691412,26915,2664497
14676,Carmine Chiappetta,31,2549900,5630241353991967,231,3623087,3087929,3088,3084841
14677,Richard Chin,25,4222100,7516761759717024,409,5991417,1020665,10207,1010458
14678,Farukh Choudhary,64,1501500,9268885984312265,394,4115703,2740930,27410,2713520
14679,Kai Corbett,54,4442400,5183616062250271,566,8030386,7139032,7139032,0
14680,Martim Marques,54,4962200,3171247594494818,544,8658736,5312234,5312234,0
14681,Ethan Cox,51,358400,9419813057086451,207,1553336,944196,0,944196
14682,Mark Coyle,25,596500,7199738311408976,87,831748,25751,25751,0
14683,Darragh Crowley,57,2350200,5030497008155405,438,5033443,4996148,4997,4991151
14684,Mauricio Cuevas,37,2867200,7410389687963668,273,4034318,1537765,154,1537611
14685,Cui Qi,35,2616800,8639696810961525,301,4203587,560878,56088,504790
14686,Cui Wei,49,2914900,3152071357883861,393,5146499,2436915,2436915,0
14687,Kevin Čustović,70,3789400,8472924450227336,600,7321650,6011784,602,6011182
14688,Marcus Dackers,38,2078300,5206285686243675,236,3192647,84338,0,84338
14689,Vignesh Dakshinamurthy,36,3377900,5307435448069974,389,5887882,926108,926108,0
14690,Gabriel David,54,947400,3321195870365430,250,2253122,1602940,1603,1601337
14691,Dawyn-Paul Donner,61,1268300,7183062134349428,320,3145816,3043900,305,3043595
14692,Seiminlen Doungel,28,4524500,9206001352750394,388,7018674,984594,0,984594
14693,George Dragomir,25,3413100,8023009393728384,303,5268409,3167100,31671,3135429
14694,Aaron Drewe,33,1326200,7060692900986632,198,2363846,1977160,1977160,0
14695,Conor Drinan,22,3641500,5385099055909206,255,4681342,2087827,208783,1879044
14696,Du Yuezheng,23,1547600,3412258758488832,122,1895486,1269660,1269660,0
14697,Mateusz Dudek,56,1478600,9748273347285675,311,3618434,241243,0,241243
14698,Mischa Eberhard,42,2832500,6330582642120173,334,4779747,3085527,0,3085527
14699,Evan Eghosa,35,2491700,4779415516458007,263,3606424,422366,0,422366
14700,Max Ejdum,46,3690600,7043257628295700,416,6115431,1455743,0,1455743
14701,Nouri El Harmazi,65,1340600,3081752126952499,356,3478007,460169,461,459708
14702,Jack Ellis,42,4161600,7037800981619374,432,6615988,1470609,148,1470461
14703,Pascal Fallmann,53,1229600,7720156165921777,327,3215494,2341567,2342,2339225
14704,Jayden Fevrier,39,347900,9798146539702870,120,879342,857400,0,857400
14705,Charlie Finney,55,4458600,9037947024122369,520,7348546,1557504,1557504,0
14706,Joseph Forde,30,1934300,5566151155010431,192,2730966,391091,3911,387180
14707,Joe Foulkes,37,674500,8331501870991918,135,1261335,87107,8711,78396
14708,Narender Gahlot,58,2808800,4860320676708283,453,6177722,1379869,0,1379869
14709,Michael Gallagher,54,3949800,5762664684929231,556,7764179,7153888,71539,7082349
14710,Joaquín García,44,4463300,3932051937755511,462,7051975,573458,573458,0
14711,Ruly García,41,4230000,8723051475273843,433,6144393,3061813,3061813,0
14712,Joseph Gbode,54,2623500,8547768162900175,406,4895029,2558654,25587,2533067
14713,Neal Gibs,68,1990200,7401682672610862,426,4549727,455675,455675,0
14714,Nicolas Glaus,42,2650000,4380393777367948,320,4381590,2267198,0,2267198
14715,Jannik Graf,23,4286300,5488762454872056,300,5617553,1816011,1817,1814194
14716,Ryan Graydon,49,4074700,7676071873882718,455,6844080,1311256,1312,1309944
14717,Michał Gurgul,49,607300,4218417306523713,210,1754197,941330,9414,931916
14718,Ha Seung Un,28,1973000,5204705369390435,202,3055441,1265054,127,1264927
14719,Luke Haakenson,41,995900,6257418062608749,202,2124760,1139915,114,1139801
14720,Kamron Habibullah,35,3656300,6532354606562125,417,6443005,5045002,50451,4994551
14721,Jad Hakiki,31,1169000,9103136044274068,143,1743484,145348,0,145348
14722,Jordon Hall,36,4882200,9688122883830483,487,7319706,5357609,5357609,0
14723,Justin Hammel,53,3355000,6125633982760086,433,5994059,5517348,551735,4965613
14724,Han Feng,59,3832900,3803255827899102,533,6534177,2288547,229,2288318
14725,Han Jong Mu,58,1401500,9654300211701217,328,3384328,73621,0,73621
14726,Nick Hayes,43,3391900,6010822527473101,417,5915734,1142107,114211,1027896
14727,He Yupeng,27,3288500,5495326854468096,269,4535466,3761928,0,3761928
14728,Brad Hills,30,518800,5536658705437448,93,836252,695060,0,695060
14729,Emil Højlund,27,3079400,3593376106091070,285,4859593,274463,2745,271718
14730,Fabian Holst-Larsen,59,4845800,3752275670931450,602,8456325,5154350,515435,4638915
14731,Huang Jiahui,43,3204800,4551548833154845,360,5527582,1305535,13056,1292479
14732,Diego Huesca,47,4860800,6598268951411513,504,8189109,6107428,6107428,0
14733,Mutellip Iminqari,66,315500,5038166322112885,261,2107040,96503,966,95537
14734,Liam Isherwood,50,2190700,3200476238104825,342,4192622,1636236,164,1636072
14735,Matty Jacob,22,660400,7638013205422713,60,749159,133283,133283,0
14736,Aniket Jadhav,30,3310700,3133880911676814,313,4768223,4307822,0,4307822
14737,Imam Jagne,53,1544800,5449092226821536,327,3487051,1463570,0,1463570
14738,Tobias Haahr Jakobsen,46,1459300,5992687056666093,293,3442252,2932473,2932473,0
14739,Wille Jakobsson,48,1302100,3476046823586766,267,2960352,1659436,1659436,0
14740,Douglas James-Taylor,51,1405500,3959777494926372,302,3047569,333739,0,333739
14741,Sven Jansen,49,933100,6522794159443865,223,2083103,61177,612,60565
14742,Timo Jansink,66,4145600,9073070029539706,577,7980650,7485161,7485161,0
14743,Leo Jansson,50,3414800,3994924385633593,490,6288781,5702733,0,5702733
14744,Jaaso Jantunen,24,4262900,4885619392436209,340,5548678,3313205,0,3313205
14745,Jeon Byung Kwan,60,344100,8193272309022774,236,1964329,854088,0,854088
14746,Jiang Ning,30,4271200,7596320824710701,359,6163112,4520436,45205,4475231
14747,Oliver Jones,37,3953300,7838187737466455,429,6466655,4255172,425518,3829654
14748,Jung Ji Hoon,58,3556200,9633858365650507,489,6052872,4015202,4015202,0
14749,Issa Kaloga,64,407000,3342079465221499,279,2186589,1851476,186,1851290
14750,Kang Yoon Gu,55,598100,3339501945961371,240,2170054,2155633,216,2155417
14751,Naif Kariri,55,332300,7166160337261228,187,1515288,97042,0,97042
14752,Dara Keane,54,1936300,9948224185895809,381,4503837,2445852,0,2445852
14753,Kipp Keller,70,2594100,8930068085850621,528,6635504,5237970,0,5237970
14754,Puitea,56,4265500,9997347446066245,588,7778562,2085027,0,2085027
14755,Kim Dae Woo,58,3876400,4035850397952654,534,7368595,623990,0,623990
14756,Kim Yeon Soo,29,3358400,8735835226367950,341,5226183,2966673,0,2966673
14757,Kim Gyu Hyeong,70,4701400,7955248085267385,654,8656035,3164365,0,3164365
14758,Kim Dae Hwan,55,1254600,7347918286093835,306,3289168,1626831,162684,1464147
14759,Jakob Kindberg,53,546400,4548212144185371,190,1700936,757115,0,757115
14760,Danu Kinsella-Bishop,35,1330200,8848387197054775,177,2190417,127872,12788,115084
14761,Marian Kirsch,49,4033100,7298124772793609,437,6532543,4250021,425003,3825018
14762,Bernt Klaverboer,39,4328200,3055186511163604,446,6560322,1055839,105584,950255
14763,Tim Kloss,31,346200,6957343216147072,78,536503,371328,37133,334195
14764,Matthias Köbbing,42,2233800,3476082880785615,293,3899721,1319166,132,1319034
14765,Jakub Konstantyn,45,844300,6291008056450505,221,2266474,487540,0,487540
14766,Adam Kramarz,57,2843000,5132413251096013,449,5175742,1576831,1577,1575254
14767,Mikkel Kristensen,62,1902700,3065372036906479,375,4086330,2372074,23721,2348353
14768,Jeroen Krupa,45,1522700,6909701109613211,252,3134210,2543028,25431,2517597
14769,Johan Kury,70,3073300,8279514157304361,605,6938821,863366,864,862502
14770,Sasha Kuzevski,59,3060900,9772802586968016,454,5891899,2385831,0,2385831
14771,Ricky Lallawmawma,47,1927700,9883251986104259,299,3562771,1213014,122,1212892
14772,Peder Hoel Lervik,57,3654600,8313633753415686,508,6465903,4328004,43281,4284723
14773,Li Xiangbin,69,1935600,9739558112635152,481,5577325,3869232,387,3868845
14774,Li Yongjia,52,3326300,8781189979700012,445,5936247,3260950,0,3260950
14775,Calixte Paul Ligue,66,2462200,3200296162216625,441,5290261,1603598,160360,1443238
14776,Elvis Lindkvist,49,458000,6823984535665317,167,1355537,63559,636,62923
14777,Luca Lipani,35,606200,7859455171886823,110,1076977,382843,0,382843
14778,Liu Yue,54,307500,9109735632959213,211,1488787,284697,285,284412
14779,Liu Zhenli,54,4268300,5820663023102469,502,7272522,582375,58238,524137
14780,Liu Jiashen,33,4745200,9394936404853738,448,7262044,2412207,2413,2409794
14781,Pablo Luján,64,1959800,5716443523613913,351,3919298,3268136,3268136,0
14782,Ben Lundt,64,2067100,9867379512845268,407,4413129,2541026,2542,2538484
14783,Magnus Lysholm,50,614100,4436605673384379,206,1944187,601988,60199,541789
14784,Laurin Mack,54,4475600,3772498147812206,512,7905632,196460,196460,0
14785,Théo Magnin,30,1828000,9713595960583780,191,2962466,2050992,206,2050786
14786,Abdulaziz Makin,41,1652500,9490287411255497,239,3135730,680534,0,680534
14787,Johan Manzambi,69,3735200,3631958981317268,540,6856615,1617632,0,1617632
14788,Mohammed Marran,38,518700,5151551660553779,116,1017999,141793,141793,0
14789,Dan Martin,64,3829300,3656422222342238,554,7203782,280712,28072,252640
14790,Glan Martins,30,1553700,8435415602857924,155,2039042,1857084,186,1856898
14791,Abdullah Matuq,24,3470100,6771977020056337,305,5401627,2868588,28686,2839902
14792,Evans Maurin,61,1276400,8179043586075777,297,3104612,925116,926,924190
14793,Jon McCracken,53,2197600,9648579673565287,341,4253374,2545804,255,2545549
14794,JJ McKiernan,52,4575100,9422321961433376,566,7858030,1290675,0,1290675
14795,Brian McManus,56,4159700,8171627610619843,547,7403092,1964000,196400,1767600
14796,Aaron McNally,27,4697100,9036112931871236,343,6195400,5249339,524934,4724405
14797,Mateusz Mędrala,29,2017800,6598533895976763,225,3144108,2119237,2120,2117117
14798,Richard Meier,53,1526500,5365260840820566,293,3184873,674865,6749,668116
14799,Steffen Meuer,48,2553200,3648329457462669,361,4903827,2470547,24706,2445841
14800,Leny Meyer,61,1526400,8060854457320827,337,3783569,1954887,195489,1759398
14801,Zoran Mitrov,46,1146700,4022485206968280,261,2738964,1350674,0,1350674
14802,Cody Mizell,58,4665500,3938171325042064,584,8564952,5961958,597,5961361
14803,Thoiba Singh Moirangthem,57,497200,4931659065520332,255,2237298,36430,3643,32787
14804,Roméo Monticelli,68,4569300,8232499098782214,716,8694012,1542584,15426,1527158
14805,Kian Moore,40,3191300,5826429740101631,349,5543039,4942050,0,4942050
14806,John Mountney,51,3944700,5460987013239751,487,6335451,4924520,0,4924520
14807,Muhmet Nebijan,69,3477600,3241270597280349,559,7133451,3669960,366996,3302964
14808,Joy Mukena,24,2338100,7316032112603424,199,3012442,1295066,130,1294936
14809,Pascal Müller,44,878600,6746215130013116,201,1889528,153510,154,153356
14810,Cian Murphy,53,2147400,9980900857742911,346,4377757,98514,0,98514
14811,Adam Murphy,33,4060500,5896148243232254,460,7040291,3077656,307766,2769890
14812,Kelly N'Mai,39,830700,8981389385357229,163,1631620,1512186,1513,1510673
14813,Sivasakthi Narayanan,52,1045000,3466492858277133,261,2682312,2505052,0,2505052
14814,Niklas Niehoff,26,2585400,7794587258165467,230,3833088,251047,252,250795
14815,Tom Nixon,48,1884900,9745575767988344,334,3877634,1428798,142880,1285918
14816,Alex Nolan,26,1233900,4684885887893320,108,1582561,1026732,102674,924058
14817,Darragh Noone,59,811900,8279738463632959,256,2475305,114620,1147,113473
14818,Alan Nuñez,64,2413200,3001366767152416,422,5212644,1459646,0,1459646
14819,Henry Obermeyer,40,4889100,5466361636347146,475,7259000,5017625,0,5017625
14820,Zech Obiero,68,302500,9110413975831013,317,2585564,702037,7021,695016
14821,Justin Obikwu,51,4621700,8093851165512349,556,7730311,4954521,4954521,0
14822,Alfonso Ocampo-Chavez,43,3210400,8574418267839934,364,5185508,2189836,0,2189836
14823,David Okagbue,34,3083100,9731180365364685,357,5056939,3145742,0,3145742
14824,Mayka Okuka,37,2823800,5603020760352978,283,3993874,799031,799031,0
14825,Oliver Olsen,44,4541100,4817584248685729,458,6918319,271431,272,271159
14826,Toyosi Olusanya,69,3103500,9014342484346772,584,7386196,4736248,473625,4262623
14827,Tobi Omole,61,2685700,7100016113777229,467,5529663,3798391,3798391,0
14828,Tyrese Omotoye,22,4488700,9854367504964094,335,6587665,3380756,0,3380756
14829,Adriano Onyegbule,32,4236700,7833829579484334,390,6093190,4654805,4655,4650150
14830,Arquimides Ordoñez,36,1400700,3862741185111518,186,2347066,1228971,122898,1106073
14831,Evan Osam,63,1367600,8636621878915414,391,4070434,851236,8513,842723
14832,Trent Ostler,36,4965400,6767752253601776,507,8507779,4402828,44029,4358799
14833,Mohamed Oukhattou,31,2754700,6960425004732432,266,4178843,282169,283,281886
14834,Timothy Noor Ouma,67,2035600,7216569359632588,475,5408845,894837,895,893942
14835,Sahil Panwar,49,1289900,3943732620824075,306,3197327,2529263,252927,2276336
14836,Michael Parker,68,4885300,3287021486235614,675,9437863,970543,97055,873488
14837,Gabriel Pellegrino,65,3736900,6055194684178002,527,6404280,6242973,624298,5618675
14838,Oliver Pettersson,29,4760400,4937285122789542,454,7045404,3237859,32379,3205480
14839,Piao Taoyu,44,2708300,4703078722705582,312,4316103,4267234,0,4267234
14840,James Plant,41,2146200,7487215902199694,288,3571165,2582078,259,2581819
14841,Albert Posiadała,28,1372400,9912250359627308,134,2016009,390774,391,390383
14842,Filip Przybułek,46,3073900,6863379224722247,406,5597485,3764908,37650,3727258
14843,Maximilian Pußwald,46,2374400,7725130142326175,290,3811391,172217,172217,0
14844,Sebastian Quirk,43,2474100,5010025749395578,344,4350246,3493985,349399,3144586
14845,Junior Quitirna,52,3661000,6132195181376167,521,6960406,3838031,383804,3454227
14846,Mohammed Rafique,66,4073400,3471521689976989,599,8042705,212156,0,212156
14847,Liam Ravenhill,49,2812800,4861541795492643,375,5386629,2230654,2230654,0
14848,Filip Rejczyk,67,1752000,7382717003400631,347,4178695,1253536,12536,1241000
14849,Rico Richards,34,2789500,5836271626916931,322,4671768,2004874,0,2004874
14850,Sean Robertson,69,3531600,5555483290974841,579,6929028,1398868,1398868,0
14851,Darren Robinson,59,4823700,9344585936273122,554,7740289,4708753,0,4708753
14852,David Robson,23,841600,8503789100901719,49,760776,614162,614162,0
14853,Bogdan Rotar,31,2863700,7605895253201428,292,4196026,678329,67833,610496
14854,Filip Rózga,44,1424700,7896823036333649,225,2808543,1901094,191,1900903
14855,Juan Rubiano,31,2441500,9726814020444756,283,4163729,3765503,0,3765503
14856,Tadhg Ryan,32,1197000,4451262559394310,177,2084149,1372681,0,1372681
14857,Aakash Sangwan,32,1533200,7359707455401933,153,2063174,1444348,0,1444348
14858,Roman Schabbing,42,2521400,8723433084075275,331,4478231,375420,375420,0
14859,Lasse Schulz,37,3790400,9568731876922338,448,6831398,6330667,633067,5697600
14860,Joshua Seberry,36,1681900,6029865498076299,213,2538008,2476108,24762,2451346
14861,Maximilian Sellinger,40,2619600,9326583753647010,297,4167099,3018507,0,3018507
14862,Shang Yin,41,1347700,7424719252877047,228,2716451,1016813,1017,1015796
14863,George Shelvey,59,992400,7758096960324161,297,2699741,2315970,23160,2292810
14864,Ross Sinclair,35,2423200,9827353775876401,261,3844764,3705866,0,3705866
14865,Vikram Singh,66,2612800,7062631261586256,435,5449764,3869864,3870,3865994
14866,Gurmeet Singh,70,4312300,6420099854275445,658,8027590,7820740,0,7820740
14867,Arshdeep Singh,65,4923100,9462889551964012,734,10288542,8962586,8963,8953623
14868,Boris Singh,67,2587100,4816643482857409,409,4825089,460598,0,460598
14869,Ronald Sithole,37,4734900,9864369581445709,423,7479611,6874528,68746,6805782
14870,Jack Skahan,41,2123600,6708803312153976,277,3898614,421816,4219,417597
14871,Jackson Smith,59,4268000,4418312062004274,513,7585266,1720556,1721,1718835
14872,Vegard Solheim,23,4197300,4026025230809582,338,5484756,3358511,336,3358175
14873,Oscar Solnørdal,33,4156100,9438644088634007,378,6082759,254106,0,254106
14874,Jakub Stec,55,3280000,8791065907644342,531,6456296,5808884,58089,5750795
14875,Elliot Stroud,50,1360900,3318191354650009,285,3131607,1440669,1441,1439228
14876,Sun Qinhan,67,2776800,6041351398457171,473,5317984,677750,6778,670972
14877,Sun Zheng'ao,27,3225000,9787063546962821,290,4596023,1512341,151235,1361106
14878,Matthew Sutton,68,512700,6220854771776180,259,2302021,1285214,0,1285214
14879,Nim Dorjee Tamang,37,2788900,8271441079690761,271,4232092,1440428,0,1440428
14880,Aljaž Tavčar,48,1738200,8146031095894230,280,3102494,71456,71456,0
14881,Emre Tezgel,37,4575600,5935477963891511,419,7215556,471510,4716,466794
14882,Dagur Dan Þór­halls­son,39,4155400,4956850879354823,433,6653987,3600469,3600469,0
14883,Junior Tiensia,37,699800,6066454304317170,154,1376679,878083,0,878083
14884,Mert Yusuf Torlak,67,4903800,5178544852998728,667,8796078,5133080,514,5132566
14885,Niko Tsakiris,60,3741400,5993582789445000,478,6598159,5157911,0,5157911
14886,Cian Tyler,27,4420900,8466095193590095,380,6111228,5968008,0,5968008
14887,Marius Ulla,50,3148900,5291000014253372,381,5631055,4223429,423,4223006
14888,Kayne van Oevelen,57,2894300,9175126184941989,460,6162266,335517,33552,301965
14889,Ethon Varian,52,1695900,9757666736171101,335,3818903,2279150,2280,2276870
14890,Luis Vásquez,43,1337900,3830768821588668,241,2633285,125960,125960,0
14891,Eduardo Villanueva,35,4269900,3485696882015018,477,7625240,5183438,518344,4665094
14892,Lewis Walker,43,727000,4187616644796903,171,1542889,1394859,139486,1255373
14893,Wang Yaopeng,47,2033800,5192309119734837,317,3872296,2477483,2477483,0
14894,Wang Yang,39,4764600,5866810556467099,536,8331920,315512,316,315196
14895,Wang Yu,38,1173600,9400460052961200,194,2104220,1942625,1942625,0
14896,Suresh Wangjam,25,1326800,3188498539651677,149,1912714,6643,0,6643
14897,Wei Minzhe,57,2359600,5848857585789729,367,4638004,400662,0,400662
14898,Szymon Weirauch,24,881800,4186817711223299,100,1112165,61057,61057,0
14899,Reece Welch,70,3274900,8916010540091510,534,6436517,3125384,313,3125071
14900,Harry Williams,44,715900,3664134277385039,193,1760101,1566175,1567,1564608
14901,Charlie Winfield,25,1989200,4957225671714293,187,2743404,1125410,0,1125410
14902,Tyler Wolff,50,1356400,5378462510203614,238,2498846,2022065,20221,2001844
14903,Max Woltman,35,3830700,5920354453199082,333,5872782,394029,395,393634
14904,Harry Wood,56,349100,4337540824326033,237,1744423,104410,10441,93969
14905,Marco Wörner,22,2316200,7859314341880474,152,2786796,2121771,0,2121771
14906,Marcel Wszołek,69,1549400,5967120814538377,409,4489037,2948387,0,2948387
14907,Wu Guichao,44,1444700,4636577754974955,228,2800089,227199,0,227199
14908,Xu Yang,63,3311500,4086765354035034,554,6977766,1305625,1306,1304319
14909,Yang Chaosheng,36,853000,6206816425041595,176,1687683,717606,718,716888
14910,Yang Dong Hyen,69,4041500,6561534925560910,569,7167855,6583007,659,6582348
14911,Yang Yilin,29,821300,4778093190275570,90,1150482,921382,0,921382
14912,Jonny Yull,25,3871100,7839366004618939,333,5462016,2212797,222,2212575
14913,Zhao Yingjie,55,1168700,5418701879594656,335,3104317,2282684,228269,2054415
14914,Adam Zimarino,68,1165900,4556735458426196,369,3756203,1611906,161191,1450715
14915,Tizian Zimmermann,50,939100,9164986738228433,283,2638807,1700488,170049,1530439
14916,Malwin Zok,22,3199300,4096768228633888,280,4714566,558947,5590,553357
14917,Tobi Adeyemo,48,3236900,3241204154161045,387,5380150,4128985,412899,3716086
14918,Martin Agnarsson,25,3685300,5088617909419214,267,5026801,2187954,0,2187954
14919,Johan Persson Åhstedt,26,3081900,3033761247947814,305,4463956,1177442,117745,1059697
14920,Khalil Al Absi,68,3550600,8040512732296937,568,6921939,6096592,0,6096592
14921,Moataz Al Baqawi,45,2288900,8732339216851509,308,4097682,2273580,0,2273580
14922,Abdulrahman Al Enazi,31,3356000,4638780816330711,351,5449791,2587349,0,2587349
14923,Firas Al Ghamdi,61,2594400,4678636901341526,460,5356551,1903336,1903336,0
14924,Abdulrahman Al Hajeri,30,3008600,8451504652490470,286,4493996,602603,603,602000
14925,Omar Al Jadaani,47,803500,4416477862895475,230,2092584,704399,705,703694
14926,Mohammed Al Mahasna,67,3117100,5144431851293810,542,6380549,1101077,11011,1090066
14927,Hassan Al Mohammed,65,3690800,4814522698542915,568,6860330,4739802,0,4739802
14928,Salem Al Najdi,37,876700,6777790039935473,161,1799184,349279,3493,345786
14929,Abdulrahman Al Sanbi,68,3099500,3962141048709505,508,6171141,5431507,0,5431507
14930,Mohammed Al Yami,44,2456400,7363409948597323,339,4440532,855114,8552,846562
14931,Jordan Amissah,34,848500,9576515710057855,107,1306194,424120,424120,0
14932,Victor Andersson,61,2817600,6407822988013282,470,6158868,1213804,1213804,0
14933,Devin Angleberger,22,2574700,8515138700886626,212,3646608,290913,2910,288003
14934,Alexander Aoraha,51,3236400,7485034681845571,427,5655199,4027466,403,4027063
14935,Nathan Asiimwe,51,3376500,5768622873021545,419,6025047,11329,114,11215
14936,Ali Auglah,65,3439300,6979134492397243,501,7001588,1905584,1905584,0
14937,Taha Ayari,50,4510200,3016390116391851,539,8197975,4446760,4447,4442313
14938,Alex Badolato,40,1636400,8294084621222192,237,2971775,1667569,1668,1665901
14939,Nicola Bagnolini,43,1509500,9228709661101280,221,2594374,956652,957,955695
14940,Reed Baker-Whiting,23,2826400,9071122493583530,185,3514754,1032032,104,1031928
14941,Kofi Balmer,44,4415000,8527409371481449,517,7750623,364204,365,363839
14942,Cian Bargary,43,3999000,8729125589211282,427,6221450,3966490,396649,3569841
14943,Vincy Barretto,63,1188400,8556196879746710,329,3235622,3141652,0,3141652
14944,Kaare Barslund,53,3736800,6019835387364564,486,6424776,1095609,1096,1094513
14945,Furkan Bekleviç,68,3400900,7172421168809861,585,7097229,547486,548,546938
14946,Brayan Benitez,38,1340000,3346722291305836,236,2801475,633107,0,633107
14947,Bryant Bilongo,35,4868100,5005024525732688,520,8429196,2904615,2905,2901710
14948,Scott Bitsindou,50,315400,6318869275140723,171,1394184,1205216,1206,1204010
14949,Noah Blasucci,43,3984400,5679166286380276,481,6708149,1126127,1127,1125000
14950,Luca Bolay,24,4156500,5812937117102659,319,5467068,298967,298967,0
14951,Alex Bonetig,57,2013600,3384126388450386,351,4417492,1528298,153,1528145
14952,Gary Boylan,62,3334400,3033234354982242,535,6887238,4843298,48433,4794865
14953,Rhys Bozinovski,33,2774900,9416842362541507,297,4384083,2603508,0,2603508
14954,Seán Brennan,37,1210500,7697001893393211,151,1894643,794830,79483,715347
14955,Mark Byrne,59,3355100,8694053924837024,478,5942239,1889689,1890,1887799
14956,Rhys Byrne,66,3160600,7593499137516749,529,7022068,21112,0,21112
14957,Ciprian Călugăr,51,1308100,6243396129085535,317,3084839,1416856,0,1416856
14958,Iulian Codrin Cărăușu,47,4366400,5534417797680617,541,7759468,6021033,6021033,0
14959,Theo Chapman,65,4319200,9323793302944124,536,7332128,4263818,4263818,0
14960,Pierce Charles,53,2655200,7922087807381997,396,5333437,5082829,508283,4574546
14961,Théo Chatelain,68,2232500,5312344972469734,404,4810894,3000543,3001,2997542
14962,Pratik Chaudhari,54,1984700,7923215367001973,346,3898911,2467779,2467779,0
14963,Cheng Changcheng,37,1371200,4124649412047025,212,2520173,835722,83573,752149
14964,Cho Jae Hun,44,3182600,9449200776968629,404,5919387,1321970,0,1321970
14965,Ionuț Cojocaru,44,452400,4976888170735403,177,1527441,1345182,134519,1210663
14966,George Cooper,51,496200,4073872254768301,212,1848644,1218251,0,1218251
14967,Jimmy Corcoran,67,3429400,3513676645950262,518,6836122,926015,0,926015
14968,Dominic Corness,57,2841400,7077555362665627,484,6001777,770831,770831,0
14969,Edoardo Corvi,57,1789900,8599168780518037,350,4086955,395857,39586,356271
14970,Brandan Craig,59,2321800,5884615450181619,458,5524570,5466307,547,5465760
14971,Rasmus Cronvall,24,495100,9793217316793853,75,683336,628057,0,628057
14972,Cui Ming'an,68,4623300,5395871552351862,623,8786858,5642128,565,5641563
14973,Noah De Queiroz,24,4615400,4515989934875050,427,7630371,3155898,31559,3124339
14974,Luke Dennison,63,4617900,4481853264114784,628,8497269,332893,333,332560
14975,Marcus Dewhurst,35,2944300,6779727697277516,304,4755928,3325319,0,3325319
14976,Andreas Dithmer,67,4438100,8102857872998819,628,8840661,8016350,80164,7936186
14977,Chris Donnell,42,3892800,6156921029372775,474,6568714,6177621,0,6177621
14978,Djovkar Doudaev,33,4457400,7811687865632767,422,7018878,6727073,6727073,0
14979,Erik Dueñas,49,1753800,8633403351768506,301,3752673,1848378,1848378,0
14980,Courtney Duffus,37,3595500,6431908182165876,415,6155747,4743040,474304,4268736
14981,Luke Duzel,63,4276700,3704937623089456,612,7920378,3219346,3220,3216126
14982,Jamie Egan,64,406800,7593546401791341,242,2048374,1543520,154352,1389168
14983,Ramiro Eguez,25,3921300,5059270524447183,326,5260195,1719796,17198,1702598
14984,Tope Fadahunsi,22,4466200,6818639003515910,368,6224072,517749,5178,512571
14985,Danish Farooq,55,4652000,7125955751432898,581,8078997,7442164,74422,7367742
14986,Alexander Fesshaie,38,1337200,5051373388971406,206,2425986,1576420,1577,1574843
14987,James Gale,59,2913500,6921436029131917,426,5145012,2058106,20582,2037524
14988,Christian Gammelgaard,30,940900,6406217389343542,99,1285014,143611,0,143611
14989,Samuel Garzón,23,1848400,4570671234587305,158,2366605,2035695,0,2035695
14990,Shahzat Ghojaehmet,54,2544700,3871866986416778,384,5053627,3396562,0,3396562
14991,Ian Godoy,37,379400,9482370198013950,134,1074444,285101,285101,0
14992,Leonard Grob,31,2011900,6477231541650730,208,3009317,1492857,14929,1477928
14993,Andreas Gülstorff,54,1891900,4156756148577880,307,3942249,2758819,2759,2756060
14994,Jonas Häkkinen,27,499200,4911247527007246,67,615179,50382,504,49878
14995,Rayan Hamed,34,795500,6965530426432314,127,1300297,496514,497,496017
14996,Max Harris,68,4638400,6530622634161257,642,8278918,3839988,384,3839604
14997,Calvin Harris,54,2688600,4293545741726443,431,5570983,974761,0,974761
14998,Abdulbasit Hawsawi,28,3429500,8865500651402157,346,5808237,4710001,4711,4705290
14999,He Zhenyu,55,1322000,7658070637087475,274,3181033,2358910,23590,2335320
15000,Fritiof Hellichius,62,1479500,6025889368944044,371,3627269,760341,0,760341
15001,Aaron Henry,27,2961600,5183601184567268,273,4127833,2994733,0,2994733
15002,Selmin Hodza,28,635300,9792972253630498,109,1038717,911310,9114,902196
15003,Jannik Hofmann,33,2346300,4580743372059860,245,3897142,639237,0,639237
15004,Louie Holzman,69,2267600,6659173837530987,461,5377089,3098873,0,3098873
15005,Brad House,36,2898900,6567788938252791,337,4762152,3806451,3806451,0
15006,Hubert Idasiak,38,2260500,6090984802935962,279,3877471,2295952,2296,2293656
15007,De Pievre Ilunga,45,4354800,6397731319531997,452,6588237,460342,0,460342
15008,Luca Jaquez,66,2639200,9274296325027965,462,5631850,4048397,4048397,0
15009,Mansour Jawhar,54,1488400,9342235671704336,322,3404504,3373114,0,3373114
15010,Romario Jesuraj,46,4952800,3190505195964666,534,8337350,6962440,0,6962440
15011,Cody Johnson,36,4443800,8914302796949873,496,7144801,5146870,0,5146870
15012,Kaedyn Kamara,30,2433000,5540201463350701,234,3763359,1251473,126,1251347
15013,Daniel Kanu,23,1722600,7095772214572715,153,2361532,1575182,1575182,0
15014,Hisham Kasimu,28,2157800,3323789525070703,228,3064363,2910574,0,2910574
15015,Gene Kennedy,23,2316800,8191278432996948,195,3293446,3034991,0,3034991
15016,Brandon Khela,59,3087400,6268037818255751,446,6102368,5683412,56835,5626577
15017,Kim Min Seok,67,2161300,4384074376959245,403,5049368,4573891,4574,4569317
15018,Kim Ji Hoon,38,1791500,5611620300502901,253,3268792,470823,47083,423740
15019,Filip Kocaba,43,2237300,8944852463781249,329,4377493,1009922,1009922,0
15020,Krzysztof Kolanko,43,4622800,8500586446281949,485,7956192,2503739,250374,2253365
15021,Jan Krzywański,41,2915200,5408501640294562,335,4606338,854143,855,853288
15022,Rohit Kumar,54,1191100,9324620242520364,280,2791768,707709,707709,0
15023,Bertram Kvist,33,3427500,8814600769468220,333,5021461,3485517,3485517,0
15024,Kwak Seung Min,70,1673100,3409101273087847,449,4706010,2137276,214,2137062
15025,Lalchungnunga,50,2649500,9551609569763750,327,4063441,2816980,2817,2814163
15026,Jake Leake,61,1189200,3045092835387091,303,3104296,771933,77194,694739
15027,Kameron Ledwidge,63,1663600,6246245350470742,426,4415210,2565263,0,2565263
15028,Lee Geon Hee,61,4230100,4564870300237473,600,8355042,1417948,141795,1276153
15029,Lee Jong Hyun,42,4781700,6477516681763476,523,8106494,2833346,284,2833062
15030,Liu Zhurun,42,4304700,7880608701691815,517,7083251,2866383,2867,2863516
15031,Liu Xinyu,61,4831800,7481350549183255,596,8400302,2423597,0,2423597
15032,Klaidi Lolos,33,1381300,8800839113715372,163,2089677,1772947,1773,1771174
15033,Nathan Lowe,34,2399900,6729947364684034,268,3828876,1540580,1541,1539039
15034,Jakub Lutostański,52,1323800,7853413660624216,285,3050832,2869179,2870,2866309
15035,Ayom Majok,47,2437900,7065272817974446,292,3797499,1599035,1599035,0
15036,Debjit Majumder,36,1118100,9180531031501614,157,1700618,997999,99800,898199
15037,Jovon Makama,50,1634000,9916790322207512,302,3681188,2474252,24743,2449509
15038,Aiden Marsh,63,897300,6836188719799779,318,3141114,2844242,28443,2815799
15039,Valpuia,34,2618500,7539244926793694,276,3945665,2380696,0,2380696
15040,Stephen McMullan,50,2758900,3743863950910253,353,4828018,594105,59411,534694
15041,Henrik Molvær Melland,66,4752800,9456139782845945,586,8326536,1589119,15892,1573227
15042,Jean Baptiste Mendy,62,4108000,6942638488669305,560,7096760,3427995,34280,3393715
15043,Mirshad Michu,63,2251900,4632987811511125,457,4949449,1294586,129459,1165127
15044,Jevon Mills,22,569100,3910483663075018,49,568141,490697,0,490697
15045,Min Dong Hwan,58,3366900,5148889279460639,491,6550773,585659,585659,0
15046,Bryce Miranda,35,3488500,8370643821139407,324,5316705,1650519,165052,1485467
15047,Hazem Mohammed,61,977300,7952819139651457,348,3315160,3289666,329,3289337
15048,Hira Mondal,46,1001200,9969711503221109,245,2491264,294384,0,294384
15049,Gustav Mortensen,48,3331200,6093601370572900,447,6076985,1343783,135,1343648
15050,Szczepan Mucha,33,1416100,7959152114136116,184,2228343,1312632,132,1312500
15051,Irsan Muric,68,507100,3919187248269457,318,2609245,34618,0,34618
15052,Drew Murray,44,4506200,3657265282569449,516,7429706,6380987,0,6380987
15053,Kiyan Nassiri,36,2019700,5522691016440872,246,3264991,236689,0,236689
15054,Harvey Neville,40,4348100,6585037691630213,473,7647141,5662431,0,5662431
15055,Kieran Ngwenya,27,1216300,6665851803684788,97,1409037,912986,0,912986
15056,Niu Ziyi,43,952300,9758664117884832,215,2172515,428900,0,428900
15057,Kristoffer S. Ødven,31,4656100,6266662364121431,449,7046156,5543794,55438,5488356
15058,Tani Oluwaseyi,47,1814600,5677046979569785,284,3475358,1468466,1469,1466997
15059,Mohamed Ouédraogo,66,1321300,8078016322684410,335,3599290,3545931,0,3545931
15060,Michał Ozga,64,3407000,5755279540164730,521,6688607,2838922,0,2838922
15061,Isaiah Parente,61,2136800,9687501869597080,418,4830770,4391409,439141,3952268
15062,Park Chang Woo,53,841500,3642302310703977,269,2393629,268445,268445,0
15063,Adam Pavlesic,29,4192200,5336318239981287,399,6954697,6227878,623,6227255
15064,Rafferty Pedder,38,1957000,3476391522703952,261,3418528,1348976,0,1348976
15065,Charlie Pegrum,63,4636900,9063186071834752,580,7917895,2699591,2700,2696891
15066,André Picornell,52,1988600,7608668470183165,305,4019901,3869523,38696,3830827
15067,Ethan Pye,53,1784400,7688113907327827,363,4228758,326656,32666,293990
15068,Andreas Pyndt,44,3202700,8513037656310212,364,5688046,2092223,0,2092223
15069,Mihnea Rădulescu,36,2867900,5592884674458179,324,5111788,901563,0,901563
15070,Elmin Rastoder,54,3616500,4446896299893867,494,6141025,894376,0,894376
15071,Princeton Rebello,27,1494700,7051198491258635,181,2521476,2446437,0,2446437
15072,Kaylen Reitmaier,46,2915500,8107313771553466,351,4895355,3619524,0,3619524
15073,Will Richmond,56,4196800,8055592571290696,566,7664875,5527046,55271,5471775
15074,José Río,30,2666000,5200158479389515,248,3815683,543768,54377,489391
15075,Myles Roberts,65,3607000,3207579005647372,574,7642011,2078265,208,2078057
15076,Kyle Robinson,32,1045600,9129067996243858,170,1859875,418950,419,418531
15077,Alexis Rodas,61,4130400,7890146332928942,539,7661460,6627028,6627028,0
15078,Alan Rodriguez,28,558500,5959956266286904,64,621162,235056,23506,211550
15079,Alberson Rodríguez,24,1560000,6318936265480900,147,2018607,368964,368964,0
15080,Juan Manuel Romero,40,3733900,7979200813101278,442,6489211,4933186,494,4932692
15081,Imari Samuels,31,4260400,9547225202425831,412,6747929,3233328,324,3233004
15082,Lauge Sandgrav,47,3633800,3307841447857359,429,6493702,5934668,0,5934668
15083,Alejandro Santander,42,435100,7770921445948085,143,1091619,277666,0,277666
15084,Mathias Dahl Sauer,65,812100,6805215843510785,362,3328856,3292098,330,3291768
15085,Marvin Seybold,57,4991400,3937052538117499,688,8824152,8442198,8443,8433755
15086,Laurie Shala,32,3031500,7601149425175618,328,4590710,2636905,2637,2634268
15087,Lewis Shipley,57,1279500,7070153520749839,344,3490529,3312220,331222,2980998
15088,Lewis Simper,70,3341600,7957890474757286,599,7334103,4130254,4131,4126123
15089,Germanpreet Singh,41,2951500,7285034522009912,336,4738548,1750770,0,1750770
15090,Jitendra Singh,52,3469400,4996480315652735,446,5937032,762269,7623,754646
15091,Jesper Skau,45,2801400,7777337458589924,338,4597963,3093564,3093564,0
15092,Collin Smith,33,3914400,5493277531892589,391,5652913,2805556,281,2805275
15093,Jakub Snopczyński,28,4982700,8424241645371195,403,6746633,3902580,391,3902189
15094,Ramzi Solan,43,3772200,5247966092865283,459,6765632,5909511,59096,5850415
15095,Jason Sraha,22,3112800,7188756843632033,212,3846877,2313021,2314,2310707
15096,Sanjeev Stalin,62,1117300,9018486510088323,314,3248298,2058483,20585,2037898
15097,Alexandru Stan,24,943900,7898712230277476,77,1092305,481571,4816,476755
15098,Mihailo Stevanovic,66,2687300,9012475442105129,432,5614748,2206387,0,2206387
15099,Jonah Sticker,52,3128000,8813584539152876,442,5956387,3149445,0,3149445
15100,Hunter Sulte,32,3691500,7332379249118074,355,5838676,4903703,4903703,0
15101,Leon Suzuki,50,1561600,3813578313629142,255,2925981,2570356,0,2570356
15102,Fynn Talley,66,4806000,9084497814792684,621,8782110,3390283,0,3390283
15103,Kian Taylor,59,3616100,8223334812138051,526,6390063,3310820,3310820,0
15104,Jano ter Horst,30,357100,6009868829629020,99,763057,203649,203649,0
15105,Gideon Tetteh,70,4725700,6723367421708626,723,9705885,81537,0,81537
15106,Dylan Teves,24,1961300,8670750807290900,162,2714212,1662648,1663,1660985
15107,Lewis Thomas,22,1354700,4683203829488371,109,1692814,1206292,1207,1205085
15108,Max Thompson,46,3577900,7906218759315772,442,6123045,4955019,4955019,0
15109,Oliver Tipton,56,1846400,9541519639333706,349,3922042,1213724,0,1213724
15110,Krzysztof Toporkiewicz,23,2012800,4265309777166606,157,2667916,607936,607936,0
15111,Filip Trpcevski,22,4168500,7643221590130516,325,6071100,2323436,0,2323436
15112,Stefano Ube,56,946000,8590905760869464,255,2477673,1014170,1015,1013155
15113,Cem Üstündag,23,3326600,7831014773818777,302,5257429,3535508,3536,3531972
15114,Muhammed Uvais,34,1043300,9020319079023754,152,1703211,124131,12414,111717
15115,Oskar van Hattum,59,4343800,7522763105625586,585,7690191,3853471,0,3853471
15116,Diego van Oorschot,28,913000,4388151473838056,104,1231730,618308,61831,556477
15117,Edwin Sydney Vanspaul,60,3208400,8765853578935015,491,6587125,3943716,0,3943716
15118,Nando Verdoni,55,1732400,5697125337325621,385,3919255,1845600,185,1845415
15119,Jakob Vester,46,1475400,6013388509605849,252,2928720,1915007,191501,1723506
15120,Caylan Vickers,62,1826900,9855134151654880,400,4591561,1692650,169265,1523385
15121,Eyram Viegbe,52,1776500,3441985006469586,352,4109478,193117,194,192923
15122,Gino Vivi,43,3834200,8464925561713721,384,6375336,3888877,38889,3849988
15123,Luke Wade-Slater,65,1047500,4445151629973984,371,3380992,2543,0,2543
15124,Wang Xianjun,47,2030000,4671085043168081,295,3748777,2163560,0,2163560
15125,Wang Jiahao,41,3700200,9337900847397043,425,6516144,5263542,5264,5258278
15126,Christie Ward,34,4165200,5339603913973123,397,5956138,3994148,3994148,0
15127,Lewis Webb,28,2749800,4006273344702047,233,3839127,3520203,3520203,0
15128,Adam Wells,41,1228200,6299410732385152,187,2147892,308902,30891,278011
15129,Viktor Widell,47,3067300,8998900502240637,398,5432249,387241,388,386853
15130,Rasmus Wikström,26,2200400,9865908767842531,215,3171962,533024,0,533024
15131,Jack Wills,38,2332300,6013515749769267,279,4004429,3720692,0,3720692
15132,Yan Zhiyu,23,3614600,5905756196164212,324,5227661,2881705,289,2881416
15133,Yao Daogang,32,1876900,4843699742770996,229,3089918,843940,8440,835500
15134,Besfort Zeneli,39,1341400,3634333910832935,231,2703377,809152,80916,728236
15135,Tristan Zesiger,57,1648100,9692075371039372,376,4063820,111858,112,111746
15136,Zhang Huachen,33,1265000,5137666782395937,143,1761255,1217940,122,1217818
15137,Zhao Jianfei,49,1318000,8537356524660217,277,2822564,226127,2262,223865
15138,Rami Zouaoui,24,3022300,3856317934600959,251,4323890,2225246,0,2225246
15139,Halik Abraham,35,4793700,9286649569328363,424,7403074,6862225,6862225,0
15140,Aaron Akalé,41,1813800,5853954403411491,275,3512235,634972,635,634337
15141,Sultan Al Akouz,22,2105000,4943197807165084,168,2738780,2281384,0,2281384
15142,Dhari Al Enazi,64,561400,7958659536994720,334,2766144,2078120,0,2078120
15143,Waleed Al Enazi,65,3953500,9891903924500161,522,6864250,1298806,1298806,0
15144,Bader Al Enazi,62,4734600,8670106750055539,621,8639172,5907200,5907200,0
15145,Adeeb Al Haizan,36,2714000,7711112983504376,315,4542422,2161736,0,2161736
15146,Ziyad Al Jari,67,2036200,4512264353350910,425,5102992,3556178,0,3556178
15147,Hassan Al Slais,40,3056600,4226088398501021,348,5343935,3093090,3094,3089996
15148,Kaden Amaniampong,35,1152900,9661604002161490,172,1948403,359507,35951,323556
15149,Casper Andersson,40,1311300,3484023886613558,193,2253629,907677,0,907677
15150,Dirk Asare,49,1349600,8708604312581098,260,2953827,685940,0,685940
15151,Leon Avdullahu,48,525900,6390417522322030,218,1861129,66856,669,66187
15152,Daniel Babb,32,3154500,9516130877594847,309,4931409,3310745,0,3310745
15153,Ahmed Bahusayn,53,3745800,6447708849426218,476,6531892,202469,20247,182222
15154,Sebastian Banozic,43,1664600,5450842526525526,257,2968430,2391598,0,2391598
15155,Brendan Barr,40,1448900,9032376097556580,200,2623437,305514,305514,0
15156,Emil Benny,23,3698600,7234869725316819,298,5326730,4424286,442429,3981857
15157,Serif Berbic,45,1114700,9969672762781186,211,2148825,132603,132603,0
15158,Kevin Berkoe,29,1135900,8296574505477761,128,1681403,462617,4627,457990
15159,Will Blackmore,68,4926800,6810450628830686,668,8834864,8727386,873,8726513
15160,Eirik Blikstad,47,942100,6174095764433102,187,1907401,1676689,16767,1659922
15161,Luca Bolletta,60,3055300,4927732663793165,489,6088042,74327,74327,0
15162,Tom Booth,59,4242400,7611062440267314,581,8004349,6856050,686,6855364
15163,Magnus Bøttker,56,2502800,4075191385282663,416,5257744,1779337,17794,1761543
15164,Ben Bottomley,54,3852700,6285304283954224,495,6780910,4298645,4299,4294346
15165,Matthew Bozinovski,56,2429900,8509345665715480,360,4422869,899134,89914,809220
15166,Jed Brown,67,394400,5260544483083650,263,1922882,1438965,14390,1424575
15167,Cosmin Bucuroiu,34,4077100,7696743007849091,394,6825305,3324232,0,3324232
15168,Livan Burcu,33,1756300,3164005151186623,217,3076932,2620104,263,2619841
15169,Tobías Cabrera,32,4930000,8203988243704361,424,6966853,6565728,656573,5909155
15170,Cai Mingmin,33,2933100,4344614950542793,309,4447017,3329527,0,3329527
15171,Max Caputo,61,4657700,8243952981844548,606,8168022,5802220,58023,5744197
15172,Sauvik Chakrabarti,28,4103600,6280051374879216,346,6220673,2703258,0,2703258
15173,Josh Chambers,65,2466500,3097460240244262,431,5114067,3159376,0,3159376
15174,Chen Jie,63,1630200,4517937926418888,331,3705394,3419489,3419489,0
15175,Chen Keqiang,46,4561500,8060784682051944,546,8403820,5116365,0,5116365
15176,Peter Cherrie,36,4966000,5992619050842362,433,7162202,3866035,0,3866035
15177,Ajay Chhetri,25,2802600,8285721728719266,247,3606445,1330149,133015,1197134
15178,Ayush Chhetri,63,1727400,6058288562506417,383,4002971,2233894,2233894,0
15179,Makan Winkle Chothe,67,1109600,4439498326013159,405,3903574,2251033,0,2251033
15180,Éanna Clancy,62,2375100,3149656306756388,492,5933841,5134306,0,5134306
15181,Chay Cooper,23,4701100,4393824826367341,372,6728813,3224795,3225,3221570
15182,Joel Cotterill,47,2543500,9090505832689468,325,4411185,3904845,3905,3900940
15183,Kieran Cruise,63,3667100,6479885799538098,533,7128974,2031383,2031383,0
15184,Rohit Danu,60,4586900,3919463950771537,593,8325060,3679659,3679659,0
15185,Sourav Das,29,3738900,5888651738443903,343,5280676,639944,640,639304
15186,Malik Deme,69,1979400,9406456661531367,463,4755313,4128979,0,4128979
15187,Mark Dignam,63,2601700,3485124842131411,450,5264423,1546576,1546576,0
15188,Matthias Dollinger,50,3900600,9634188937484481,490,7030171,2840283,2840283,0
15189,CJ dos Santos,61,4037600,7430167843352817,522,6891653,2124096,212410,1911686
15190,Viktor Dryselius,60,3427200,3077571767444096,567,7286946,1279412,12795,1266617
15191,Sam Durrant,30,3212900,8491604764731552,349,5333754,5174439,5175,5169264
15192,Michael Edwards,49,808800,4559767904226896,194,1902185,132676,132676,0
15193,Otega Ekperuoh,57,1941200,4610979286576521,386,4420985,332451,0,332451
15194,Ilias El Hari,67,4025300,5615468697620312,609,7542366,3257544,32576,3224968
15195,Nassim Elouarti,39,3066300,4383212109235705,346,4993569,1172150,11722,1160428
15196,Florian Engelhardt,42,3747900,6847062025497687,439,6031229,4697226,46973,4650253
15197,Bento Estrela,24,3818500,8169945617978242,311,5549515,2569406,25695,2543711
15198,Fei Ernanduo,49,967100,6188715276468982,269,2704417,1871,1871,0
15199,Marcus Ferkranus,52,3194000,9623549068870328,397,5986596,5426388,0,5426388
15200,Sam Gale,35,1017200,7127204252677481,153,1731093,748288,74829,673459
15201,Aldo Galeano,36,4802700,3362653342997620,468,7674449,2414505,0,2414505
15202,Saviour Gama,26,3019300,7117493890405840,309,4882545,4599794,459980,4139814
15203,Carlos Gavilán,46,2552400,8723257579348827,311,4540407,1939477,1940,1937537
15204,Hunor Gedő,34,3827600,9828017836521999,414,6158506,4393101,4393101,0
15205,Parthib Gogoi,31,2452000,7316981910304389,256,3863186,3480800,34808,3445992
15206,Sarthak Golui,25,2835300,9314533700715200,256,3844760,387660,0,387660
15207,Joe Gubbins,49,2352800,9807391710353244,388,4986861,2431053,2431053,0
15208,Gideon Guzy,55,3857900,9964255389770785,526,6976918,1487176,149,1487027
15209,Ramon Guzzo,40,2875700,8114824708778618,353,4852313,2199640,0,2199640
15210,Steven Hall,33,1607000,4327305197756272,184,2390389,1079711,1079711,0
15211,Matthew Hall,68,975800,6349718721651801,363,3359893,3010544,0,3010544
15212,Michael Halliday,67,4239900,3192532652990190,640,8821069,5831924,584,5831340
15213,Han Dong,69,3392900,8470030439556477,480,6509142,317641,31765,285876
15214,Simen Vatne Haram,58,2094800,7284498814064201,367,4704643,4136304,414,4135890
15215,Lorcan Healy,59,3204200,7087865685490196,498,6247714,4440724,444073,3996651
15216,Diego Heller,54,4623900,5146217781681724,622,8478877,7437613,0,7437613
15217,Finn Hetzsch,29,2065400,4418790360388968,253,3452851,593523,0,593523
15218,Donal Higgins,27,3378400,6586910499663859,306,5180631,1558102,15582,1542520
15219,Lucas Høgsberg,49,3866400,8296385062899951,454,6098759,114460,114460,0
15220,James Holden,52,2934400,4339691570169655,407,4998898,4516333,451634,4064699
15221,Matúš Holíček,61,4516600,8691999391444347,601,7988830,1946646,194665,1751981
15222,Corey Hollman,56,4567100,6117467344600026,649,8236972,1822054,182206,1639848
15223,Stian Aarønes Holte,47,3842100,9838908696499226,461,6860981,3575080,0,3575080
15224,Joshua Honohan,56,4011500,5954621299120013,557,7039094,4766728,477,4766251
15225,Hu Jing,57,1763600,3722343167465742,293,3555078,2070091,0,2070091
15226,Bradley Ihionvien,28,4266300,9015843459176333,407,6080616,5130832,0,5130832
15227,Brooklyn Ilunga,68,1598800,4268239976307162,381,4270187,3265617,326562,2939055
15228,Mustapha Isah,22,2952800,3703685090291693,244,4260627,125570,1256,124314
15229,Jacob Jackson,53,2735200,8147352729700266,394,4988583,2536354,0,2536354
15230,Luca Jaquenoud,62,3730200,7458682151117204,487,6749023,1436340,1437,1434903
15231,Jiang Zilei,32,3649200,7430002564701479,331,5671154,5175779,5175779,0
15232,Zak Johnson,29,2109100,8716959362334844,219,3220994,1076870,107687,969183
15233,Jarlath Jones,42,1012600,4969484369697101,210,2289031,1333076,1334,1331742
15234,Rory Jordan,42,1597700,5931153419710111,246,2976363,2059437,0,2059437
15235,Wiktor Kamiński,53,3780100,7030929936737289,514,7362869,6011590,0,6011590
15236,Hamzad Kargbo,27,2696400,9915343792701005,206,3832575,662591,0,662591
15237,Noah Karunaratne,44,1717900,7739693727572441,275,3192222,147451,1475,145976
15238,Prasanth Karuthadathkuni,23,1636900,7498529095758318,142,2042344,173545,174,173371
15239,Cian Kavanagh,50,1253500,6551519408574649,264,2785427,1546708,1546708,0
15240,Lukas Kelly-Heald,24,2428400,9457490843307433,167,2847922,1608443,16085,1592358
15241,Imran Khan,27,1142300,7265936508694613,120,1572457,51554,0,51554
15242,Kasper Kiilerich,27,1701500,8053114880765875,187,2511628,452696,452696,0
15243,Maciej Kowal,34,2245300,7774666562263470,263,3726916,663048,0,663048
15244,David Kubatta,48,3687800,7497540430503961,480,6839318,5402254,54023,5348231
15245,Ajith Kumar,70,1358600,6048909996518255,431,4169716,3237369,0,3237369
15246,Anton Kurochkin,28,2081400,9793425722258898,197,3164442,714315,7144,707171
15247,Krzysztof Kurowski,26,609300,6281229549192590,61,651819,246461,2465,243996
15248,Miłosz Kurowski,59,4019000,5243406036586304,486,6587307,2785727,0,2785727
15249,Provat Lakra,69,1818100,9595974978960458,491,5401109,2416795,0,2416795
15250,Dinpuia,64,1912100,6066878070261676,440,4773757,4103706,410371,3693335
15251,Mateusz Lechowicz,49,3633100,8209895675536162,434,6171619,1559260,155926,1403334
15252,Lee Kang Han,54,4853100,4661607335802918,574,8422681,3704670,371,3704299
15253,Lee Bum Young,59,1346900,7149434972763958,288,3269718,370448,370448,0
15254,Lee Jun Hee,35,1480800,5115258950898715,179,2312155,1754513,0,1754513
15255,Liang Shaowen,50,3971700,3712839916773918,467,6594745,1519884,1520,1518364
15256,Andréa Librici,23,2574800,7851153695606888,213,3260989,2829594,28296,2801298
15257,Alexander Hedén Lindskog,30,3241100,7756241982014496,284,4514232,3168128,3169,3164959
15258,Ahmed Longmire,69,646800,8903214795797525,302,2665361,2310505,232,2310273
15259,Lü Zhuoyi,57,1363100,8331918823647090,325,3562402,2977958,297796,2680162
15260,Jack Lynn,24,2313300,3424980928905710,166,2961338,1757201,175721,1581480
15261,Matty Macarthur,52,2419100,3479892048706654,368,4647720,3093292,309330,2783962
15262,Jithin MS,35,2875400,3686654376661039,313,4856792,1661888,167,1661721
15263,Murphy Mahoney,26,431300,9205951889584071,71,565499,100682,10069,90613
15264,Mohammed Mahzari,42,2230900,7807196483210422,287,3789809,2259911,2259911,0
15265,Saurav Mandal,48,1347300,6835305873884588,278,2781096,2085999,2085999,0
15266,Ninthoi Meetei,52,2223000,3107092678267506,399,4652243,1719804,0,1719804
15267,Jack Milne,30,549900,5398766160521741,66,643388,138768,1388,137380
15268,Zach Mitchell,63,448500,3326739030820058,306,2614345,1044736,1045,1043691
15269,Liam Möller,69,4568500,3750782345610215,614,8490426,5317439,532,5316907
15270,Isaac Moore,37,4494700,9198843289183667,467,7018319,5413683,5414,5408269
15271,Mohammad Nawaz,32,4652400,5340240488392429,434,7526049,4853187,486,4852701
15272,Claudiu Negoescu,41,354900,7716223995773012,156,1202741,550812,0,550812
15273,Ronny Nelson,51,2764800,3189694833706939,386,4962432,3104391,3104391,0
15274,Kitt Nelson,29,3204000,7011007048028379,291,4954607,853939,0,853939
15275,Magnus Nielsen,31,3662700,4999769859048034,332,5349987,2220971,22210,2198761
15276,Danny Norris,62,4938000,9262732986658889,548,8209922,492024,0,492024
15277,Leon Nübel,33,2838700,5721948908324652,320,4568552,2160896,21609,2139287
15278,Connor O'Brien,56,4655200,7408627022562023,568,8554384,6901563,6901563,0
15279,Alan Omerovic,70,2699500,5904217156857531,464,5982616,2433443,2434,2431009
15280,Leander Øy,27,4521300,3279750438417123,360,6347281,2588768,259,2588509
15281,Taulant Parallangaj,27,845400,5444835632805247,70,941252,743093,0,743093
15282,Niclas Holm Pedersen,67,1116100,5108533861012670,368,3730821,975574,97558,878016
15283,Jonathan Perez,54,4008100,3664499678116727,501,7644423,1539435,0,1539435
15284,Aaron Pickles,50,4528700,6640372926957544,537,7592070,5034370,5034370,0
15285,Jakub Pochcioł,58,4837100,5730408454275058,592,8155708,3621042,3622,3617420
15286,Robert Marian Popescu,28,887900,3489914257318879,113,1251582,1125427,113,1125314
15287,Marcel Potoczny,33,2983000,7642781866102941,310,4486679,2696904,2696904,0
15288,Oscar Priestman,70,4401400,4760393699373103,657,8664396,3423369,0,3423369
15289,Mobashir Rahman,68,1160000,6436640023838799,319,3356500,2663820,0,2663820
15290,Amey Ranawade,57,516800,9453146372858973,248,2117897,210896,21090,189806
15291,Jayesh Rane,36,1126000,3023360739994757,189,2263751,1157109,1158,1155951
15292,Sumit Rathi,49,880500,3332479907781670,239,2269682,1194840,0,1194840
15293,Frederik Recktenwald,28,3515900,4779433881434968,286,4689324,552357,553,551804
15294,Magnus Rugland Ree,33,1870400,6683995125747511,188,2735378,1741999,175,1741824
15295,Miguel Reichmuth,35,1059600,3991108239465509,176,2081581,1050316,105032,945284
15296,Wilfredo Rivera,49,967400,5198830325308140,273,2657765,2314376,23144,2291232
15297,Alessio Rizza,59,4702000,9231879272820396,638,8668462,772117,0,772117
15298,Jannik Robatsch,67,525800,7535310856833875,265,2162085,42752,42752,0
15299,Rochharzela,22,3879800,6331794756884840,306,5845353,3931525,3932,3927593
15300,Abraham Rodriguez,30,3851900,7073054886570474,365,5850942,1184269,11843,1172426
15301,Noah Rupp,60,2912300,5683640465132549,484,5585769,230583,231,230352
15302,Mansour Saeed,57,354200,6296165672582875,257,2118826,123745,12375,111370
15303,Alex Saji,44,4214600,7271518092062324,464,7411661,3178921,31790,3147131
15304,Samuel Sandoval,35,2547900,9203404272790657,287,4121950,256141,256141,0
15305,Zac Sapsford,48,1773400,7281923971423726,296,3332478,325338,326,325012
15306,Jamie Searle,45,3490200,5383443677539131,437,6367462,3656513,0,3656513
15307,Josh Seary,27,4434700,8892396383589997,342,6383600,437924,43793,394131
15308,Johannes Selvén,51,417300,4642723072972710,207,1635114,1435086,14351,1420735
15309,Parag Shrivas,62,3081100,8034276820955157,501,6015953,3868379,3869,3864510
15310,Hussain Sibyani,24,2463200,7410950593941018,207,3420321,2446476,24465,2422011
15311,Huidrom Singh,42,3100600,8587337969584288,328,4841449,1588459,15885,1572574
15312,Jiteshwor Singh,66,686500,5664063661017389,332,3107752,2358924,236,2358688
15313,Kamaljit Singh,55,2796900,9627648837018465,462,5462964,4297130,0,4297130
15314,Bidyashagar Singh,41,662700,7174421997297497,166,1442921,448697,0,448697
15315,Amarjit Singh Kiyam,68,3279300,4803947686596836,535,6700249,4681962,4681962,0
15316,Melvin Sjöland,22,4201600,8721058821208310,345,6485820,2750437,0,2750437
15317,Bailey Sloane,67,391200,8300529057319204,290,2406436,1656457,0,1656457
15318,Scott Smith,27,3217500,7798664926347931,278,4681137,1145060,1146,1143914
15319,Oskar Snorre,55,2795700,8271304109001656,439,5725265,4840152,484016,4356136
15320,Harrison Sodje,50,1202400,4290893273100268,248,2583548,1961962,197,1961765
15321,Michael Soosairaj,59,4945400,3887724969164777,589,8465785,7033755,0,7033755
15322,Răzvan Andrei Tănasă,62,2667000,7920858925966090,476,5813803,3521625,3521625,0
15323,Joe Taylor,58,2911600,3168787825711505,484,5878503,2992056,0,2992056
15324,Sam Taylor,39,1996000,7032358333687720,263,3580147,148868,149,148719
15325,Saliou Thioune,52,2470400,5743663984977336,344,4490531,4347125,435,4346690
15326,Redeem Tlang,41,657100,8863460522094040,171,1492434,570258,0,570258
15327,Karlo Tomašec,68,2402800,6566452054457523,485,5507316,4195946,41960,4153986
15328,Christian Torres,23,4712300,5286356234078491,324,6259846,765836,7659,758177
15329,Musa Toure,28,4799500,9552097262996091,460,7066947,293507,0,293507
15330,Jacob Trenskow,34,3158100,4522943834221429,304,4785805,4623353,462336,4161017
15331,Xavier Valdez,41,4555300,9868456900513396,455,7143081,6070725,60708,6010017
15332,Isak Vanlalruatfela,35,3560500,7043269188894971,342,5471881,2148329,215,2148114
15333,Fabio Vargas,62,1140100,9974768221016059,317,3041760,1968991,19690,1949301
15334,Roberto Voican,60,909400,9212560007038178,334,2973520,316771,317,316454
15335,Yannick Vötter,37,1040700,3823324633190363,160,1752441,116825,1169,115656
15336,Tomasz Walczak,23,4274800,9851866012876495,375,5697528,3983384,0,3983384
15337,Jack Warshawsky,29,3911400,4132867936072868,341,5597014,4516756,0,4516756
15338,Leon-Oumar Wechsel,27,2843500,5656791811332650,277,4187175,625468,0,625468
15339,Wei Lai,51,3909300,8548295000039570,481,7013902,5574227,0,5574227
15340,Fabian Wilfinger,46,3420600,5299716773285252,437,6091600,4235688,42357,4193331
15341,Jay Williams,63,3600100,4818862526279039,608,8084915,6649175,664918,5984257
15342,Andrew Wogan,24,3919600,7354338387718032,274,4709023,3419420,34195,3385225
15343,Josh Woods,70,2042200,3827529842486663,478,5545200,3229555,322956,2906599
15344,Wu Wei,28,1584900,5766324315771592,185,2481886,1958948,19590,1939358
15345,Laurence Wyke,66,368300,9260187692308669,315,2415737,2049659,205,2049454
15346,Yang Zihao,70,1430200,6945982799752122,373,3817346,1673596,16736,1656860
15347,Ablikim Abdusalam,57,2412700,5001017911701445,371,4456994,378548,0,378548
15348,Babajide Adeeko,46,2378500,3457666284702933,309,3867590,685936,0,685936
15349,Ayush Adhikari,62,3009900,5925128766693068,460,5917280,3635797,0,3635797
15350,Malek Al Darwish,68,2148000,7083556813738746,424,5115239,884116,885,883231
15351,Ayman Al Hussaini,34,2636000,3202602144179636,287,4297479,3653205,36533,3616672
15352,Osama Al Mermish,36,3156900,9397675713121955,347,5352723,3517520,352,3517168
15353,Turki Al Mutairi,56,2821000,5339966601304141,425,5553839,1573769,0,1573769
15354,Rakan Al Najjar,61,4518700,7111913848838488,635,8260113,5523508,0,5523508
15355,Othman Al Othman,46,3410900,6092941393470825,394,5408207,972640,9727,962913
15356,Faisal Ali,32,1493300,5053875804522622,192,2480773,794249,7943,786306
15357,Sebastian Anderson,38,2108700,7224217453368502,255,3821322,1982818,1982818,0
15358,Jamie Andrews,23,3641900,9620244859578915,301,4674930,433312,43332,389980
15359,Mayowa Animasahun,62,3440900,9722649666253703,512,6658190,5429499,54295,5375204
15360,Joel Anker,53,1708300,7212351153090520,312,3655719,1684813,16849,1667964
15361,Oskar Annell,59,1287500,6568865449278275,363,3610416,1627981,1627981,0
15362,Gavin Beavers,55,351400,5342028700819879,214,1667164,1405773,1405773,0
15363,David Bendrik,37,460100,5817406949143612,114,997196,208183,208183,0
15364,Xavier Benjamin,58,3476400,7351295275253948,510,6430483,6277703,0,6277703
15365,Kenan Bilalovic,69,4818600,6943346960505089,687,8945209,7237128,7237128,0
15366,Love Björnson,36,1444800,6074944487788377,219,2502027,315166,0,315166
15367,Nathanael Blair,40,4432500,4164023546710674,401,6268315,5577144,0,5577144
15368,Alexandru Blidar,67,2455100,7856578906964156,477,5836994,2712498,0,2712498
15369,Oskar Boesen,45,1584300,4361557605963959,241,3042097,1027032,1028,1026004
15370,Stephen Bolma,39,4692400,8352960549455156,443,7164475,6067072,607,6066465
15371,Gaurav Bora,37,4683400,5878147863607301,447,7715635,3091096,309110,2781986
15372,Federico Brancolini,44,3877900,4583152312423733,450,6828126,390935,0,390935
15373,Noah Brdar,67,2359600,4142538394771838,469,5647322,2273413,0,2273413
15374,Cian Byrne,43,2379000,7407149268902283,314,4115999,2838700,2838700,0
15375,Oliver Byrne,47,640500,5390666820930580,174,1655504,582136,582136,0
15376,Mark Byrne,38,3844600,3763598706970687,411,6076563,334026,33403,300623
15377,Sean Carey,28,3478900,6984266533282235,332,5392437,4250398,425040,3825358
15378,Ludvig Carlius,44,849200,3963404329998553,196,2044242,896455,897,895558
15379,Antonio Carrera,33,4280800,7752417521087067,417,6549598,5412708,0,5412708
15380,Chen Chunxin,47,1241400,7102233893116319,274,2843636,2666716,2667,2664049
15381,Luca de Meester,39,3412000,9704522197420501,407,5863257,4417026,0,4417026
15382,Aidan Denholm,41,4349700,7645266062408479,445,7191588,171292,1713,169579
15383,Tom Donaghy,37,686500,3171765034369665,160,1534234,1508798,0,1508798
15384,Justin Duda,62,3366500,3775851547947323,500,6446373,4657649,0,4657649
15385,Bela Dumrath,62,2574000,3575912892205631,499,5966538,3338000,0,3338000
15386,Noureddine El Bahhar,57,2246200,9257033576578739,393,4703328,1203397,12034,1191363
15387,Cameron Elliott,54,4729900,8821068013786140,514,8245668,3668007,3669,3664338
15388,Mario Enache,43,3935800,6826370706286115,401,5787824,1693999,1694,1692305
15389,David Ezeh,47,3726400,7192072435035026,438,5824400,2746967,0,2746967
15390,Kingslee Fernandes,68,2448000,3405426113397604,476,5543870,4058782,405879,3652903
15391,Emmanuel Fernandez,51,2252300,8565989293805577,337,4159872,3029539,3029539,0
15392,Julian Gaines,32,731000,5399928091697642,131,1407705,326565,327,326238
15393,Santiago Gutierrez,32,3321200,7570646803735871,355,5659667,1353704,136,1353568
15394,Antoine Hainaut,53,4619800,4168750244751550,543,7508460,3738733,3738733,0
15395,Josh Hallard,44,3698400,9494924313295190,374,5889293,5849076,585,5848491
15396,Bret Halsey,36,994100,4642102764759106,166,1760626,446227,0,446227
15397,Han Ji Yul,42,3176900,4204507805652276,395,5456420,3966902,0,3966902
15398,Nathan Harness,37,3229600,4346320689571446,303,4739270,1276088,127609,1148479
15399,Emmanuel Harvest,38,4108600,7321782635877455,466,6338125,5241970,524197,4717773
15400,Krisztián Hegyi,70,1659300,7998708351983893,378,3728292,1620689,0,1620689
15401,Erik Herrmann,52,1021800,7285617291152401,278,2877460,1507297,15073,1492224
15402,Isaac Hughes,48,3321300,7600561488196530,452,5636186,2968313,2968313,0
15403,Andrin Hunziker,57,1848100,9218954998981660,314,3809029,3587689,3588,3584101
15404,Oliwier Hyla,32,1468400,5856216364759072,191,2229658,1594011,1594011,0
15405,Tega Ikoba,27,2834200,3285825743042753,235,4022424,537071,538,536533
15406,Rony Jansson,24,3319200,3220210649471457,237,4563286,1392764,0,1392764
15407,Bartłomiej Jelonek,29,4198400,5331739326948546,359,5786518,4976759,4977,4971782
15408,Jeon Sung Jin,63,1187100,4194928019679564,310,2936894,2498717,250,2498467
15409,Ji Shengpan,54,2737300,3543903746888952,413,5590438,417122,418,416704
15410,Alexandru Jipa,64,3996500,5058021647408955,668,8404975,851538,8516,843022
15411,Bobby Jones,29,4356000,5594458694404994,401,6508858,159442,1595,157847
15412,Frank Junior Adjei,45,4726300,6652312704267213,510,7381096,6886263,689,6885574
15413,Florian Kastrati,45,2484900,8080519971228994,342,4683077,4516730,4517,4512213
15414,Johan Kenneryd,59,4878400,7871521298407089,623,9013122,6696332,0,6696332
15415,Evan Khouri,31,1519800,9077176480852127,187,2456340,725682,725682,0
15416,Kim Hyeong Geun,23,2587800,7048777293089173,182,3289393,1105331,111,1105220
15417,Kim Kyu Pyo,66,1483100,5971530340430743,385,4008179,2498465,24985,2473480
15418,Kim Ki Hwan,66,4643500,3822573504046395,609,8524179,1099184,0,1099184
15419,Pontus Kindberg,60,3144900,3400150148480861,500,5985911,810036,81004,729032
15420,Emil Kischka,55,2199100,9714110661261596,384,4554605,3216016,321602,2894414
15421,Luca Kjerrumgaard,37,1532700,6649424517341959,190,2462644,2170923,21710,2149213
15422,Olaf Korczakowski,27,1048200,3615334413781838,119,1557104,830186,0,830186
15423,Kacper Kucharczyk,26,4310000,9923442995603586,387,6054132,3913622,3914,3909708
15424,Jan Łabędzki,31,3625900,5883519575258926,305,5288501,1628587,1629,1626958
15425,Daniel Lalhlimpuia,55,4037100,6729084820400664,521,6651953,5407660,540766,4866894
15426,Jerry Lawrence,37,2138900,9486389030653870,264,3754400,795300,0,795300
15427,Michael Leddy,53,3780700,5742009960891606,491,7292921,6742844,6742844,0
15428,Antonio Leone,60,540200,4544115866109588,256,2310583,1222773,1223,1221550
15429,Lim Hyeong Jin,46,4549700,4649304650438644,516,7594951,3541916,3542,3538374
15430,Heiber Linares,23,2437500,6321940676950577,204,3231389,1182139,1183,1180956
15431,Piotr Liszewski,32,4364100,9309508651359999,374,6348118,1421846,1422,1420424
15432,Liu Le,69,4821100,7378862596616118,626,8897374,6053981,606,6053375
15433,Liu Jiahui,62,2237000,6861655963968000,380,4579143,3737808,0,3737808
15434,Liu Yixin,31,3484200,8537010284489289,279,4958248,1441816,14419,1427397
15435,Adam MacKinnon,41,1528600,5758940433615647,246,2832696,2159552,2159552,0
15436,Rafał Mamla,62,1132500,6729015107961563,360,3700492,2301352,23014,2278338
15437,Anthony Marcucci,55,1740700,8020382803204176,328,3729635,919684,9197,910487
15438,Alfie Marriott,24,1553000,9530138439752906,116,1838980,248500,24850,223650
15439,Glenn McConnell,52,1687400,3425699638834931,338,3840923,3392289,3392289,0
15440,Evan McLaughlin,39,3708600,9627801538134638,421,6173548,1256051,126,1255925
15441,Teddy Mfuni,63,3050400,8431530404927242,495,6142405,4395246,4396,4390850
15442,Samik Mitra,30,4352500,6874040215871710,399,6387020,182400,182400,0
15443,Manoj Mohammad,49,2650000,5394231121987264,405,5379516,2667428,267,2667161
15444,Devendra Murgaonkar,48,4128200,8295802721358039,531,6799443,3155418,31555,3123863
15445,Muhammed Nemil,29,332400,4224553106535097,75,518376,90769,0,90769
15446,James Nieuwenhuizen,29,4959000,9367949607187644,384,6528822,212562,0,212562
15447,Sebastian Nilsson,53,2422100,5114459778698162,374,4987324,4113908,0,4113908
15448,Conan Noonan,55,827800,8597891895513675,243,2419029,1758414,1758414,0
15449,Finn O'Boyle,34,1558900,5726705841490860,166,2182269,42040,4204,37836
15450,Matthew O'Brien,66,1289200,8800763166587282,387,3889571,758831,758831,0
15451,Harvey O'Brien,30,581900,5785586975212272,119,1031838,909896,90990,818906
15452,Charlie O'Connell,66,4408900,9299239075922037,602,7615917,2132028,21321,2110707
15453,Emmanuel Ochoa,29,2574000,8787853768129546,256,3819907,957318,95732,861586
15454,Morten Olsen,70,303600,5002984245407317,321,2503413,118089,0,118089
15455,Ike Orji,50,1841500,4206190701807681,296,3509387,2091172,2092,2089080
15456,Igor Orlikowski,55,306300,8698500390925030,205,1544362,1009401,1010,1008391
15457,Fiachra Pagel,65,2768600,6339927959723479,471,5632231,2011429,0,2011429
15458,Marius Papuga,25,4373700,9930827411234074,396,6894813,3134659,314,3134345
15459,Park Yong Hui,26,2397200,7875358665314784,210,3186832,2048291,204830,1843461
15460,Fabian Pekruhl,63,1430700,8925549707131281,327,3533034,1822647,18227,1804420
15461,Kacper Piechota,62,1660500,6947881787567685,338,3769418,2758637,276,2758361
15462,Arthur Piedfort,35,1759200,9774288212179919,221,3128843,1914684,1915,1912769
15463,Kayden Pierre,44,4471000,8560335538558546,530,7908311,6053890,606,6053284
15464,Paul Piffer,54,1427500,7480157097273245,302,3213985,2491457,24915,2466542
15465,Florian Pruhs,44,2839600,8905769359638350,387,5406060,4509684,451,4509233
15466,Qian Yumiao,37,2091100,9364217025373629,250,3418615,1543904,1544,1542360
15467,Fabricio Quaglio,32,656500,8795570470422148,109,989621,651216,651216,0
15468,Abdul Rabeeh,66,1599000,4191648687970759,373,3900940,1535461,154,1535307
15469,Kiban Rai,64,2961600,9410374229176985,488,6048100,2013137,2013137,0
15470,Mohamad Rakip,57,1005500,3455114444566460,265,2659141,2504741,250475,2254266
15471,Paul Ramfangzauva,26,1035000,5090467690309251,106,1318617,62979,630,62349
15472,Hayden Sargis,38,2772600,7111178561797849,329,4345673,3309434,33095,3276339
15473,Phoenix Scholtz,36,1623000,6005783054391457,206,2844499,1442965,144297,1298668
15474,Jordan Semedo,30,4770100,9341681435230842,408,6987867,583668,58367,525301
15475,Sha Yibo,36,1701400,8923012379837563,234,3004301,108690,108690,0
15476,Lara Sharma,70,3535800,4413580482956940,507,6437804,2508152,2509,2505643
15477,Shi Chenglong,26,2038300,5492026122313307,206,3302639,1902552,19026,1883526
15478,Shin Sang Eun,43,310300,9574322542765739,138,956930,167120,16712,150408
15479,Karanjit Singh,61,4427600,4506755128369423,641,8338817,5836942,5836942,0
15480,Cieran Slicker,40,3657600,4331876980898784,400,6157250,58908,590,58318
15481,Anton Sorenson,68,3945600,5110861744015196,581,7633309,533283,53329,479954
15482,Steven Sserwadda,59,2858900,8534621999396126,443,5475190,5313597,531360,4782237
15483,Storm Strand-Kolbjørnsen,41,3853300,8664261193659647,401,6409776,1141399,1142,1140257
15484,Ludvig Svanberg,33,2265500,6878101610684579,244,3620978,1905685,190569,1715116
15485,Tang Chuang,39,3847500,6976921491908058,442,5968568,2569906,25700,2544206
15486,Tao Qianglong,63,2681400,5257754252832353,489,5880760,2200700,2200700,0
15487,Sahil Tavora,24,2298300,9614832778608586,203,3287302,1241304,125,1241179
15488,Komal Thatal,53,2448400,7309182684042670,354,4307937,1019867,101987,917880
15489,Keegan Tingey,23,4014200,6972926527599885,323,5852792,3974714,3974714,0
15490,Bartosz Tomaszewski,37,2409700,5433141094648823,287,3901335,2442988,2442988,0
15491,Emre Topçu,57,3566800,3524315563881973,455,5877240,2551139,0,2551139
15492,Jackson Travis,53,1611400,4632563737015219,350,3678399,1431618,1431618,0
15493,Isaac Vanmalsawma,31,527600,3691991229198992,124,1066284,1062403,10625,1051778
15494,Adam Verdon,43,4454500,3036002069653558,467,6635567,5172460,0,5172460
15495,Wang Chu,31,3166400,9669681719690049,298,4585773,2034812,203482,1831330
15496,Wang Dongsheng,41,2687100,3963264793690483,344,4478027,924679,925,923754
15497,Brad Williams,25,3830500,9270972104500833,311,5029572,4547122,45472,4501650
15498,Thomas Williams,34,2234100,9166968325369710,230,3529182,416175,0,416175
15499,Cameron Windust,54,4068400,4102070934273565,529,7649776,3313801,0,3313801
15500,Vishal Yadav,57,402900,3508085855162241,259,2002159,775390,77539,697851
15501,Luis Zamudio,36,2962200,7934022576577947,343,4969618,3970250,3971,3966279
15502,Zhou Xin,60,2739900,6537655090832143,446,5041203,3980856,0,3980856
15503,Armin Abaz,22,619500,4689762636978132,68,722814,227108,0,227108
15504,Peter Abimbola,55,818200,9011704064928375,267,2532534,1613359,161336,1452023
15505,Meshal Al Alaeli,35,374300,4724502181354336,84,620861,269487,0,269487
15506,Azzam Al Bishi,44,2277700,7693305379893572,351,4425079,1791375,180,1791195
15507,Nasser Al Bishi,56,4204000,6789682765608086,585,8042498,4217407,0,4217407
15508,Rakan Al Dawsari,59,3681400,5836976394137247,521,7123279,3570823,0,3570823
15509,Ali Al Jassim,40,3966700,4962679441397460,426,6248148,3344859,3345,3341514
15510,Nawaf Al Rashoudi,67,4415300,3316437062674102,608,8689635,3535440,353544,3181896
15511,Marwan Al Sahafi,23,3494900,4165614642381218,259,4840096,3604291,360430,3243861
15512,Ali Al Shaefi,62,3872500,8162097608069260,576,7316246,2164654,217,2164437
15513,Mathias Andreasen,34,3784400,8126788119424628,380,5803895,3646837,0,3646837
15514,Hendry Antonay,38,521000,5959295973743664,122,1016670,103967,10397,93570
15515,Gbemi Arubi,36,2029600,9468598870830597,255,3310107,2239620,2239620,0
15516,Sulaiman Asiri,48,1806800,6722246975910302,278,3462952,2160355,0,2160355
15517,Leon Augustine,41,2081400,6008284289979364,301,3668477,2679383,26794,2652589
15518,Josh Bailey,49,367900,4436403984829677,239,1885656,1778388,178,1778210
15519,Jake Batty,69,3395200,7892378141414900,556,6882747,3705168,37052,3668116
15520,Namgyal Bhutia,26,950600,8951078750979980,72,1113716,1001074,0,1001074
15521,Gabriel Billington,32,2015500,5441085900868511,220,3141669,2946874,29469,2917405
15522,Maksymilian Boruc,43,3558800,6667290284401921,447,6168764,3207792,0,3207792
15523,Matt Boylan,34,2040200,3035299530358756,245,3408863,1421288,1422,1419866
15524,Conor Brann,53,1272800,5004478154980222,318,3387536,1475913,0,1475913
15525,Owen Bray,25,2283400,4202503220548911,223,3576616,118713,11872,106841
15526,Andy Breuer,34,1987400,8365476218213290,246,3605224,3159224,31593,3127631
15527,Marcel Campbell,67,3567500,5688130798114329,522,7163046,2777933,0,2777933
15528,Ted Cann,61,3489400,9041502359500424,546,7131310,1141689,0,1141689
15529,Pontus Carlsson,24,3083700,6263074081540129,236,3903904,256307,2564,253743
15530,Matty Carson,28,3270400,4867910602968193,279,4570825,906130,907,905223
15531,Jack Carter,51,2254100,8460879045967053,349,4521326,1808778,18088,1790690
15532,Edward Caspers,34,2589400,6514485598064367,249,3801372,1006955,10070,996885
15533,Matthew Connelly,24,2279500,3756650978602111,196,3057374,1291537,130,1291407
15534,Jackson Conway,56,3577300,4118896512533512,561,7198122,6563021,657,6562364
15535,Colm Cox,51,317200,3191363545087973,225,1818157,1072397,10724,1061673
15536,James Dadge,55,4395900,6055044252606424,573,7799064,6518456,6519,6511937
15537,Rakshit Dagar,23,3396900,7434166514525704,280,4586134,2117033,21171,2095862
15538,Warren Davis,49,4399100,4216455515973693,574,8347712,446054,446054,0
15539,Ignacy Dawid,50,2028400,4178155048414819,308,4186894,2387168,238717,2148451
15540,Samba Lélé Diba,67,526300,4064243206903829,330,2560726,116356,1164,115192
15541,Josh Dockerill,24,1672200,8950992166463394,129,2191122,1595484,1596,1593888
15542,Jake Doyle,37,1409200,9514820127802644,183,2398703,469415,0,469415
15543,Craig Dundas,49,1819000,4546346518300978,339,3978275,1460827,146083,1314744
15544,Alex Dunne,26,1747200,3191323474210658,157,2468080,1100376,1100376,0
15545,Hugo Fagerberg,24,1406100,3872527431701321,120,1711655,776805,77681,699124
15546,Harvey Fox,22,4678000,7436322402777279,375,6762281,2852080,28521,2823559
15547,Magnus Fredslund,70,3557600,7234166148683370,576,7180112,3861171,0,3861171
15548,Oisin Gallagher,50,2766200,6220102554115131,393,5181944,445376,445376,0
15549,Thomas Geris,58,1939800,8344239709235270,346,4018370,556824,557,556267
15550,Joe Gibson,27,1801300,7117033400617749,170,2431261,2424952,0,2424952
15551,Alex Giles,59,3562200,3899204865689072,516,6494775,4125407,41255,4084152
15552,Pragyan Gogoi,68,799300,9061066108731557,357,3287224,1262471,0,1262471
15553,Jayden Gorman,34,1028600,9621135364932628,156,1699340,63315,6332,56983
15554,Olly Green,31,4236700,3020684778379301,379,6099046,5151758,515176,4636582
15555,Nawaf Hawsawi,42,1098900,3618299528678150,192,2198019,415430,4155,411275
15556,Abdulelah Hawsawi,33,3366700,4858378920137118,342,5156218,4780855,47809,4733046
15557,Chris Hegardt,59,571600,8264590699733509,237,2090412,127344,12735,114609
15558,Lalrinliana Hnamte,70,887700,5650002654403997,375,3330244,282746,282746,0
15559,Isaac Hovar,57,2050500,7395281549697992,365,4276504,3013089,3014,3010075
15560,Hu Ming,25,3548900,5549627581814603,296,5403876,948506,949,947557
15561,Hu Hetao,32,3698500,9318119926495388,310,5286638,3484336,349,3483987
15562,Declan Hutchings,53,994400,4596659177119224,256,2476426,385838,385838,0
15563,Hwang Do Yun,67,4010000,3859893233352395,607,7859805,5010922,0,5010922
15564,Jang Si Young,66,1162900,5824563014523903,325,3236051,927355,928,926427
15565,Jeon Hyeon Byung,61,1990300,6388729912907952,376,4193385,223773,223773,0
15566,Mamadou Jobe,53,1984800,5758116016693854,354,3918061,2868789,2869,2865920
15567,Noah Åstrand John,58,1258600,9709159612658107,294,3238932,274467,2745,271722
15568,Josh Johnson,69,3521900,4726299288107259,490,7016213,1581272,159,1581113
15569,MJ Kamson-Kamara,37,4182100,3642014827380441,408,6690737,3542061,35421,3506640
15570,Mourad Khodari,53,4761500,8015004967750002,599,8907738,7644240,0,7644240
15571,Enes Koc,28,2852200,7592620546954548,264,4145867,2224126,22242,2201884
15572,Kylian Kouassi,51,4093300,4979512880982665,508,7559517,6435041,6435041,0
15573,Jeppe Kudsk,62,3419900,8769706415414290,501,6746094,2961229,297,2960932
15574,Bego Kujrakovic,32,1893500,8162928560018897,209,2749385,903553,904,902649
15575,Oliver Larraz,59,2366000,9186920604188655,463,5178570,2212679,0,2212679
15576,Damian Las,52,3571400,6856223997336187,422,6371232,4867676,4868,4862808
15577,Harry Leeson,24,1617900,5540354811556871,172,2411185,705301,705301,0
15578,Li Ning,34,4024800,9004256506651447,444,6928116,3759497,37595,3721902
15579,Darius Lipsiuc,54,1445600,5237601829093257,270,2940047,820307,8204,812103
15580,Liu Chaoyang,40,645800,7785161879255329,164,1562953,968546,96855,871691
15581,Lu Ning,34,1215200,5346639022578112,160,2039432,1543309,0,1543309
15582,Ma Sheng,24,2643900,6362480926238209,200,3478695,928938,928938,0
15583,Owen Mason,39,2778200,4654976834005217,298,4225949,75756,0,75756
15584,Jake Morris,42,4351800,8404647107926055,440,6538024,2343561,2343561,0
15585,Ankit Mukherjee,39,2631600,9324917345090005,280,4161822,3692237,3693,3688544
15586,Magnus Munck,54,3459600,7283245520880914,469,6598770,4966345,496635,4469710
15587,Ross Munro,38,346600,5619834910556856,108,858544,669032,0,669032
15588,Alex Munteanu,52,1967300,5259267009086894,370,4176873,762725,0,762725
15589,Simon Nesler-Täubl,53,1709000,3780716436029660,345,3842667,2312276,232,2312044
15590,Gani Nigam,70,4824500,7153710149285131,674,9365699,2714107,2714107,0
15591,John O'Donovan,63,1562700,5740185341265012,371,4102852,290457,290457,0
15592,Nana Owusu,52,4383800,6715587996007067,513,7486720,2066129,206613,1859516
15593,Jakub Paszkowski,39,2371800,5981900057503772,283,4015642,3849896,384990,3464906
15594,Peng Peng,26,2614800,6449532112384457,227,3648246,2328142,2328142,0
15595,Sanson Pereira,34,4073600,5048722741047109,355,5983914,905486,0,905486
15596,Matthias Postl,34,713300,3873115418792676,135,1407613,1221141,1221141,0
15597,Lalthuammawia Ralte,37,3166000,3011541805285620,303,4793317,1577992,1578,1576414
15598,Denis Rența,52,2222500,5569662895084653,367,4576459,101013,0,101013
15599,Tom Ritchie,25,3790300,6171079541547787,269,4692623,140019,14002,126017
15600,Bhaskar Roy,46,2606600,9884143634476290,363,4618411,149439,149439,0
15601,Shankar Sampingiraj,68,4190000,6826103045061221,598,7935737,1026069,0,1026069
15602,Meshari Sanyor,46,4868500,5834692196554879,499,7156003,6040173,605,6039568
15603,Christian Schmidt,45,2539500,9729664399852079,293,4180465,1813743,181375,1632368
15604,Simon Seidl,28,2548000,3104366929712306,225,3778826,2915852,0,2915852
15605,Seo Seung Woo,58,4294700,3331982581900303,570,7741494,7356636,7357,7349279
15606,Arsh Shaikh,37,3358300,4785393348629205,361,5266120,1691811,169182,1522629
15607,Declan Skura,61,2455900,9407111178604183,448,5372761,140299,141,140158
15608,Miłosz Strzeboński,61,457800,9140753824741959,282,2177814,1192488,1193,1191295
15609,Arion Sulemani,30,727600,5236469690706044,80,893183,117044,1171,115873
15610,Chris Sze,55,2711300,9823140168538356,436,5351590,3051204,305121,2746083
15611,Ellis Taylor,56,1069100,9106713965368486,271,2822254,1402807,14029,1388778
15612,Tian Yuda,45,1514200,3129578245387948,276,3220421,1876988,188,1876800
15613,David Toure,42,442800,4046020765305620,174,1516176,599370,599370,0
15614,Seydou Traoré,34,4818500,5338609642754239,490,7219723,2433451,24335,2409116
15615,Lewis Trickett,67,1213000,8230418175058503,389,3659450,252659,0,252659
15616,Alexandru Utiu,28,3557700,8975925829808375,377,5147794,3858042,38581,3819461
15617,Jannes Van Hof,60,3554700,9391097419148991,549,7358220,2475136,0,2475136
15618,Gordon Walker,61,776900,3419606282265746,320,3016959,1217542,0,1217542
15619,Charlie Waller,30,1375900,6911423020498738,151,1902794,81940,8194,73746
15620,Jesper Webber,26,1549000,4054532376325872,174,2521294,1346855,1347,1345508
15621,Wen Junjie,49,3152200,7340618945642163,394,5318349,3117848,311785,2806063
15622,Harvey Wiles-Richards,38,2078800,4264789981173870,249,3381850,699250,6993,692257
15623,Morgan Williams,59,3314400,5964075188891320,478,6697863,5564616,5564616,0
15624,Wu Fei,62,1321800,4360048688327329,340,3436822,610843,0,610843
15625,Murat Can Yıldız,50,1989600,7226288464025999,343,4346455,420187,42019,378168
15626,Zhang Xiangshuo,26,2891100,8087667037039784,263,3999122,384663,385,384278
15627,Zheng Haoqian,31,1767400,5813963065726020,175,2658118,194482,1945,192537
15628,Albin Ahlstrand,24,544400,4972978832501731,27,323499,56460,56460,0
15629,Tarif Akhand,38,4039400,8339752293401582,380,6313220,4932478,4933,4927545
15630,Mohammed Al Abdullah,47,1887100,8819621150462643,251,3355345,382963,38297,344666
15631,Belal Al Doaa,28,325800,6506858104609327,80,597583,182200,183,182017
15632,Mutlaq Al Hurayji,32,1981600,6243453754964941,200,2805915,1374295,138,1374157
15633,Suwailem Al Menhali,64,4163200,4860634980365528,569,7481228,3772443,3773,3768670
15634,Theo Alexandrou,39,4237400,9123638934492535,400,6165300,5869154,5870,5863284
15635,Victor Arong,55,2555100,9761221103900613,392,4859850,2509885,2510,2507375
15636,Zak Baker,35,2753600,9154619200797649,279,3963541,1414903,1414903,0
15637,Rhys Bartley,41,2335200,9063758805379555,308,4317159,3308868,0,3308868
15638,Zaydan Bello,66,4919700,6662371359864136,623,9230185,7961662,7961662,0
15639,Murphy Bennett,27,822200,5282959342866264,106,1266653,54669,547,54122
15640,Ryan Bowden,49,3189600,3488391573017524,448,6114727,611858,612,611246
15641,Gabriel Breeze,62,4486300,9453091693629077,666,8522295,7377023,0,7377023
15642,Matteo Campagna,50,3101600,4705767180528563,386,5260918,1711926,1712,1710214
15643,Jesús Cantillo,35,770700,5372555866066939,122,1296775,1106485,111,1106374
15644,Sami Clarke,48,869000,8326385441009259,227,2357000,2051378,0,2051378
15645,Răzvan Creț,38,1265100,4462699082997442,194,2247355,2155523,2156,2153367
15646,Leander D'Cunha,67,742400,9923681064000443,369,3236852,2143603,2144,2141459
15647,Aaren D'Silva,59,4720600,9559790116319319,556,7774610,856576,0,856576
15648,Ebbe De Vlaeminck,70,2492200,5705769588124697,478,5506722,4250412,4251,4246161
15649,Emin Durakovic,37,843000,6818135482938812,153,1584563,825916,8260,817656
15650,Makise Evans,43,4111900,3512011539922814,441,6732879,4441194,0,4441194
15651,Fang Hao,69,2635500,3053419725196929,554,6582336,5588535,5589,5582946
15652,Feng Shuaihang,53,1911500,4200737592583051,336,3945397,834969,0,834969
15653,Brison Fernandes,68,4064000,4140671550296756,644,8921396,7760520,777,7759743
15654,Sonny Finch,70,2816100,3611186608596026,514,6437024,2016824,202,2016622
15655,Nicolas Firmino,57,4695000,7485123473722200,622,8576921,1199389,0,1199389
15656,Alexander Freeman,59,4464400,8459361064919037,632,7877814,1660839,166084,1494755
15657,Hussain Furayj,59,4647300,8367157245241230,550,7623968,1275395,1276,1274119
15658,Gou Junchen,64,4554000,4737195103147092,615,8049367,2825051,2826,2822225
15659,Guo Jiayu,49,2109200,6501130476934553,345,4010486,3412955,0,3412955
15660,Leo Hedenberg,27,827700,9156522946869806,93,1038296,823028,824,822204
15661,Gavin Hodgins,26,4292000,9650181882399649,378,6755137,2497285,2498,2494787
15662,George Horbury,24,3951400,3491919073804118,348,5853128,3342692,335,3342357
15663,Hu Jiajin,25,2301600,4917969656348605,190,3285303,776581,776581,0
15664,Kim Hyun Seo,56,940700,7215344530271094,283,2499510,1355090,1355090,0
15665,Kim Ju Hyeong,22,2457700,3525504284566662,200,3344076,1323076,0,1323076
15666,Anuj Kumar,39,2912300,3421530704468443,330,4891887,855988,85599,770389
15667,Ravi Kumar,39,620500,4174506192821886,133,1221172,470753,47076,423677
15668,Niraj Kumar,34,764600,4146609332452841,125,1332898,1201128,1202,1199926
15669,Eduard Lambrinoc,56,2237800,3364783853062098,370,4898399,2108061,21081,2086980
15670,Lee Won Woo,52,1979900,9006466082369153,369,4372907,2552906,25530,2527376
15671,Toms Leitis,42,852900,6450019350352618,203,2023475,23952,0,23952
15672,Jack Lemoignan,23,3813500,3943702268444315,292,4909917,1128687,113,1128574
15673,Liu Bin,56,771600,5679114699141708,260,2473687,1357366,136,1357230
15674,Thomas Lutte,30,4806000,5203371980685119,420,7326288,2595984,0,2595984
15675,Kaelan Majekodunmi,55,510600,9034482848031977,196,1636320,77374,0,77374
15676,Sean McAteer,31,648500,6626792437875471,97,914972,719069,71907,647162
15677,Danny McGrath,25,779500,7031242780307884,92,1034391,66663,6667,59996
15678,Memet-Raim Memet-Ali,52,2634200,8813148026673898,405,5174992,5100452,511,5099941
15679,Argjend Miftari,57,4761400,3409354162331943,547,8077080,1606703,161,1606542
15680,Fardin Ali Molla,63,1686400,7061924024927335,352,3936992,201761,0,201761
15681,Wungngayam Muirang,22,506900,7561227241078932,28,316727,303111,30312,272799
15682,Luther Munakandafa,34,3195200,8295113012324212,339,5095162,2731793,274,2731519
15683,Daniel Munie,35,1610700,4232169395882462,190,2554770,1696797,0,1696797
15684,Ștefan Mușat,25,4993200,3734894225285187,377,6634772,4392615,4393,4388222
15685,Jake Najdovski,28,3204700,7690821065143073,265,4202962,1594884,159489,1435395
15686,Jakub Niemczyk,63,4881900,3717833162713431,587,8039457,6276233,628,6275605
15687,Kennedy Okpala,34,4540000,9441499088606733,466,7538623,1350510,1350510,0
15688,Sergio Oregel,41,2745700,7077217406342654,295,4143897,1500391,150040,1350351
15689,Emerich Poilly,56,2673300,7608011816864067,405,5155082,3242248,324225,2918023
15690,Nikhil Prabhu,49,493500,4909919603190857,225,2002191,1941234,0,1941234
15691,Malakai Reeve,45,480800,8776757714643713,184,1497162,1398459,13985,1384474
15692,Heath Richardson,61,3770000,5423936696630160,519,6654511,1883656,1883656,0
15693,Aron Sasu,29,3521700,3970341898219158,337,5178273,2617908,26180,2591728
15694,Gursimrat Singh,24,4648200,3932400633613716,424,6720717,4270667,4271,4266396
15695,Manvir Singh,45,1639700,3270256880721079,270,3363937,2863292,0,2863292
15696,Tondonba Singh,51,1069600,7807359935348177,248,2466784,258572,2586,255986
15697,Gurkirat Singh,64,4912300,9513820092122968,722,9532169,8425084,8425084,0
15698,Harrison Smith,36,753200,8047417932225510,151,1507321,892680,892680,0
15699,Ethan Sutcliffe,62,2870600,9846557015201507,486,5662353,3223570,323,3223247
15700,Ahmad Taleb,30,4675700,6196438623525874,407,6639927,1964266,196427,1767839
15701,Casey Walls,40,4889800,6499792896224736,491,8310233,3850315,0,3850315
15702,Rhys Walters,53,1888200,4387402956581659,316,3779746,2923084,2923084,0
15703,Callum Wood,68,2368200,6618306378056003,449,5536835,5165018,5165018,0
15704,Joe Wright,55,3671500,6446568198144912,489,6521977,5755535,0,5755535
15705,Xia Xiaoxi,27,560500,3769825181415894,89,888920,340562,3406,337156
15706,Xu Zhenyao,54,2477100,5337026872028949,401,4959785,2334786,0,2334786
15707,Dylan Youmbi,57,2263200,8737544607484558,421,4594880,4439611,0,4439611
15708,Abdulrahman Abdulqader,70,608400,8721659750567470,332,2806038,53677,5368,48309
15709,Ali Abdulraouf,69,4988800,5230221920326012,690,9246054,6306141,6307,6299834
15710,Kudirat Ablet,23,660000,3019829022011741,58,688039,422729,422729,0
15711,Rayan Al Dawsari,41,1800000,9297658720391088,303,3499087,3129483,313,3129170
15712,Abdullah Al Enazi,54,3520500,9072709881764682,497,6336308,2628311,2628311,0
15713,Bandar Al Shahrani,69,3026100,9731245802142431,513,6484873,1713514,17136,1696378
15714,Salem Al Toiawy,56,1885700,6734622940536675,340,4024742,377805,378,377427
15715,Sajal Bag,66,3967100,4946864535466657,554,7226019,4792537,0,4792537
15716,Mitch Beardmore,48,4658000,9165073417207892,499,7362983,640216,0,640216
15717,Gustav Bendrik,70,4473800,6053055940419585,631,8138903,6746164,6746164,0
15718,Pranjal Bhumij,31,4781500,3480310659008331,419,6465171,4713692,0,4713692
15719,Lewis Billington,39,1336800,7434103734174413,188,2240307,1280079,1281,1278798
15720,Jamie Bramwell,59,4118300,9783224057348028,596,7694008,3788548,3788548,0
15721,Javier Casas Jr.,68,440500,5099711095828636,335,2656963,1316360,13164,1303196
15722,Mackenzie Chapman,30,3686200,4680461443447160,349,5507371,2251326,22514,2228812
15723,Chen Xiangyu,52,4430900,9264427656871415,496,7824537,1719303,0,1719303
15724,Cho Sung hoon,46,1712200,3456589196442640,292,3216660,3115303,311531,2803772
15725,Owen Cushion,25,887100,5004062249346221,88,1097149,1045888,1045888,0
15726,Tuhin Das,35,4473000,7704407052811792,426,6946348,6371575,6371575,0
15727,Mikey Davies,51,4263400,3745455393038125,489,7526188,731217,7313,723904
15728,Christian Dobozi,59,2882900,5209580386553800,431,5266142,4266221,4266221,0
15729,Max Edgecombe,63,4108200,8721235925052746,556,7590232,1453798,1453798,0
15730,Fred Emmings,60,4773600,9248596911982710,581,8393156,740057,74006,666051
15731,Fu Yuncheng,54,3427600,6642840846741228,478,6297565,766824,7669,759155
15732,Lennon Gill,67,2752800,9142972493330920,532,6383728,4611425,0,4611425
15733,Amrit Gope,41,4618600,3229662562715812,528,7184657,2991436,299144,2692292
15734,Ha Dong Seon,42,4499700,8765731653529462,470,7524053,3760450,0,3760450
15735,Jack Hannah,61,2105800,3986411385716464,431,5263772,4130868,0,4130868
15736,Freddie Issaka,55,408700,3777612261629467,230,1810026,24333,0,24333
15737,Ji Jiabao,42,4024000,5165865811101340,494,6406765,306119,306119,0
15738,Soyal Joshy,39,3210400,7331060456622287,378,5261283,4283246,4284,4278962
15739,Matt Kerbey,47,2811700,6902115514819365,366,5279124,2074539,2075,2072464
15740,Oskar Leśniak,28,1584100,4256124501757326,173,2492458,2244579,225,2244354
15741,Li Yuefeng,69,4940300,9174137942180020,701,9840322,1527761,1527761,0
15742,Li Junfeng,50,4833400,6205389287895197,535,8049137,432256,0,432256
15743,Owen Lunt,57,3531500,6578397237145883,495,6352497,4271253,427126,3844127
15744,Mai Gaolin,53,2321500,8553893715963911,326,3928667,2712460,271246,2441214
15745,Ashton Mee,44,1774100,4226038469167103,253,3406708,61388,614,60774
15746,Rylee Mitchell,59,3145300,9587672453928484,494,6141604,2055935,0,2055935
15747,Joe O'Connor,34,1008300,6663767787599844,132,1576668,1480095,14801,1465294
15748,Devin Padelford,32,1358400,4537284362437584,199,2492885,266335,26634,239701
15749,Park Geon Woo,54,4458600,8101488864481855,558,8199484,5349515,0,5349515
15750,Park Jae Kyung,41,856300,6286198849803327,173,1800170,818743,0,818743
15751,Bobby Pointon,56,2128600,7947528327878323,407,4730785,1817992,18180,1799812
15752,Ran Weifeng,35,3378400,8615071897810928,347,5120999,40401,40401,0
15753,Ravi Rana,68,579600,8013145132429931,304,2614208,2181325,2182,2179143
15754,Alex Robinson,32,1300000,9447037016037392,188,2247155,1979934,0,1979934
15755,Missael Rodríguez,40,1170700,3112874115154041,183,2163052,1649530,165,1649365
15756,Ruan Qilong,40,2886000,9193313148689914,350,4615627,738959,0,738959
15757,Sebastian Saftig,57,3578000,6483085408539957,523,6723178,613009,0,613009
15758,Ricky Shabong,54,2462900,8145597818182896,432,5624737,2751585,27516,2724069
15759,Shi Lishan,48,1863100,7099635378296694,294,3495227,785672,0,785672
15760,Givson Singh,32,3049300,9259519109327812,320,5070357,2853515,0,2853515
15761,Sun Jianxiang,70,4797300,3238929372096654,664,8968079,7506645,0,7506645
15762,Sachin Suresh,52,4343700,4360590079130271,558,7685851,4071842,4072,4067770
15763,Cain Sykes,52,3958400,8547295112107460,433,6569069,1087304,1087304,0
15764,Josh Tomlinson,51,4746900,4396542147115749,568,7789603,1900414,191,1900223
15765,Felipe Valencia,43,3073700,9836101748937298,387,5129249,2972767,298,2972469
15766,Wang Haoran,27,2306500,8461960152078874,232,3493257,881546,8816,872730
15767,Wang Zhenghao,70,1648400,8363038049688619,474,5049046,3108322,31084,3077238
15768,Wang Junqiang,42,2178100,5860924434858180,310,4087895,3046387,304639,2741748
15769,Jude Wellings,56,1118000,6290733376141303,325,3323527,1689589,168959,1520630
15770,Kyle White,56,2854200,8366849207211929,460,5981010,5841165,58412,5782753
15771,Yoon Min Ho,70,1870800,3191768668467231,452,4453981,1791907,1791907,0
15772,Ahn Chang Min,52,2016700,4263730751593650,358,3962497,1477330,1477330,0
15773,Omar Al Kuraidees,56,3711900,5475684999902316,512,6857076,4512137,4512137,0
15774,Farha Al Shamrani,36,1850800,5595492639040560,232,2860692,952199,9522,942677
15775,Bae Soo Min,31,4822900,7531300384536814,460,7344982,6486562,64866,6421696
15776,Luca Chavet,37,667700,8467630085085004,146,1363786,680177,68018,612159
15777,Osvaldo Cisneros,51,2823200,7506700615390026,435,5231087,4581589,0,4581589
15778,Nikhil Deka,68,3937000,6789671255028641,634,8571099,3129438,0,3129438
15779,Jamie Duggan,50,2377400,6499883200528686,412,4768144,2631817,2632,2629185
15780,Sweden Fernandes,24,1096600,3312295244021726,82,1263204,769679,7697,761982
15781,Gao Jian,22,4916100,8724302535815912,364,6575294,5818108,581811,5236297
15782,Ge Yifan,54,4234600,9585233347483557,598,7959648,2275291,22753,2252538
15783,Guo Tong,46,737700,9068627223566537,240,2351437,1839819,1840,1837979
15784,Guo Yunqi,63,557800,3488735386102107,268,2245701,956811,956811,0
15785,Evan Haddock,63,4307400,4649027839941516,620,8004657,597943,598,597345
15786,He Yiran,49,4834700,3314907451227498,589,8599748,262970,26297,236673
15787,Hua Mingcan,51,3086800,5944092601328412,425,5440621,2646837,2647,2644190
15788,Huang Cong,30,3479100,5899058608578259,329,5194979,4138617,0,4138617
15789,Divine Izekor,52,4598800,5789905774274794,542,8103897,6478321,6479,6471842
15790,Jeon Yong Jun,37,4411000,6770149254726174,424,6342941,1686895,16869,1670026
15791,Kang Hyun Je,28,2153500,7961029938398734,198,3374249,1930526,0,1930526
15792,Lee Gyu Baeg,35,3793700,3379585953385575,423,5908671,5434196,0,5434196
15793,Liao Lei,38,3806300,3248423041663395,360,5832847,3272452,0,3272452
15794,Liu Haofan,63,4252400,8917283189518913,595,7958236,4685351,468536,4216815
15795,Harry O'Connor,40,2574400,4569467484078612,278,3900881,343775,0,343775
15796,Callum Ralph,26,2016000,4626007664470865,187,3024465,1358200,13582,1344618
15797,Caleb Roberts,47,3819500,9655084046983017,439,6948020,4675657,468,4675189
15798,Sun Xuelong,69,888700,9078958763224290,319,3070237,2507087,0,2507087
15799,Tang Xu,35,4769500,8287300675389465,490,7470859,4816897,481690,4335207
15800,Wang Hao,55,3867900,9115002626542333,528,6979569,2417671,0,2417671
15801,Yan Yu,55,4931300,8386132452289822,581,8585704,6806901,0,6806901
15802,Zhao Jia'nan,64,4371900,6751101444719566,658,8776860,3942322,3943,3938379
15803,Eyad Al Nasser,62,2952600,5890993487757260,508,6231993,2591785,2591785,0
15804,Chen Guoliang,43,458800,5424330071155839,169,1280487,717024,7171,709853
15805,Nicolas Closset,67,4727200,9288953040975704,618,8884099,1230987,0,1230987
15806,Deng Xiongtao,22,312800,8686646309410985,24,109782,103028,10303,92725
15807,Dennis Egel,26,2479800,8650262974378748,228,3663595,2470385,247039,2223346
15808,Matteo Fiorenza,32,4125300,7161265021276293,407,6237812,549666,0,549666
15809,Hao Haiyi,41,2859500,3913154846435087,398,5147097,5074738,0,5074738
15810,He Youzu,50,568000,5039755371469187,200,1796533,276320,0,276320
15811,Chanso Horam,42,982300,6286121841276162,234,2395922,797097,798,796299
15812,Jin Haoxiang,53,2991200,3081514286009726,402,5130577,1758561,175857,1582704
15813,Tobi Jinad,66,3928800,4298055462186516,530,7040788,5699554,570,5698984
15814,Lai Jinfeng,29,1839500,3779600701618553,204,2819413,289923,28993,260930
15815,Lee Jong Hoon,48,4177500,7244812224740490,470,6694844,2409438,0,2409438
15816,Leng Jixuan,51,4848100,4236549875481844,614,8508385,4695751,46958,4648793
15817,Li Junfeng,65,2028500,9480689927228753,425,4749826,2189261,0,2189261
15818,Li Junju,35,4581400,4049611412854634,438,6783869,5915209,591521,5323688
15819,Lim Jun Sub,57,2622300,9178029471201466,443,5225353,3115216,3115216,0
15820,Liu Jun,64,3201900,3944700355069048,471,5880602,3536950,353695,3183255
15821,Aditya Patra,23,4853400,3172778071347955,386,6505854,919301,919301,0
15822,Qiu Zhongyi,62,2852900,8398625017335928,440,5695197,3396491,3396491,0
15823,Brian Romero,50,3283600,4104530271766257,505,6704406,3324520,333,3324187
15824,Shan Huanhuan,54,3891100,4852074378474476,545,7262810,1488296,1489,1486807
15825,Phijam Singh,37,1753900,4225068958788288,210,2783726,1422814,142282,1280532
15826,Vikram Singh,26,3276000,9232153218625993,251,4348556,3742838,0,3742838
15827,Engson Singh,29,434200,3053389455444059,100,853723,139240,13924,125316
15828,Son Seung Woo,37,984900,5076849071982815,144,1630371,4232,4232,0
15829,Abhishek Suryavanshi,50,3908200,9681169136606945,423,5818916,4269252,426926,3842326
15830,Xiang Rongjun,52,2657400,8909893397997146,377,5036461,239827,0,239827
15831,Xue Tian,32,1219600,9539528308111815,170,2052479,1403668,1403668,0
15832,Xue Qinghao,57,2106600,9273991808770253,410,4873051,3372945,338,3372607
15833,Zhang Yue,66,1704900,4339029162642570,363,3947603,2155729,0,2155729
15834,Zhou Zhengkai,35,2920700,3285052802784350,303,4718692,3630629,0,3630629
15835,Mark Zothanpuia,33,3194400,4389814159196763,341,4633767,978711,979,977732
15836,Jin Liangkuan,54,4437400,9148142263140220,542,7862183,5394645,5395,5389250
15837,Lyu Jiaqiang,45,3978800,9624691155369985,448,6796646,5925456,592546,5332910
15838,Mijit Mewlan,32,3713900,7221593876778322,345,5254993,622356,0,622356
15839,CVL Remtluanga,26,2329400,6904904595535733,215,3482725,2029325,2030,2027295
15840,Deven Sawhney,41,1667100,3368372248440427,234,2850737,1022125,103,1022022
15841,Wang Tengda,60,2946900,5262918168135414,481,5855718,5551473,555148,4996325
15842,Wu Yuhang,33,678800,9830298737946596,103,1027581,60844,0,60844
15843,Ye Daoxin,40,2366400,7669873027367348,286,4031811,589152,589152,0
15844,Yin Jie,35,1709100,7474166387770267,221,2757629,897344,0,897344
15845,Alexia Putellas,30,3599400,6471756979664317,336,4920697,811249,811249,0
15846,Aitana Bonmatí,58,2288100,6316819147540967,382,4636631,1454698,0,1454698
15847,Sam Kerr,53,3722400,5564709278034932,446,5976385,2595944,0,2595944
15848,Caroline Graham Hansen,67,2411300,8890432617033310,448,5478154,1704428,0,1704428
15849,Kadidiatou Diani,30,2492700,9005975416943251,252,3600638,1638232,0,1638232
15850,Mapi León,64,4096000,4617875022461762,603,7322136,583807,584,583223
15851,Alex Morgan,38,1038100,3193276737974745,170,1997026,887047,0,887047
15852,Ada Hegerberg,35,2064100,8589949048695054,231,3158956,2636561,263657,2372904
15853,Irene Paredes,69,1437500,7101457729970601,387,4217753,1873772,188,1873584
15854,Wendie Renard,27,3575400,9538494321971518,318,5262667,900063,90007,810056
15855,Alexandra Popp,34,3559700,5034189969489549,366,5369108,4671693,4672,4667021
15856,Debinha,22,4898700,5868911725289760,397,6380542,446373,4464,441909
15857,Sophia Smith,22,3947400,4967973161123578,348,5364626,3592301,0,3592301
15858,Guro Reiten,63,2584300,9373884922665784,425,5315067,4381051,439,4380612
15859,Christiane Endler,69,1911500,8926070047861226,466,5075742,3753355,0,3753355
15860,Marie Katoto,68,773600,3775379379093615,350,2882917,623844,6239,617605
15861,Patri Guijarro,30,1959400,9035413265975910,198,2891408,895728,0,895728
15862,Fridolina Rolfö,54,3800400,9553927110609221,558,7579615,2388160,238816,2149344
15863,Lucy Bronze,55,4918200,8916387298228031,597,8297775,1620439,163,1620276
15864,Beth Mead,51,2405500,3109580774221264,419,4833103,1012605,1013,1011592
15865,Ewa Pajor,59,871500,7115084865265580,335,3055615,1418305,142,1418163
15866,Lena Oberdorf,57,4716700,5137392125769369,561,7770641,6185343,61854,6123489
15867,Lina Magull,58,2793100,7382005243540159,387,5083200,4367282,4368,4362914
15868,Rose Lavelle,67,3799200,3859080316104476,625,7811699,5101674,51017,5050657
15869,Sandra Paños,65,4584900,8462016181375386,684,8928650,6269127,626913,5642214
15870,Selma Bacha,51,354900,8144920011057342,189,1533647,353849,354,353495
15871,Mary Earps,63,589000,6155441491954601,284,2402397,1961033,197,1960836
15872,Lauren Hemp,51,3310000,7047759962620828,391,5347515,5155493,5156,5150337
15873,Grace Geyoro,65,4090400,9964919891690392,572,8281263,5862390,0,5862390
15874,Jill Roord,52,594900,7499826896542874,214,1732481,1026787,102679,924108
15875,Vivianne Miedema,40,1951800,4034134120244698,301,3966259,134549,1346,133203
15876,Sakina Karchaoui,26,1137700,8613762948788370,133,1706254,678069,679,677390
15877,Lindsey Horan,40,1533400,9233251746513525,208,2783741,1691316,170,1691146
15878,Kim Little,64,2472800,8855963564876702,487,5328911,2702893,2702893,0
15879,Lea Schüller,52,4075300,5803256223181469,504,7491944,2817060,281706,2535354
15880,Ashley Lawrence,46,1348800,6767988635346996,249,2801604,1151724,116,1151608
15881,Mallory Swanson,29,4967900,5378926115349548,488,8262581,3204407,3204407,0
15882,Cristiana Girelli,48,940200,5089693774562465,228,2181407,604193,604193,0
15883,Ona Batlle,31,1159800,4013455649207597,165,1984223,1922335,19224,1903111
15884,Millie Bright,55,2854800,5783867099179656,479,6160201,4535005,454,4534551
15885,Kadeisha Buchanan,38,1375800,7634033228318236,232,2714950,1861506,18616,1842890
15886,Rachel Daly,52,717200,5600526704752802,246,2318513,229634,229634,0
15887,Merle Frohms,67,1236800,6246920197146122,308,3165415,2582831,2582831,0
15888,Kathrin Hendrich,55,3060300,7659328118606410,432,5690234,2040462,0,2040462
15889,Amandine Henry,36,4168600,6317588617939187,392,6487606,5711899,5712,5706187
15890,Svenja Huth,55,1621300,8427728743466782,329,3783374,738014,7381,730633
15891,Katie McCabe,57,4443900,9721848918137005,565,7921957,2651666,265167,2386499
15892,Asisat Oshoala,62,1956800,9055440244779084,390,4508161,3632537,36326,3596211
15893,Megan Rapinoe,57,2423500,6721228622987029,400,4992260,1686290,168629,1517661
15894,Becky Sauerbrunn,68,2891700,4313067035095046,510,6242419,3457173,3457173,0
15895,Khadija Shaw,34,4623800,7108503553348244,457,7126936,6032063,0,6032063
15896,Kailen Sheridan,39,1260200,9373696468566738,201,2411101,2230486,2231,2228255
15897,Keira Walsh,44,3854700,3147290907663121,420,6411854,3832340,383234,3449106
15898,Leah Williamson,48,2719100,7822128485425162,358,4963546,1086298,1086298,0
15899,Manuela Zinsberger,49,3063000,9205960170625674,481,6224885,4605215,0,4605215
15900,Ann-Katrin Berger,44,2827000,3343309404962570,381,5240766,3114878,31149,3083729
15901,Bella Bixby,43,2280100,5954572809991818,289,4050323,3499906,35000,3464906
15902,Lisa Boattin,55,1462800,5577726086124696,328,3430320,637174,638,636536
15903,Jane Campbell,67,1257400,7054357669120844,340,3282464,57471,575,56896
15904,Catarina Macario,31,704000,6705339511316309,114,1191963,31526,31526,0
15905,Delphine Cascarino,45,3865400,5119431521698498,445,6650041,1802902,0,1802902
15906,Sara Däbritz,27,2103400,4382094747399016,207,3198947,2316638,23167,2293471
15907,Linda Dallmann,61,2381900,4306006519308264,390,4729973,4395206,0,4395206
15908,Paulina Dudek,55,3024700,9189342716525695,425,5591991,2220287,0,2220287
15909,Crystal Dunn,42,3843800,5998855810638330,457,6684477,3716142,0,3716142
15910,Jess Fishlock,46,1724100,7924879913721354,280,3578024,3422692,0,3422692
15911,Caitlin Foord,49,592700,4430371976434485,204,1790363,1600838,161,1600677
15912,Pernille Harder,48,3289200,6082243546553180,473,6274036,1654770,166,1654604
15913,Amanda Ilestedt,63,4471600,4564009219501577,532,7254209,5718415,572,5717843
15914,Chloe Kelly,36,3431200,3653046119378175,396,5612733,3671718,0,3671718
15915,Aubrey Kingsbury,53,3582500,5392455174582864,421,5638242,1874831,0,1874831
15916,Fran Kirby,60,1808200,8016962985904999,340,3945607,3369018,3369018,0
15917,Eugénie Le Sommer,44,2351300,7396253029214437,352,4854729,4312740,0,4312740
15918,Amel Majri,55,1838500,4664536558185217,329,3810967,2828324,282833,2545491
15919,Lieke Martens,54,1638500,4978738942240805,321,3735168,2180915,2180915,0
15920,Clara Mateo,65,3554800,5152918083735406,587,6876345,2411839,242,2411597
15921,Yuki Nagasato,34,4896400,8529509535885495,416,7017498,1638705,1639,1637066
15922,Ashleigh Neville,25,1924100,7737860641244955,206,3054444,2823927,2823927,0
15923,Chiamaka Nnadozie,69,1920400,6936631182444800,426,4626736,3076617,307662,2768955
15924,Trinity Rodman,59,4171100,3169624976278615,584,7480283,7014385,702,7013683
15925,Alessia Russo,59,1015800,9799427050429786,322,3074511,1010101,10102,999999
15926,Desiree Scott,36,3616300,7239223249925619,356,5815186,2677146,0,2677146
15927,Georgia Stanway,31,3561600,9331759975226537,359,6009816,2167483,2167483,0
15928,Marta Torrejón,35,1818600,7326270619712182,198,2620212,1769568,1770,1767798
15929,Marta,54,3618100,7935978797462807,448,6268071,3638387,0,3638387
15930,Caroline Weir,61,1422400,3986676826218094,314,3280979,1408209,141,1408068
15931,Rasheedat Ajibade,33,1925500,5580687902371178,210,2914693,1575810,15759,1560051
15932,Hannah Blundell,29,3170000,4996364766782982,287,4860462,2534529,253453,2281076
15933,Barbara Bonansea,63,2433900,3672216164344143,432,5370424,4680355,468036,4212319
15934,Mathilde Bourdieu,52,309700,6717314540901275,190,1472212,1057079,105708,951371
15935,Klara Bühl,23,3898200,6913116638891818,293,5315940,1828742,182875,1645867
15936,Ellie Carpenter,60,2611500,4294797753427162,440,5626906,4065591,4066,4061525
15937,Arianna Caruso,23,1100500,6306643113835943,83,1341929,253046,0,253046
15938,Steph Catley,28,3740700,8960476071973105,323,5507891,3526303,353,3525950
15939,Erin Cuthbert,64,4336700,8790069385153197,621,8041465,589475,0,589475
15940,Ludmila,69,3320600,5395876058238053,506,6757523,3910744,39108,3871636
15941,Sara Doorsoun,40,1338900,7538898851356065,193,2191830,714700,7147,707553
15942,Magdalena Eriksson,58,3734200,3394726638285224,595,8188068,2723846,273,2723573
15943,Adrianna Franch,33,2382500,8022273635011713,263,3703856,2275284,2275284,0
15944,Laura Freigang,68,2298600,3226886410315201,468,5635696,782035,0,782035
15945,Leah Galton,63,884500,3837014038297779,291,2596683,1658595,16586,1642009
15946,Vanessa Gilles,29,4940600,3960924418843442,444,7571623,981709,982,980727
15947,Alex Greenwood,29,2342600,7481186280826288,216,3627208,1867105,0,1867105
15948,Giulia Gwinn,69,1414800,8169788695182877,428,4499613,1406673,0,1406673
15949,Marina Hegering,33,549800,7791770872904529,114,1004737,563168,56317,506851
15950,Lauren James,31,4188800,3366895539223633,429,6995968,6042660,0,6042660
15951,Dominique Janssen,44,361000,8371203075554889,137,1089951,911907,0,911907
15952,Meghan Klingenberg,53,794600,6206120249474782,254,2421710,2194971,0,2194971
15953,Racheal Kundananji,27,3002100,5426606618301759,289,4602761,2324837,2325,2322512
15954,Dzsenifer Marozsán,47,891800,3828532214743499,224,2133392,759686,75969,683717
15955,Griedge Mbock,41,3045900,7172619701743340,358,5034440,3957526,0,3957526
15956,Casey Murphy,56,3995000,6924408231504213,491,6971478,6862780,0,6862780
15957,Alyssa Naeher,41,1730600,7651111511214659,291,3239797,1584546,15846,1568700
15958,Katharina Naschenweng,29,2286700,7251889315891184,236,3387110,217362,217362,0
15959,Kelley O'Hara,47,1763600,6239876860387414,285,3635658,3073803,0,3073803
15960,Pauline Peyraud-Magnin,43,4207100,3942834336004331,462,7224444,4029940,4030,4025910
15961,Claudia Pina,26,4362300,8499372485675503,391,6462455,1817791,182,1817609
15962,Lara Prašnikar,47,4739000,5690803423521123,564,8622474,3804912,3804912,0
15963,Christen Press,35,2539400,9341100839925906,291,3938228,1112692,11127,1101565
15964,Mayra Ramírez,34,4740000,3002604319787620,450,6733995,3114656,312,3114344
15965,Felicitas Rauch,28,4172600,3964278945177692,403,6459296,5328925,53290,5275635
15966,Martina Rosucci,52,4782300,8667559674492513,504,7018305,3188353,319,3188034
15967,Sophie Schmidt,31,3401900,7148147509947086,317,4814641,1946403,195,1946208
15968,Tabea Sellner,49,1697700,9822367582811118,307,3456852,1182579,118258,1064321
15969,Christine Sinclair,35,3774200,9731032399646244,341,5343924,2061180,0,2061180
15970,Sherida Spitse,51,2814800,6857290396594503,371,5111062,4487633,4488,4483145
15971,Ella Toone,62,4230200,9642179066460655,567,7606726,1840529,18406,1822123
15972,Glódís Perla Viggósdóttir,69,2267200,7436240775338204,410,4450849,1296732,129674,1167058
15973,Lia Wälti,38,4348900,5826047564386936,419,6644583,3425754,34258,3391496
15974,Lynn Williams,60,1005300,9419973462660746,316,2948678,863209,86321,776888
15975,Ramona Bachmann,27,888800,9781821861881541,105,1200016,338610,33861,304749
15976,Sandy Baltimore,52,2215400,9820003230784504,387,4710069,2617953,0,2617953
15977,Lineth Beerensteyn,51,2691400,4690006662409608,353,4433808,3835457,0,3835457
15978,Nicole Billa,63,1275400,8213964902439919,387,3547705,2177595,21776,2155819
15979,Alana Cook,25,2480000,7238630015942163,223,3784003,1945132,1945132,0
15980,Ana-Maria Crnogorčević,67,2598000,7669282078086986,430,5127429,3018419,0,3018419
15981,Kenza Dali,24,3949900,6941006013050752,323,5733702,1658454,1658454,0
15982,Vanessa DiBernardo,50,3936800,7369802882656295,442,6767472,4701516,470152,4231364
15983,Damaris Egurrola,35,4134400,9962523169720127,375,6292709,941371,941371,0
15984,Nerea Eizagirre,26,4945300,9616485741230998,457,6875672,4911875,0,4911875
15985,Jun Endo,40,987000,3629667378189082,197,2177574,1838615,184,1838431
15986,Ingrid Syrstad Engen,33,4210900,9693560263441487,376,6332561,2545658,254566,2291092
15987,Bethany England,35,1988200,5449382161131267,210,3120101,462801,0,462801
15988,Paula Fernández,67,1714600,9059443265043918,407,4501561,3241827,325,3241502
15989,Gabriela García,58,1360900,7407568915730037,327,3260570,1212294,122,1212172
15990,Théa Gréboval,58,4569500,4958472440604595,595,7761179,917096,918,916178
15991,Chantal Hagel,53,4635600,4327351024612075,573,7754417,935641,0,935641
15992,Yui Hasegawa,58,3237500,3566270738376033,494,6196220,3063008,3064,3059944
15993,Ashley Hatch,65,1559200,9228992806373389,347,3801786,3448358,3448358,0
15994,Sofia Huerta,41,1082000,7084238785006072,190,2232068,221124,0,221124
15995,Sofia Jakobsson,23,1051900,4707249918976966,66,1104571,865936,0,865936
15996,Sveindís Jane Jónsdóttir,48,2238700,5653239935106840,337,4166810,3686196,0,3686196
15997,Ali Krieger,55,439100,3930800009477840,204,1671477,4002,4002,0
15998,Katie Lind,39,1393000,3755325983402572,213,2567429,252355,0,252355
15999,Sydney Lohmann,68,1073300,5237319115669390,377,3582598,2674515,26746,2647769
16000,Frida Maanum,62,4470400,8709330077309907,590,8687497,5083797,0,5083797
16001,Hailie Mace,49,3013800,7851792387282990,417,5863586,5038263,503827,4534436
16002,Melvine Malard,67,4876600,6660671986592735,664,8598904,483835,48384,435451
16003,Perle Morroni,67,4213800,4243036402306556,652,8553120,297040,297040,0
16004,Leila Ouahabi,55,2003900,7343193488571084,334,3918996,447050,447050,0
16005,Tanja Pawollek,50,4837000,6281948115575357,599,8733835,8347785,8347785,0
16006,Ève Périsset,66,1559500,5279309512039753,330,3692534,3285443,329,3285114
16007,Carson Pickett,29,4793600,9457954844403005,420,7687966,4121906,0,4121906
16008,Alba Redondo,31,3290300,3149057329990564,341,5111070,4381218,439,4380779
16009,Rocky Rodríguez,66,2316900,4891408835816985,397,4977300,909787,9098,900689
16010,Misa,47,2747000,7565680860300653,324,4739197,3513619,352,3513267
16011,Ashley Sanchez,49,3730100,8630374307315924,424,6399240,5020470,0,5020470
16012,Ouleymata Sarr,56,1519400,9329153816659969,312,3581978,2505499,0,2505499
16013,Amaiur Sarriegi,34,1692200,6181869689839425,216,3004917,85568,856,84712
16014,Olivia Schough,25,3230500,3221256388416497,267,4475553,4386756,0,4386756
16015,Caroline Seger,22,1743200,4156178664086244,112,2001754,515190,0,515190
16016,Linda Sembrant,55,2608200,8752830461349502,393,5046255,268885,0,268885
16017,Carolin Simon,54,4476100,6966983190716657,513,7169543,7123914,71240,7052674
16018,Emily Sonnett,69,711100,9180248900401670,288,2713464,1878889,18789,1860100
16019,Ángela Sosa,34,410400,3251586458790748,100,776668,373695,0,373695
16020,Hina Sugita,23,2166500,9118891912870456,165,2851390,986194,986194,0
16021,Gaëtane Thiney,29,3916000,8193279394348959,383,6496651,491819,492,491327
16022,Daniëlle van de Donk,44,862000,5649762918464557,186,1873419,899645,0,899645
16023,Emily van Egmond,63,4584000,4073866015062923,631,8410916,4215205,4215205,0
16024,Manuela Vanegas,22,2770000,8393612603922404,233,3793026,833852,833852,0
16025,Katie Zelem,30,2722700,3378006125094296,273,4268750,2083298,0,2083298
16026,Nataša Andonova,42,992200,3543297590098220,154,1675028,1100156,1100156,0
16027,Lauren Barnes,56,1253800,9618630475989077,281,2968450,747665,748,746917
16028,Charlotte Bilbault,64,816400,9457213889087280,284,2603971,260911,0,260911
16029,Stina Blackstenius,51,3031900,8176068340148771,391,5211154,808700,8087,800613
16030,Jule Brand,67,2537200,5419820037131922,519,6423014,3973820,3973820,0
16031,Mariona,27,4299800,6150174017129914,399,6548998,3003190,301,3002889
16032,Viola Calligaris,64,2941700,7418076754516101,455,5661449,869197,8692,860505
16033,Danielle Colaprico,50,1614700,7995765764863893,300,3355846,2483466,0,2483466
16034,Daphne Corboz,39,4611400,3935052324798507,463,7591973,2062939,206294,1856645
16035,Geyse,62,568500,9472337723233882,273,2136299,1115412,112,1115300
16036,Elisa De Almeida,57,712000,8588089384334296,240,2213990,2152275,216,2152059
16037,Athenea,31,1795800,7594996953215813,211,3030385,2824568,0,2824568
16038,Melchie Dumornay,66,3453000,9202719434990325,577,7189729,242193,0,242193
16039,Abby Erceg,50,1781400,5285000448004915,321,3966625,961313,961313,0
16040,Emily Fox,22,4814500,8012077980689420,362,7141871,2471030,2471030,0
16041,Sara Gama,39,1500000,5083305081104720,203,2659194,2502969,2502969,0
16042,Hanna Glas,28,3388900,5843353081825471,312,5167284,4065197,0,4065197
16043,Esther González,28,1669800,4182220889106799,175,2571189,1253542,12536,1241006
16044,Verena Hanshaw,24,418000,8145917237263067,68,571600,414990,41499,373491
16045,Rachel Hill,46,1914700,3806854537026917,255,3330750,3063434,0,3063434
16046,Synne Jensen,23,4898800,5480928476732693,427,7180245,3429234,3430,3425804
16047,Ewelina Kamczyk,36,4935400,6241480309211845,539,8064139,1420591,143,1420448
16048,Lo'eau LaBonta,39,2629100,8744588002166269,290,4288963,21951,220,21731
16049,Hayley Ladd,25,2226500,3492071227230619,165,2892164,2594544,260,2594284
16050,Lena Lattwein,35,367800,5286207489876315,100,766602,735219,7353,727866
16051,Maya Le Tissier,49,396600,5992730805735652,167,1338036,259208,2593,256615
16052,Alisha Lehmann,42,2835300,7269600110107869,352,4719896,566198,0,566198
16053,Sydney Leroux,45,3234400,7967860475205278,414,6125286,3895475,0,3895475
16054,Melanie Leupolz,68,4476800,7559583150816367,569,8036616,7077896,0,7077896
16055,Tatumn Milazzo,46,4147300,7647063345640703,495,6970347,747033,0,747033
16056,Janina Minge,47,2741100,8188422468475586,348,4798136,1798385,1799,1796586
16057,Jordan Nobbs,67,4606900,6527671138466030,706,8899921,8043741,805,8042936
16058,Gabi Nunes,35,4883700,3175558426594912,443,7813140,2718284,272,2718012
16059,Mayumi Pacheco,51,3391300,7215105263808545,471,6348467,5366428,0,5366428
16060,Nikita Parris,29,477300,5850336703437252,55,527410,21330,2133,19197
16061,Midge Purce,60,3872600,7119340510806342,534,7520343,3461039,0,3461039
16062,Cecilia Salvai,33,2854200,3054502820905403,291,4773745,3549243,0,3549243
16063,María Sánchez,45,1168700,4003040154985859,238,2729745,1907061,190707,1716354
16064,Andi Sullivan,63,3307500,7171600335780282,476,6573232,5618925,562,5618363
16065,Nicole Anyomi,60,2001900,6157135976825488,397,4441131,234044,234044,0
16066,Viviane Asseyi,52,2746800,4545247267182695,372,5058662,2980567,0,2980567
16067,Leire Baños,25,1901300,8306035114191151,176,2707204,735232,0,735232
16068,Laura Benkarth,69,1200400,9202520527314557,426,3876965,806192,8062,798130
16069,Kessya Bussy,63,4600200,9267014152335634,531,7796073,6024398,6024398,0
16070,Deyna Castellanos,38,2815400,8010131939632938,303,4384566,213484,21349,192135
16071,Niamh Charles,62,3986700,4494252785499923,520,7292594,6956081,69561,6886520
16072,Antônia Silva,59,3145500,8621702709855572,461,5476095,5415130,0,5415130
16073,Marine Dafeur,57,605200,9406917750857584,262,2364119,79440,7944,71496
16074,Abby Dahlkemper,46,2991800,9469369055088568,385,4903956,283536,28354,255182
16075,Tierna Davidson,28,448500,8396103842406984,86,702681,591279,591279,0
16076,Tainara,53,3451500,7101238837115321,469,6171095,2350896,2350896,0
16077,Océane Deslandes,37,2069200,6228098930347878,249,3321425,2226929,0,2226929
16078,Jessie Fleming,54,1836900,4031467187704833,327,3845859,2380114,0,2380114
16079,Lola Gallardo,33,2167000,5430352456222639,237,3355513,3327569,0,3327569
16080,Maëlle Garbino,58,491400,4432926787402082,257,1952962,1385808,138581,1247227
16081,Lucía García,40,519400,6685869525103164,157,1274727,1070465,0,1070465
16082,Naomi Girma,24,4078300,5915386923767696,378,6055055,2157433,0,2157433
16083,Didi Haračić,48,1243900,4444666641110457,230,2347907,1428965,142897,1286068
16084,Sophie Ingle,31,2390400,4805789459131953,233,3890498,1645120,0,1645120
16085,Kerolin Nicoli,25,4397200,4088182780729610,369,6424825,1824801,183,1824618
16086,Oriane Jean-François,36,906200,4642970168670425,162,1780421,64676,0,64676
16087,Lisa Karl,37,1360300,9783341150177143,186,2156122,432651,0,432651
16088,Hasret Kayikci,52,1668500,8262396966862491,332,3870365,3722998,0,3722998
16089,Sophia Kleinherne,58,2686100,5475472169814356,422,4893025,1412843,1412843,0
16090,Emma Koivisto,26,4795000,5095612305488730,418,7241435,6550517,656,6549861
16091,Rosemonde Kouassi,66,2847900,4549270957446640,494,5774722,1438529,1439,1437090
16092,Maëlle Lakrar,34,4520200,8518841643365036,456,7658963,6231376,6231376,0
16093,Léa Le Garrec,64,499700,6119275955720825,266,2274344,610919,0,610919
16094,Merritt Mathias,62,843500,5815877541723577,295,2871715,136232,0,136232
16095,Erëleta Memeti,46,2099600,4980142040447403,308,3883101,3695786,36958,3658828
16096,Carmen Menayo,40,3569600,6932112309163928,374,5826640,2438260,2439,2435821
16097,Sam Mewis,62,1704500,8340293282987805,366,3985122,1326234,1327,1324907
16098,Sjoeke Nüsken,52,3631000,3163697880123794,479,6327092,6134427,613443,5520984
16099,Denise O'Sullivan,30,3384400,4142666718005935,288,4669444,2322488,233,2322255
16100,Géraldine Reuteler,61,2224700,7433230628443718,420,4874311,1450254,146,1450108
16101,Faustine Robert,67,3484000,4230381326932927,517,6700293,3410904,342,3410562
16102,Elisa Senß,68,2256600,9805775498454736,504,5495508,1028056,1029,1027027
16103,Sandie Toletti,43,2573200,6985042299619127,357,4516295,666589,6666,659923
16104,Marion Torrent,45,2984900,7725522847480554,372,5026268,430124,430124,0
16105,Phallon Tullis-Joyce,56,4132300,3052255790541894,511,7289044,1122917,112292,1010625
16106,Morgan Weaver,45,1621300,6509379214068017,252,3185504,2029858,0,2029858
16107,Christen Westphal,39,1286200,5348810962626091,208,2525806,1641027,1642,1639385
16108,Sarah Zadrazil,28,2839600,4700253183478584,268,4612248,997098,9971,987127
16109,Sara Agrež,32,2066200,3468469411895560,248,3396513,1448721,14488,1434233
16110,Emily Alvarado,32,1824600,6237908848043130,185,2515333,1146052,11461,1134591
16111,Mackenzie Arnold,61,4745800,5572373463548178,626,8150078,2489518,24896,2464622
16112,Elizabeth Ball,59,3660700,3955012207189821,491,7120537,6275635,6276,6269359
16113,Estefanía Banini,61,1864800,3628684957781406,380,4084553,2553923,256,2553667
16114,Molly Bartrip,62,4294800,4583272325850994,610,8223481,5945536,0,5945536
16115,Vicki Becho,26,4651900,7189088542096678,373,6249838,2902924,0,2902924
16116,Sharon Beck,60,4297300,5267123255655224,543,7319059,5649481,56495,5592986
16117,Janine Beckie,53,3623600,9034356804123420,486,6805579,1058480,106,1058374
16118,Nathalie Björn,46,2056100,5986159810007210,336,4007111,1703729,17038,1686691
16119,Florencia Bonsegundo,65,3119000,7394083292209573,491,6240031,3936593,3936593,0
16120,Dagný Brynjarsdóttir,47,1992100,6865332586065444,283,3808133,3363265,33633,3329632
16121,Jelena Čanković,59,2818900,7954784470577364,398,5007362,4233672,424,4233248
16122,Marta Cardona,54,3054200,3445903311321642,482,6199987,399774,3998,395776
16123,Olga Carmona,34,2901400,5496736530021850,350,4819461,1843880,1843880,0
16124,Grace Chanda,63,555400,4102700956463393,332,2677537,702087,0,702087
16125,Allysha Chapman,29,4543200,9198917592650812,417,6779343,3108813,31089,3077724
16126,Mylène Chavas,31,1020100,9945722716009764,127,1543094,54422,0,54422
16127,Hawa Cissoko,24,3955100,9415831133694287,346,5513577,190378,0,190378
16128,Sam Coffey,67,3364300,4370035013147231,577,6746992,6060285,0,6060285
16129,Aldana Cometti,29,2919700,4608614674652267,276,4183349,3842648,384265,3458383
16130,Rachel Corboz,52,4533100,6326239337860605,564,8047211,179084,179084,0
16131,Jovana Damnjanović,30,2839400,7869278397575697,264,4206747,2436295,243630,2192665
16132,María De Alharilla,46,2194000,9061888410425283,319,4256465,2411751,2412,2409339
16133,Kristin Demann,56,3800500,9466502092486634,527,7335350,653653,65366,588287
16134,Makenzy Doniak,57,4278300,8591048207792711,498,7172616,5853436,0,5853436
16135,Julie Dufour,31,4588900,5577025330846514,427,7168142,4057245,4057245,0
16136,Barbara Dunst,66,1826000,9236038156069139,384,4549441,1274592,1275,1273317
16137,Kristen Edmonds,61,4738500,5037112787753861,616,9192298,4462665,447,4462218
16138,Nicky Evrard,68,1430900,3317976352457216,385,3758570,410798,410798,0
16139,Meret Felde,45,2818800,9335557061769220,387,5230851,3470260,3471,3466789
16140,Jana Feldkamp,62,571600,3473340429456662,257,2191615,1851821,1852,1849969
16141,Naomie Feller,23,861800,9193134130457431,69,927866,500305,0,500305
16142,Louise Fleury,64,3215600,7004914289641045,511,6542595,6285965,6285965,0
16143,Svenja Fölmli,60,1642700,4925937660575655,326,3569607,213238,2133,211105
16144,Sanni Franssi,64,2116200,9233067438463930,433,4766394,4611036,0,4611036
16145,Sheila,36,1950100,5569818051831608,232,3388534,2997822,299783,2698039
16146,Gemma Gili,25,2153000,7006022859040896,221,3188660,1373947,138,1373809
16147,Ana González,23,2785900,9994322628465270,268,3782734,1408596,140860,1267736
16148,Dominika Grabowska,32,3755800,3356980044684013,328,5651780,4662024,467,4661557
16149,Jackie Groenen,66,1738100,8757474026077239,450,4397509,279427,0,279427
16150,Maria-Luisa Grohs,22,4456600,4471951170184303,332,6579876,4371147,0,4371147
16151,Shea Groom,30,1506500,9083818021035866,174,2321320,558038,559,557479
16152,Isabella Hartig,45,4081700,5188454457702121,488,6837269,1819938,1819938,0
16153,Steph Houghton,37,4341900,8588133016080520,487,7120056,322856,322856,0
16154,Lina Hurtig,58,1270200,9594205617379559,336,3540763,1911004,19111,1891893
16155,Stina Johannes,22,2427900,9311402940648406,180,2923891,911760,0,911760
16156,Lisa Kolb,32,3659400,8753085011422235,315,5430233,2582082,259,2581823
16157,Taylor Kornieck,70,4332000,4817446962455204,658,8736646,650617,650617,0
16158,Melissa Kössler,45,2548000,8345010223699393,370,5037883,600945,6010,594935
16159,Natalia Kuikka,29,3211800,8283476317473569,333,4610891,6707,0,6707
16160,Andréa Lardez,34,625800,3401209956617278,136,1375458,1252276,125228,1127048
16161,Elene Lete,38,1345000,7945457281811257,232,2595478,678467,6785,671682
16162,Marie Levasseur,32,827000,4505844973400228,144,1533291,486327,4864,481463
16163,María Valenzuela,31,4379700,6217046842457350,460,7424913,3648760,3649,3645111
16164,Katie Lund,66,2191200,6638598541754854,416,4944568,3259543,3260,3256283
16165,Noëlle Maritz,53,736100,6094048568182932,250,2093698,45330,0,45330
16166,Sarah Mayling,42,4176200,3137911232667131,475,7256665,5379707,53798,5325909
16167,Savannah McCaskill,66,3186700,6575165176942199,582,6816582,3259653,32597,3227056
16168,Jessica McDonald,28,2450600,5440886107246691,228,3488386,22105,2211,19894
16169,Kristen McNabb,49,4875300,5609657157443841,578,8594897,523461,0,523461
16170,Andrea Medina,54,3297400,5197771313701079,438,6208870,1941058,194106,1746952
16171,Nuria Mendoza,24,452600,3977342460162471,59,480872,380884,38089,342795
16172,Kristie Mewis,38,4809000,8320342500596347,467,6891789,1417271,1418,1415853
16173,Nérilia Mondésir,51,2297400,3255368917977357,335,4277093,1993064,200,1992864
16174,Marie Müller,50,813300,4564694950021262,240,2326478,704877,0,704877
16175,Adriana Nanclares,57,2679800,4480140233492707,460,5466800,3950033,39501,3910532
16176,Ifeoma Onumonu,54,4266800,8345896713754556,540,7230341,853902,8540,845362
16177,Diana Ordóñez,63,1327800,7500346282177680,398,3709427,1860197,187,1860010
16178,Andreea Părăluță,56,2143800,3288207764251276,399,5067489,3453760,3453760,0
16179,Julie Pasquereau,33,1861400,4011251195480770,218,2784498,1993813,1993813,0
16180,Lena Petermann,43,4871100,7100263646667555,564,8144404,7051543,7052,7044491
16181,Constance Picaud,35,1461000,3813673266457526,204,2446532,867259,867259,0
16182,Itziar Pinillos,60,1693500,7256994742365798,405,4533100,2785175,278518,2506657
16183,Nichelle Prince,46,3427400,3003137648701311,429,5846943,3014437,30145,2984292
16184,Maximiliane Rall,66,2138700,7332747391365438,398,4398474,3652705,3653,3649052
16185,Cinta Rodríguez,53,1801600,9694336330583712,308,3725168,77563,77563,0
16186,Ellie Roebuck,63,3232500,6817218516064777,473,6285864,2117726,212,2117514
16187,Ebony Salmon,29,4963200,8005451675507831,444,8149720,3009134,0,3009134
16188,Leicy Santos,33,906300,3045411403045940,160,1768710,1704703,1704703,0
16189,Letícia Santos,27,2665400,3578660927212415,244,3959142,1345986,134599,1211387
16190,Risa Shimizu,44,3734000,3768448262472617,443,6760827,941096,942,940154
16191,Katja Snoeijs,58,4634700,6861020818717092,567,7871597,2261863,2262,2259601
16192,Kathellen Sousa,49,490000,7518424843173225,203,1709807,1620244,162025,1458219
16193,Michaela Specht,36,897500,6717657997729348,165,1738443,888719,8888,879831
16194,Sofie Svava,62,3568000,5770679678851476,506,6210626,3881115,0,3881115
16195,Kateřina Svitková,37,3721600,3007031342390138,365,6194752,3403498,3403498,0
16196,Paula Tomás,27,477900,9921180957383257,81,647644,224864,0,224864
16197,Ainhoa Moraza,54,1940100,5875926389507405,306,3819734,1531996,1532,1530464
16198,Wang Shuang,55,2398900,4015720660250258,419,5186375,3266553,3267,3263286
16199,Arin Wright,68,1273700,4625301963136172,346,3537334,2828118,282812,2545306
16200,Lotte Wubben-Moy,50,4767300,7370440239942791,516,8501630,3503923,350393,3153530
16201,Shelina Zadorsky,69,4935800,8363614212116993,732,9414574,9370481,0,9370481
16202,Weronika Zawistowska,23,4435200,9181105542213060,391,6480545,281958,281958,0
16203,Claudia Zornoza,47,4382000,3570500616886620,507,7823221,6990449,700,6989749
16204,Tere Abelleira,25,3157200,6763365829701353,255,4518208,4289164,429,4288735
16205,Ivana Andrés,38,1604600,8776398717141466,189,2578195,637001,637001,0
16206,Iris Arnaiz,49,2174700,9100403621882924,346,4260710,2997870,2997870,0
16207,Emily Boyd,26,3012000,7411488545175584,298,4547777,1520903,153,1520750
16208,Pauline Bremer,68,4596800,8792339061146005,566,8412410,1108120,111,1108009
16209,Signe Bruun,67,3869100,8425020697386261,560,7637001,1292870,129287,1163583
16210,Jess Carter,64,366400,9219188598005559,299,2169636,782514,783,781731
16211,Cata Coll,23,3878700,3074297945663325,348,5805736,3333140,0,3333140
16212,Laura Coombs,29,1248000,7864364990280432,164,1967865,1208910,121,1208789
16213,Savannah DeMelo,23,497300,5791294006143568,34,360866,151514,152,151362
16214,Aida Esteve,50,3460800,3308126571772935,454,6253091,2048878,0,2048878
16215,Lisa Evans,46,2522600,8882042099467204,377,4814661,1159025,0,1159025
16216,Laurina Fazer,34,4781500,6794168259757112,497,8172930,626501,6266,620235
16217,Nahikari,30,1133600,4819124139766702,146,1861544,1788039,179,1787860
16218,Morgan Gautrat,27,4909800,4845644539574784,468,7822372,1848123,1849,1846274
16219,Lee Gibson,52,3972500,7152038056226932,524,7012691,2606133,261,2605872
16220,Julia Grosso,50,4042300,6170535388007017,471,7102490,3150546,0,3150546
16221,Sara Björk Gunnarsdóttir,40,3141600,5484666743789593,359,5153381,2117948,2118,2115830
16222,Kirsty Hanson,28,4195000,4272637550888195,387,6483574,4928138,4928138,0
16223,Honoka Hayashi,41,1894800,9874558348122030,265,3411689,2599835,25999,2573836
16224,Manon Heil,43,2689600,5743612006540718,369,4800064,4031207,4032,4027175
16225,Oihane Hernández,28,755300,5447833367069896,98,1069667,79500,0,79500
16226,Giovanna Hoffmann,53,4636300,4734594290743873,607,8322972,672179,6722,665457
16227,Kelli Hubly,60,1759800,8571463276089478,395,4362700,518356,0,518356
16228,Nikola Karczewska,55,4736700,9987117011766263,638,8796346,3872853,388,3872465
16229,Katarzyna Kiedrzynek,28,4639000,4443205036688588,382,6798788,4586473,4587,4581886
16230,Lee Geum Min,33,2901500,4977001093534870,310,4557685,4359679,4360,4355319
16231,Martina Lenzini,42,1433800,3263761095187185,212,2487603,2024263,20243,2004020
16232,Sarai Linder,56,2039900,7889225416955094,356,4466022,763719,7638,756081
16233,Rosa Márquez,30,3357300,7249457949916537,324,5111725,3424755,342476,3082279
16234,Martín-Prieto,36,1372600,4812303927489840,212,2561766,1358312,135832,1222480
16235,Asun Martínez,54,3841800,9837046371785473,488,6731394,1726345,173,1726172
16236,Zećira Mušović,63,1620100,5627099358754075,377,4335565,4330714,0,4330714
16237,Amanda Nildén,26,3892700,6119859239320254,320,5294513,3118992,3118992,0
16238,Aniek Nouwen,22,4833500,9657489392440014,360,6387192,3614383,3614383,0
16239,Maite Oroz,53,3270300,6501740008561851,468,6310852,3303754,0,3303754
16240,Sonia Ouchene,44,2207200,7234170475654522,302,3823946,1914182,1914182,0
16241,Ella Palis,38,4423300,6412890079279840,454,6808357,2239419,0,2239419
16242,Salma Paralluelo,44,3130400,7422359502386944,394,5578433,841188,842,840346
16243,Jess Park,69,4065600,7776110874180148,555,7391641,3253818,0,3253818
16244,Laëtitia Philippe,63,1469700,4715884697374124,386,4014008,3836599,38366,3798233
16245,Ally Prisock,56,4258400,9846313486869949,521,6974184,6594419,660,6593759
16246,Hayley Raso,50,1383600,6978172111301906,287,3165459,1064073,107,1063966
16247,Ali Riley,48,3531500,8508620236063641,445,6421913,1410740,0,1410740
16248,Kenti Robles,30,3220000,9079840993433697,326,5155986,2633781,0,2633781
16249,Yazmeen Ryan,47,1021500,8231741922426541,251,2385179,755470,756,754714
16250,Amanda Sampedro,60,1881000,7391614042475971,351,4043332,251844,25185,226659
16251,Lisa Schmitz,60,2360300,4065498548779844,421,5118988,3992311,400,3991911
16252,Jéssica Silva,44,4436100,9246524214688219,453,6717147,5071892,0,5071892
16253,Abby Smith,62,1269000,3724712356230972,314,3345077,1069076,1070,1068006
16254,Julie Soyer,41,813700,7375447842964459,191,1773634,745523,746,744777
16255,Sam Staab,45,2309800,6376192882666721,295,4199631,623575,624,622951
16256,Demi Stokes,42,1130400,6060008386945657,203,2188306,1283082,128309,1154773
16257,Chantelle Swaby,28,4977000,6306489315777992,428,7296534,5492648,5492648,0
16258,Aïssatou Tounkara,44,2783100,5310784247779410,409,5266845,2798110,27982,2770128
16259,Martina Tufeković,46,362200,3508326261035651,150,1180191,919069,919069,0
16260,Millie Turner,69,2652200,3508224615222665,529,6492322,1382234,13823,1368411
16261,Paola Ulloa,36,2771000,6996486555751994,271,4126784,3320924,333,3320591
16262,Irina Uribe,60,4276600,6328170995055992,624,8861708,8192331,8192331,0
16263,Shanice van de Sanden,53,2603700,7611634040642861,377,4851758,4744010,47441,4696569
16264,Merel van Dongen,66,2633800,6671336271507847,485,6145159,5950053,0,5950053
16265,Dani Weatherholt,52,4530000,5844681064927862,580,7968623,583918,5840,578078
16266,Joelle Wedemeyer,58,750600,5875225743595288,276,2701748,730270,0,730270
16267,Manjou Wilde,61,4749300,6602983407294151,596,7773631,3087855,0,3087855
16268,Riola Xhemaili,67,1590900,6476538297921247,449,4508550,1406843,0,1406843
16269,McCall Zerboni,38,1870500,7905982327162873,228,3067141,408115,0,408115
16270,Yvonne Zielinski,38,461500,6583087633077232,145,1250569,280692,28070,252622
16271,Laia Aleixandri,49,2271100,7708190320114990,385,4691123,4261549,4261549,0
16272,Filippa Angeldahl,27,3327200,8836410877202835,283,4616317,1973617,198,1973419
16273,Ana Vitória,27,3443700,7239432855779820,307,4973028,3424395,0,3424395
16274,Rinsola Babajide,57,2136500,9802066331156150,366,4263003,1030859,0,1030859
16275,Inès Belloumou,61,2568200,5393795649962252,419,5515707,4018435,4018435,0
16276,Alejandra Bernabé,30,3332700,8643576706470991,344,5222181,4064211,0,4064211
16277,Rebecka Blomqvist,66,2884400,9159630020800178,522,6348568,2887640,289,2887351
16278,Rafaela Borggräfe,43,4030600,3650954279626550,412,6638622,2100867,210087,1890780
16279,Sofie Bredgaard,56,2140600,5149874124265628,382,4592428,3459516,0,3459516
16280,Amber Brooks,64,4950500,6075757549022501,657,9707355,8325568,0,8325568
16281,Luana Bühler,52,2764300,3213750073834999,401,5081696,1652079,165208,1486871
16282,Sarah Cambot,69,1248000,8623309665173854,346,3560944,869849,0,869849
16283,Simone Charley,67,1388700,9779522982194075,365,3734388,688659,0,688659
16284,Gia Corley,69,3159500,4698913675485364,512,6501368,1304736,13048,1291688
16285,Rachel Corsie,24,1293300,5393070733860023,124,1752737,366377,366377,0
16286,Carole Costa,70,3338300,4085979157932426,533,6563500,913953,913953,0
16287,Andreia Jacinto,27,1653700,4131351971943787,173,2549594,2364244,0,2364244
16288,Fabienne Dongus,38,2394000,5985438107575601,275,4041549,1214969,12150,1202819
16289,Caprice Dydasco,45,663200,3878046515824586,208,2018178,402872,4029,398843
16290,Estela Férnandez,46,630400,7095080190511312,187,1625548,1167620,1167620,0
16291,Inma Gabarro,34,2579100,9889809227582552,264,3811293,2717159,2717159,0
16292,Aurora Galli,70,1371900,7351235003740680,414,4170189,3882082,388209,3493873
16293,Rocío Gálvez,51,4803700,7346154962446289,569,8561132,52656,52656,0
16294,Gabrielle George,53,3513000,6263320214274086,462,6299105,4333654,0,4333654
16295,Irene Guerrero,51,4315900,3769873364039618,585,8134386,6202495,6202495,0
16296,Hannah Hampton,63,656100,9728502939774336,292,2490383,939134,0,939134
16297,Paola Hernández,49,1529700,8428506704020034,297,3220540,1489897,148990,1340907
16298,Tiny Hoekstra,26,4859900,3321600353547023,412,7354324,6424836,6424836,0
16299,Olivia Holdt,54,1327800,8916861490815597,306,3489424,1459533,0,1459533
16300,Jaelin Howell,51,1949200,4413111389589754,341,4110034,1523610,1523610,0
16301,Inès Jaurena,70,2316000,7119302015957492,495,5405786,1283594,12836,1270758
16302,Estelle Johnson,25,565500,5824263913496127,44,465257,340607,0,340607
16303,Elena Julve,43,1676200,3290459949869590,237,3128895,2120698,2120698,0
16304,Alanna Kennedy,66,4419200,4273702117290786,675,9220713,173233,173233,0
16305,Kristin Kögel,29,653300,3853130197585619,111,1065853,509659,5097,504562
16306,Paulina Krumbiegel,31,1125600,9567821596463316,115,1600019,180037,180037,0
16307,Mariana Larroquette,60,4291200,3876347559190151,618,8288208,1595230,160,1595070
16308,Claire Lavogez,24,3081700,7026716322669902,212,4098360,1801487,1802,1799685
16309,Adriana Leon,59,1319400,9363200315692356,320,3099519,2257543,2258,2255285
16310,Vicky Losada,65,1988400,6830499054117437,480,5231215,1462012,1463,1460549
16311,Batcheba Louis,58,1022900,7276314939495178,298,2756643,901882,90189,811693
16312,Hanna Lundkvist,58,2538500,5285442473308719,411,4980272,83429,83429,0
16313,Shekiera Martinez,43,3352000,8962134287504988,378,5129825,1899507,0,1899507
16314,Maria Méndez,48,3954200,8448335166443324,399,5714145,4583525,4584,4578941
16315,Maren Mjelde,50,3446300,3054331990416071,464,5729367,2357559,0,2357559
16316,Caroline Møller,27,1010300,8767084157872102,95,1259601,986528,0,986528
16317,Kika Nazareth,44,2206000,7940306765128434,323,4304966,3021564,302157,2719407
16318,Nerea Nevado,26,3877200,6325268591812137,284,5262309,4692209,0,4692209
16319,Paige Nielsen,48,1413800,3337415116462314,271,2953639,2308870,2309,2306561
16320,Freja Siri Olofsson,40,1560600,3482760766731121,254,2991220,2394432,0,2394432
16321,Toni Payne,52,3695600,3490210015363538,501,7182730,2019363,0,2019363
16322,Macarena Portales,27,2033800,8541765372750557,182,2890140,837204,8373,828831
16323,Friederike Repohl,49,3099500,4545845036640147,443,5744191,2253307,22534,2230773
16324,Kaleigh Riehl,54,3765400,6389762580212885,478,6368742,4399593,4400,4395193
16325,Cari Roccaro,39,3446900,8582786009350097,384,5561960,1529748,1529748,0
16326,Enith Salón,22,3436200,3748852454770021,271,4674965,3063284,3063284,0
16327,Sandra Starke,26,3474100,3658923359187908,318,5355858,616419,616419,0
16328,Greta Stegemann,51,4582900,6203539636067631,581,8289895,492173,4922,487251
16329,Samantha Steuerwald,23,3359300,3992426959114596,257,4439479,1380037,1380037,0
16330,Tereza Szewieczková,66,3232800,7576245779969557,547,6793492,3616083,0,3616083
16331,Ana Tejada,52,4852000,6582497020012235,627,8283089,6213020,62131,6150889
16332,Lindsey Thomas,34,1101600,4393720822098920,174,1968327,225272,2253,223019
16333,Lilla Turanyi,26,2487200,4851472882228686,204,3407203,1597082,0,1597082
16334,Erika Tymrak,54,3524500,9214231256451944,484,6547720,6147438,614744,5532694
16335,Marisa Viggiano,55,3931900,8232380357702962,576,7704249,4053590,405359,3648231
16336,Lea Karólína Vilhjálmsdóttir,59,1087300,6078252469803894,284,2697694,2347053,0,2347053
16337,Ane Azkona,23,2336500,7107388407494065,188,2930778,2539020,0,2539020
16338,Bethany Balcer,58,4705000,3485764414954470,535,8368124,7643732,764374,6879358
16339,Nicole Barnhart,49,1056900,8686840092250794,222,2256184,603596,604,602992
16340,Diana Bartovičová,69,1976900,7923596630351734,388,4108947,1973236,0,1973236
16341,Jennifer Beattie,31,2919200,3522912917434089,310,4588456,4296208,429621,3866587
16342,Hanna Bennison,26,1731900,8920269625986860,143,2256122,995092,995092,0
16343,Michelle Betos,62,4994800,5963173680547840,641,8495890,5546401,555,5545846
16344,Camryn Biegalski,22,1467800,3053419509954871,119,1840399,1278402,127841,1150561
16345,Celin Bizet,47,2513800,9847323117846348,351,4258313,674670,674670,0
16346,Celeste Boureille,27,4078200,7718410584564739,360,5733632,4973488,0,4973488
16347,Belle Briede,67,2358700,5049846462807560,408,4904524,1439158,143916,1295242
16348,Linda Caicedo,41,1679800,6962186366465666,231,2927831,2319480,0,2319480
16349,Kerstin Casparij,32,4285300,4159097030480199,419,6484415,2261910,0,2261910
16350,Sandra Castelló,53,3539200,9296457387061570,489,6142705,166758,16676,150082
16351,Miray Cin,36,1834800,9250119000773291,214,2740909,189835,18984,170851
16352,Sabrina D'Angelo,68,2809100,6020598749473918,566,6959763,4047294,4047294,0
16353,Kay-Lee de Sanders,34,2201200,6828315237102476,244,3541468,2242230,2242230,0
16354,Celina Degen,62,4790100,4576627986770542,647,8550565,340579,0,340579
16355,Pauleta,51,1302200,6862685349843408,261,3099050,1060786,106079,954707
16356,Meggie Dougherty Howard,49,3033400,6853865767604007,440,5818027,1674907,16750,1658157
16357,Toni Duggan,49,4037000,8631179216162914,504,6986838,4941400,4942,4936458
16358,Claire Emslie,46,4586500,4903993856695642,532,7314442,871881,8719,863162
16359,Gemma Evans,63,1763100,3435649611133907,367,3893531,1728857,17289,1711568
16360,Bayley Feist,64,3141200,8826492886177135,509,6295555,295801,2959,292842
16361,Grace Fisk,24,3473900,4666520718285045,275,4563730,1558823,1559,1557264
16362,Paula Flach,51,4615600,7337307263860365,492,7152969,5219941,52200,5167741
16363,Mary Fowler,25,1078000,4546691919613707,87,1280570,437910,438,437472
16364,Vanessa Fürst,44,2511200,5739548352749183,311,4195747,142757,143,142614
16365,Luna Nørgaard Gevitz,45,1096200,3142377346227589,194,2192526,666214,667,665547
16366,Sarah Gorden,32,2999700,9790792947477271,309,4304171,237744,0,237744
16367,Franziska Harsch,65,4724600,6497748710180943,599,8176243,3285697,0,3285697
16368,Emilie Henriksen,58,1231300,3166786927566277,273,2788263,866602,86661,779941
16369,Alexandria Loy Hess,56,3581000,8049716678951353,511,7370375,4534464,4534464,0
16370,Sam Hiatt,68,3362400,3645664315640432,529,6634029,1907161,19072,1888089
16371,Julia Hickelsberger,41,4149500,4119366156169784,450,6541243,270841,2709,268132
16372,Fabienne Humm,26,1704400,9927410330445130,147,2376000,918403,91841,826562
16373,Léa Khelifi,45,2645000,6204026984228376,339,4405480,2463008,2464,2460544
16374,Michaela Khýrová,68,1541500,6225659928753368,354,3883583,1973052,198,1972854
16375,CeCe Kizer,26,3447300,9829024977200014,293,5410765,3035230,0,3035230
16376,Amanda Kowalski,22,1008700,3505576749932011,90,1277712,170876,171,170705
16377,Casey Krueger,30,4240300,8057439412046488,397,6306511,2224918,0,2224918
16378,Cloé Lacasse,29,3460200,8715823355586261,341,5508572,1052699,1052699,0
16379,Tess Laplacette,58,4695300,8503416396555667,576,8647978,6223333,622334,5600999
16380,Clarisse Le Bihan,56,448000,5437202203064496,281,2449472,2395335,0,2395335
16381,Kethna Louis,53,369200,8270703604532467,202,1551540,1024659,1024659,0
16382,Leonie Maier,54,3719000,8204733619875392,447,6708004,2962734,296274,2666460
16383,Anita Marcos,46,1087400,7391308470206417,243,2676591,1837994,183800,1654194
16384,Sylwia Matysik,26,4983400,5620077573483817,424,7842920,2893203,0,2893203
16385,Haley McCutcheon,23,3842500,9444414152561285,315,5330941,4304897,431,4304466
16386,Falone Meffometou,43,1730100,3996893540799678,237,2969118,533772,534,533238
16387,Jacqueline Meißner,52,3869500,6658255709961460,515,6671607,4670544,0,4670544
16388,Emily Menges,64,591000,3018035969379400,287,2300238,1489409,1489409,0
16389,Maelys Mpome,58,4212300,3641390302033381,569,7644602,2777023,0,2777023
16390,Nadia Nadim,63,2628800,6963796200441008,475,5775158,3442299,0,3442299
16391,Jessica Naz,70,4379900,8201392326388649,682,8836562,3381267,0,3381267
16392,Nadine Noordam,66,3005500,4656727054656169,464,6039803,3986634,398664,3587970
16393,Patri Ojeda,32,1309000,8237345379281691,167,2088849,1058295,0,1058295
16394,Selina Ostermeier,49,2637400,8411683253548760,380,4635433,2629156,263,2628893
16395,Lena Ostermeier,26,4686200,8741450274667654,430,6929770,5962706,5962706,0
16396,Victoria Pelova,68,4434400,6406177883983608,622,8309309,2974941,29750,2945191
16397,Pisco,36,4344700,4330361511106897,412,6382438,830069,0,830069
16398,Ria Percival,33,4900800,5920935316406582,461,7227886,1425383,1426,1423957
16399,María José,62,2927500,3711193589094428,474,6019352,2356698,235670,2121028
16400,Nerea,46,2637200,7298282525016035,355,4930034,1020334,103,1020231
16401,Ramona Petzelberger,66,2015600,7149235619006280,430,5067636,3062336,3062336,0
16402,Anja Pfluger,31,2440300,8634248616628063,285,4191013,778851,0,778851
16403,Clara Pinedo,55,4678100,6926937706348853,634,8835845,6794559,680,6793879
16404,Julie Rabanne,70,4277400,9510328547042828,647,8406058,871692,0,871692
16405,Natalia Ramos,23,4623300,6068166204114878,341,6123647,3643177,365,3642812
16406,Manon Revelli,27,4071000,4792424339729410,352,6140977,644383,645,643738
16407,Katelyn Rowland,30,1216300,3325235546137204,177,2142341,455418,4555,450863
16408,Camila Sáez,23,2873900,3808297655013631,255,3753700,3314688,332,3314356
16409,Olatz Santana,70,2327400,8622961494313767,468,5310902,4684659,0,4684659
16410,Nycole Raysla,41,3124100,8967994107297047,373,5226438,3301719,0,3301719
16411,Becky Spencer,35,3622900,9869294808117454,407,5924713,4868063,4869,4863194
16412,Jasmyne Spencer,31,2303000,3517391040474288,264,3816035,3096799,309680,2787119
16413,Eveliina Summanen,37,684500,6227575891766080,121,1183074,902557,0,902557
16414,Martha Thomas,28,478200,4302860743042261,55,462361,118901,0,118901
16415,Maria Thorisdottir,52,3413200,7444619426311307,385,5372314,3256478,0,3256478
16416,Anna Torrodà,43,4229000,9877271936494190,461,7352770,1200880,121,1200759
16417,Aïssata Traoré,28,2720900,8969973536285736,259,4117514,615725,0,615725
16418,Kelsey Turnbow,29,2864400,6517976221759772,295,4712612,4536416,454,4535962
16419,Danielle Turner,32,3619500,5320625713863760,401,6023525,1799974,1800,1798174
16420,Justine Vanhaevermaet,59,2774000,4299848356226061,388,5516962,4796996,480,4796516
16421,Ashleigh Weerden,27,2371100,5464184578533083,197,3385105,357984,35799,322185
16422,Jessica Wik,39,3119400,4757163383312013,365,5369350,429147,429147,0
16423,Rachel Williams,48,4458900,8521380167866820,468,6796916,1320585,0,1320585
16424,Lynn Wilms,40,330500,7525306963346187,126,875078,177939,177939,0
16425,Juliane Wirtz,42,425700,3763514951525411,160,1308063,691987,0,691987
16426,Pia-Sophie Wolter,40,2849600,4981672450311262,390,5060991,4766535,0,4766535
16427,Jill Aguilera,57,1157500,3082978095157958,322,3008976,24618,0,24618
16428,Korbin Albert,31,1872900,6238085163243721,225,3130454,2622490,26225,2596265
16429,Nadjma Ali Nadjim,38,3771000,4332736206061485,387,5743465,2451282,245129,2206153
16430,Angelina,52,3272400,3762140967944398,430,5597506,4075710,4075710,0
16431,Jone Amezaga,41,369000,9353893306402590,111,825787,147026,147026,0
16432,Eunate,69,4056500,9585742437921417,607,8639324,3443280,345,3442935
16433,Rosella Ayane,36,1676100,7258613733824822,231,3051546,2833172,2834,2830338
16434,Jill Baijings,59,1985500,4866584195205763,391,4378492,1527720,153,1527567
16435,Dorian Bailey,33,3947400,6765413156761296,353,6051952,2970107,2970107,0
16436,Agustina Barroso,59,4562800,3826779528476370,593,8494938,5323416,533,5322883
16437,Merle Barth,32,621600,5718346165324466,105,1060518,995588,0,995588
16438,Fiamma Benítez,30,1238100,4656981824785356,134,1792047,855246,856,854390
16439,Vilde Bøe Risa,22,1700800,8741155889791587,147,2142221,1548073,154808,1393265
16440,Chiara Bouziane,62,2392100,4747201288227718,417,5030886,2983003,2984,2980019
16441,Mickaëlla Cardia,57,4628200,9493592376025752,522,8026022,7418523,742,7417781
16442,Raiderlín Carrasco,66,3019000,4047673696066955,541,6444026,6422636,642264,5780372
16443,Estelle Cascarino,46,3065600,9415722293276056,380,5272004,3388014,33881,3354133
16444,Janice Cayman,47,3124000,8635128457850975,389,5510717,4817777,4817777,0
16445,Selina Cerci,44,4743000,9067377595951127,492,7722497,6446684,645,6446039
16446,Mariana Cerro,26,4645900,6400562789102460,364,6618145,5505875,550588,4955287
16447,Thais Ferreira,36,1687600,3384940565771460,213,2945585,2588880,259,2588621
16448,Deja Davis,63,4943900,5331246645950877,651,9224036,7807235,781,7806454
16449,Léa Declercq,36,2791400,6348967820282400,313,4405895,1800009,181,1799828
16450,Kate Del Fava,37,901300,7296766875717186,167,1695952,34643,0,34643
16451,Hélène Fercocq,33,454600,4953457196846446,82,734949,432151,433,431718
16452,Charlotte Fernandes,29,1538300,5326834277437306,189,2437909,2277665,0,2277665
16453,Mélissa Gomes,49,4785100,4782958389567771,485,7928209,7750366,77504,7672862
16454,Airine Fontaine,69,2591300,3821034311221452,529,6056783,5404272,541,5403731
16455,Ana Franco,25,4657300,9386739067977506,360,6244166,3240621,324063,2916558
16456,Léna Goetsch,63,3403500,6236602126330735,499,6625459,1250201,12503,1237698
16457,Érika González,46,452200,7661252862248472,173,1431793,799520,7996,791524
16458,Antonia-Johanna Halverkamps,66,1594900,5885660566837100,427,4628870,3275483,3276,3272207
16459,Kristen Hamilton,35,3110800,3054461948494463,338,4594914,2072633,20727,2051906
16460,Lina Hausicke,23,828100,3994779504816724,89,1047168,798474,79848,718626
16461,Shelby Hogan,54,4686600,4376617073410357,569,8813371,7409368,741,7408627
16462,Ceri Holland,47,4430000,4853131360862673,508,7647085,4656997,0,4656997
16463,Emma Holmgren,27,4557600,6388935734565689,395,7096668,2616477,261648,2354829
16464,Sophie Howard,24,3122700,6124308705288305,276,4641824,3165573,317,3165256
16465,Jordyn Huitema,70,3474700,7146630754381251,585,7367804,3735569,373557,3362012
16466,Tori Huster,24,4830500,3228508396027121,365,6325725,4582794,458280,4124514
16467,Emmy Jézéquel,53,316800,4951190798364117,186,1465108,856070,85607,770463
16468,Celia Jiménez,64,2652100,6306491982917355,430,5562872,2888595,0,2888595
16469,Johanna Kaneryd,63,2141900,9453903848273068,385,4625918,3003269,3004,3000265
16470,Franziska Kett,33,1046300,3801079143460505,162,1779649,20314,20314,0
16471,Thembi Kgatlana,36,875400,4528130573254028,136,1540699,473192,47320,425872
16472,Virginia Kirchberger,33,312400,7597363022724581,72,514947,77743,77743,0
16473,Eva Kouache,63,2038100,5742255969993718,408,4892830,4518860,452,4518408
16474,Emma Kullberg,49,1962500,6413589620338455,338,4049706,507891,0,507891
16475,Kaleigh Kurtz,52,4919600,6596821904231525,636,9220437,412136,41214,370922
16476,Emilia Larsson,64,314300,9197327021357572,246,1831689,435395,435395,0
16477,Hayley Lauder,45,2558500,7500385734388796,366,5012421,4658551,46586,4611965
16478,Jade Le Guilly,38,3520100,5084187673786698,372,5344289,3362721,3363,3359358
16479,Margaux Le Mouël,52,2186400,6513319853079871,339,4357008,1637728,163773,1473955
16480,Justine Lerond,36,1083300,8217462940633145,169,1900952,707069,0,707069
16481,Silvia Lloris,24,875400,6930651082826355,74,992056,780874,781,780093
16482,Nina Lührßen,29,4111100,9155597534377197,357,6079203,218637,218637,0
16483,Olivie Lukášová,35,2264700,8361693682824856,259,3571114,2303096,0,2303096
16484,Tyler Lussi,38,3939000,4607508409345826,427,6560504,3309449,331,3309118
16485,Ramona Maier,54,2698500,9204491894363356,427,5203115,4662428,467,4661961
16486,Cecilia Marcos,48,1705100,6304553931632514,295,3623352,241812,2419,239393
16487,Cassie Miller,52,1640000,9561001612733584,316,3558514,1613070,162,1612908
16488,Lauren Milliet,23,2274500,8048537180338805,171,2898530,1794251,0,1794251
16489,Narumi Miura,22,4604800,8932555084036937,377,7049305,3100498,31005,3069493
16490,Paige Monaghan,61,4925300,8037121021623436,671,9458331,2106894,0,2106894
16491,Megan Montefusco,62,3896700,8101245809420227,565,7147644,7035714,704,7035010
16492,Linda Motlhalo,56,2745700,6264265193963434,420,5601925,4968993,49690,4919303
16493,Meaghan Nally,35,4481600,8695899826482635,446,7167804,6792120,67922,6724198
16494,Eva Navarro,30,1801000,6665337470020242,199,2730552,2099229,0,2099229
16495,Carly Nelson,28,3805100,8845762790758840,369,5886771,369088,3691,365397
16496,Andreia Norton,52,2325600,4232479327824572,376,5058423,1613275,1613275,0
16497,Rosa Otermín,37,737900,3803804264451245,143,1358377,1160274,11603,1148671
16498,Jacqueline Owusu,23,1946100,7815279354389187,123,2301712,1357992,1358,1356634
16499,Martina Piemonte,26,4414900,6818578649790540,358,6231026,5530079,0,5530079
16500,Brianna Pinto,62,1744400,9706478019136537,395,4380649,3026971,30270,2996701
16501,Seraina Piubel,39,2509800,8503655062296667,299,4250818,1028165,1028165,0
16502,Madison Pogarch,43,1452800,3961304810692649,221,2602148,1994180,1994180,0
16503,Nuria Rábano,56,1748100,5052637294322474,346,4015486,1129734,11298,1118436
16504,Noelia Ramos,42,4019700,9775968316780068,459,7255851,2468485,247,2468238
16505,Kerlly Real,52,412800,8188359388640109,201,1609537,639468,0,639468
16506,Megan Reid,48,2359800,8234003942672971,333,4555276,2857325,2858,2854467
16507,Diana Gomes,35,1236800,7201932647388817,149,1885007,1483569,1483569,0
16508,Lucía Rodríguez,59,1669700,3178078179778439,316,3546428,1777455,0,1777455
16509,Lourdes Romero,67,3418700,7394577231301421,577,6781310,1721637,0,1721637
16510,Quinty Sabajo,40,4076100,7989592478117988,463,6695679,1457069,145707,1311362
16511,Veatriki Sarri,32,4136700,5532755075826266,386,6309553,1728982,1728982,0
16512,Bibi,43,638100,3462375072735170,181,1714402,1228949,1228949,0
16513,Kayla Sharples,59,2489900,9781811095530000,464,5978492,1086149,0,1086149
16514,Kirsty Smith,42,976800,5182717413260774,197,2000296,1755186,175519,1579667
16515,Alice Sombath,69,3961300,5792981336648704,634,8342901,5009671,501,5009170
16516,Nicoline Sørensen,67,975900,7830723018917302,350,3436838,732434,0,732434
16517,Bianca St-Georges,58,2468100,8504649288951265,412,5026285,1923467,0,1923467
16518,Judith Steinert,35,1974400,3616413022086589,236,3227186,2028386,2028386,0
16519,Abbey-Leigh Stringer,37,4839500,5522749022726545,442,6996561,1178605,118,1178487
16520,Sullastres,44,2939700,6623679408878805,384,5572038,4775063,0,4775063
16521,Virginia Torrecilla,23,1848300,8930971556739084,187,2682496,2540600,254060,2286540
16522,Michelle Ulbrich,44,1607200,3848869862992751,268,3230978,608815,609,608206
16523,Olivia Van der Jagt,69,2425000,8610128318837536,493,5810621,287549,2876,284673
16524,Katrine Veje,55,1495400,5348348196987024,355,3731452,2732246,2732246,0
16525,Aline Reis,33,3258100,4885634947800227,311,5230203,3895411,0,3895411
16526,Luisa Wensing,30,3631500,3470499665814647,318,5150652,3681094,369,3680725
16527,Aileen Whelan,59,4295600,3299152810759898,534,7099786,3572937,358,3572579
16528,Ryan Williams,28,4714100,7205445234964799,458,7532384,5944148,595,5943553
16529,Ruth Álvarez,34,1755200,3884404998213630,200,2816184,668130,668130,0
16530,Amira Arfaoui,59,4508000,7216918463111955,633,8523785,7082208,70823,7011385
16531,Guðrún Arnardóttir,31,4928700,8008489323444127,458,7084297,451166,45117,406049
16532,Peke,53,1894200,7487952470559207,365,3832286,2002332,0,2002332
16533,Bea Beltrán,64,1828800,3314717693260511,376,4117799,977465,977465,0
16534,Maike Berentzen,34,1371400,4449823096609677,163,2320505,520511,520511,0
16535,Emma Berglund,33,4680200,5505053917843392,471,7624481,18879,189,18690
16536,Roselord Borgella,24,960400,5636947639048899,115,1361527,168026,16803,151223
16537,Michaela Brandenburg,28,1489600,7322935538607364,134,2159568,1136392,113640,1022752
16538,Fiona Brown,67,3647600,6012951765374577,517,6693418,6127123,6127123,0
16539,Rute Costa,41,4951800,7583076873363242,547,8460643,6318007,63181,6254826
16540,Laurie Cance,48,923600,5261261876183408,224,2171799,1843536,0,1843536
16541,Sofia Cantore,33,4030900,4280125144707376,424,6170972,2208038,0,2208038
16542,Cindy Caputo,60,3785200,7072846688667482,501,6639190,1316147,0,1316147
16543,Gabrielle Carle,46,605000,7665970072470854,187,1713519,350003,0,350003
16544,Marta Carro,61,1300100,7700995274417409,369,3807894,2992261,0,2992261
16545,Franny Černá,45,4784300,5191904064221994,563,8542107,2476142,248,2475894
16546,Emily Curran,43,955400,7421324041735710,216,2106883,172655,173,172482
16547,Lauren Davidson,32,4505700,4604017902870834,376,6886434,2305931,0,2305931
16548,Silke Demeyere,31,4226800,7366583351654018,400,6259807,1892465,0,1892465
16549,Imani Dorsey,62,2933900,4720031425866251,463,5871276,3501063,0,3501063
16550,Salomé Elisor,64,941300,5588585717566106,365,3543027,1959873,1959873,0
16551,Estella,53,320000,5130590091577640,214,1689666,777595,778,776817
16552,Carol Férez,49,2027100,9234071311533430,342,4404973,3388864,3389,3385475
16553,Mia Fishel,54,4763400,9380219383096138,508,7793235,3203727,0,3203727
16554,Mandy Freeman,67,2359500,7195505699192883,437,5036731,4891462,0,4891462
16555,Melissa Friedrich,60,2382800,6074054546591917,431,5018009,4264221,42643,4221578
16556,Clara Fröhlich,32,4409400,5884374363112493,432,6749784,776931,776931,0
16557,Ryan Gareis,29,3633300,8013787975916744,379,6000960,606942,607,606335
16558,Luca Graf,23,4465300,4650106965365831,337,6217249,5728686,573,5728113
16559,Svava Rós Gudmundsdóttir,57,1898400,9620860692714013,331,3786711,2913363,2913363,0
16560,Alicia-Sophie Gudorf,29,3126100,6229383401689155,269,4313737,1700127,0,1700127
16561,Mia Gyau,26,1543700,3326408389235660,172,2273725,1149251,114926,1034325
16562,Madison Haley,49,2411100,4421575727508756,391,4842126,3448591,345,3448246
16563,Tuva Hansen,32,3021900,9505111129742447,315,5003388,2868453,286846,2581607
16564,Anna Heilferty,34,1992400,5334439904178011,243,3046131,2280553,2280553,0
16565,Taylor Hinds,46,1940600,7459565644843171,320,3783828,1748354,17484,1730870
16566,Karen Holmgaard,66,2599000,5845568301848063,468,5732732,4458573,445858,4012715
16567,Natalie Jacobs,50,1290100,5287575958254003,275,2914658,1570927,1570927,0
16568,Lou-Ann Joly,41,3691900,3371138260207271,406,6586291,3132920,3133,3129787
16569,Sally Julini,52,4546200,3987416723662802,605,8324181,7915847,7915847,0
16570,Grace Kazadi,52,2509400,9371724757318279,408,4923956,682679,682679,0
16571,Tziarra King,65,3273700,5238163692180885,521,6359292,3479132,3479132,0
16572,Lize Kop,34,4514500,4840941175239307,422,7141133,1064564,1065,1063499
16573,Natasha Kowalski,22,3760400,3458151403112237,331,5591584,3025621,303,3025318
16574,Tereza Krejčiříková,37,2781900,9352419815521947,299,4518390,4111631,0,4111631
16575,Veronica Latsko,40,2995100,9251355416784032,399,5368669,1775521,0,1775521
16576,Melissa Lawley,34,2399100,3215176876678258,287,4125104,2579584,257959,2321625
16577,Carrie Lawrence,64,3860300,6992163924150659,533,7244124,1341572,134158,1207414
16578,Adriana,68,470700,7225099487159810,291,2299001,229414,229414,0
16579,Elise Legrout,53,1996500,9522288984612197,337,4180914,2404419,2405,2402014
16580,Vanessa Leimenstoll,53,2133300,4170925811539528,324,4043086,1660143,16602,1643541
16581,Janina Leitzig,53,1960100,7461755704108766,341,4292541,3342262,334227,3008035
16582,Julia Lester,29,3747500,7150768018266641,346,5348885,3799568,380,3799188
16583,Romée Leuchter,27,2035500,6040935521591321,189,2698636,824875,0,824875
16584,Alex Loera,50,2940700,6478113077123241,404,5316667,4210183,0,4210183
16585,Allie Long,24,1477100,5993742819717072,124,1913323,1462287,1463,1460824
16586,Joanne Love,49,867500,8818033205715549,217,2267057,1512605,152,1512453
16587,Héloïse Mansuy,22,1012000,5711302835979435,79,1190651,840318,841,839477
16588,Andrea Marrero,47,554700,4057443356523972,191,1690605,1508077,151,1507926
16589,Lara Marti,52,2297600,8483428564881540,371,4830784,2342680,2343,2340337
16590,Nealy Martin,25,652100,9758810184694794,50,635540,201852,0,201852
16591,Cheyna Matthews,44,4422300,5101176573425489,493,7913518,7563363,7564,7555799
16592,Tegan McGrady,60,629700,3167035356187356,292,2647720,2313962,23140,2290822
16593,Addisyn Merrick,23,1446300,7113684124499489,126,1976039,1715697,0,1715697
16594,Zala Meršnik,25,859600,4713281393401495,106,1278854,554090,554090,0
16595,Teagan Micah,70,1997700,3251343025397936,441,4677927,410521,41053,369468
16596,Esme Morgan,47,2108700,8801071193806432,332,4234175,1835823,1836,1833987
16597,Olivia Moultrie,35,502900,3807366730250296,100,961419,547289,5473,541816
16598,Koko Ange N'Guessan,59,3465300,3844930982787800,477,6525415,1489391,149,1489242
16599,Fuka Nagano,46,2200600,6864560685498697,284,3960094,3403084,0,3403084
16600,Simona Necidová,60,4610400,4972590364290782,638,8824064,6233861,624,6233237
16601,Lucía Pardo,53,4819600,4926692009290605,595,7886304,5197661,0,5197661
16602,Anna Patten,70,3124800,3492029288475538,473,5957141,3790659,0,3790659
16603,Courtney Petersen,69,1735600,3215149563191689,452,4521406,3389365,3389365,0
16604,Nina Räcke,46,1681700,8529948064531716,318,3534212,17563,1757,15806
16605,Brittany Ratcliffe,39,1129700,7111879795442840,217,2272841,1290622,1290622,0
16606,Nadine Riesen,34,4392300,6021929824091954,453,7626634,4952768,0,4952768
16607,Katie Robinson,40,4253400,6075090161998758,472,7441787,3408923,3409,3405514
16608,Madeline Roth,29,367300,5362790502115489,81,594848,539870,539870,0
16609,Taylor Smith,52,1890800,6615083912714812,278,3598337,2059194,206,2058988
16610,Meredith Speck,57,577600,6294253002660401,242,2242842,1863472,187,1863285
16611,Drew Spence,39,1577600,8995653988839153,227,2696990,1020143,0,1020143
16612,Nikki Stanton,25,4431000,7203029575457064,367,6675618,6305906,0,6305906
16613,Ella Stevens,35,1731700,3112791044039385,248,3048984,1308706,1308706,0
16614,Julia Stierli,28,1047800,9991984762722520,130,1588188,381403,38141,343262
16615,Kylie Strom,22,419500,9229497494295764,41,322001,19810,1981,17829
16616,Eva Sumo,24,2861500,3433461433537237,232,4104622,2655146,265515,2389631
16617,Maddi Torre,56,2756500,4192561817171895,408,5387317,4898205,4898205,0
16618,Marta Unzué,25,4038800,8004346143466546,350,6126715,849461,0,849461
16619,Daphne van Domselaar,45,3260700,9616811912353017,394,5580601,912177,912177,0
16620,Amalie Vangsgaard,64,970900,5155448953148448,349,3451128,708582,708582,0
16621,Ally Watt,42,896000,7337071752564643,209,1997064,634058,0,634058
16622,Sophia Winkler,29,343600,4007128267107455,54,359152,198359,198359,0
16623,Cora Zicai,54,3267800,7865082753773994,489,6224351,2813022,2814,2810208
16624,Kerry Abello,57,2123500,5231890132564720,396,4578795,2703896,2703896,0
16625,Asmita Ale,28,4025400,6099607548970001,360,6307087,5117377,512,5116865
16626,Amirah Ali,34,4624400,4937241056653055,458,7536506,7220074,72201,7147873
16627,Ary Borges,49,2580400,7227571297859164,389,5178380,2883029,0,2883029
16628,Karen Araya,27,2714500,7007403661822843,222,3799132,958959,95896,863063
16629,Carla Armengol,24,3729500,6840909418220537,309,4940565,3061469,3061469,0
16630,Chelsea Louise Ashurst,34,2306500,3469659191939686,227,3539914,3528093,3528093,0
16631,Laia Ballesté,30,2487200,3450835775209078,230,3523548,1983998,198400,1785598
16632,Elyse Bennett,47,3056200,9912984055144330,381,5294606,2885316,288532,2596784
16633,Fran Bentley,35,931300,3469795179793685,129,1448856,1279011,127902,1151109
16634,Malia Berkely,33,2713300,6025938702335398,283,4319896,1278013,12781,1265232
16635,Julia Bianchi,67,1235600,6639902046550551,346,3713914,218436,218436,0
16636,Alena Bienz,57,1134100,6963937166750432,324,3196008,2375929,238,2375691
16637,Cyrielle Blanc,46,4881400,8882980522447951,520,8102596,5897585,5898,5891687
16638,Laura Blindkilde Brown,40,4559200,5283642730921326,533,7865068,78892,789,78103
16639,Gemma Bonner,47,1379900,5823053751399780,272,3220735,563258,0,563258
16640,Cara Bösl,68,3465700,5659335880766488,540,6746297,3264630,3265,3261365
16641,Maïté Boucly,43,1264700,6581999222004184,203,2359300,1174183,1174183,0
16642,Marisa Bova,40,3376700,5399577157337438,373,5302876,8473,0,8473
16643,Courtney Brosnan,42,2396300,4295272739990889,349,4846374,2369832,2369832,0
16644,Phoenetia Browne,62,4460900,5164882821013918,579,8441647,6045694,60457,5985237
16645,Valéria Cantuário,68,1845300,4723884661860056,445,4771129,2396852,240,2396612
16646,Laia Codina,37,3603900,3375129851762347,345,5651207,757987,758,757229
16647,Ava Cook,51,1285500,7102245642319872,291,2981893,773396,774,772622
16648,Kirsten Davis,32,373900,7696367569791431,65,494835,62691,6270,56421
16649,Ella Dederick,33,1515200,9227646539614431,186,2268691,1705053,17051,1688002
16650,Mariam Diakité,57,4749000,4171106247081586,605,8224613,1388044,1388044,0
16651,María Diaz,47,331900,9777283256178167,177,1400129,1389793,13898,1375895
16652,Agathe Donnary,64,1123700,4039841179691261,349,3235901,2304485,0,2304485
16653,Lisa Doorn,68,3149800,7857025102859036,499,6563598,3721291,373,3720918
16654,Emina Ekic,23,3984400,3034998123263842,306,5880972,5647300,5647300,0
16655,Nesryne El Chad,66,2317500,6826759730841183,418,4936235,3902507,39026,3863481
16656,Ane Elexpuru,67,4582300,5636119833091365,643,8720107,6131539,6131539,0
16657,Vivien Endemann,43,3381900,7456983579286638,348,5274071,776623,776623,0
16658,Romane Enguehard,48,446000,4923951648597631,180,1506444,72650,0,72650
16659,Thelma Eninger,44,1625100,8581350222344941,268,3021326,101318,10132,91186
16660,Niamh Fahey,46,2760800,7785791328017034,371,5103763,3884592,0,3884592
16661,Jana,66,3954100,6973490178465493,568,7912258,4950635,496,4950139
16662,Megan Finnigan,63,4949800,7642401714557492,587,8230599,1858048,1859,1856189
16663,Shameeka Fishley,40,4734700,7023488664866683,512,7551078,6891910,689191,6202719
16664,Débora,62,4920100,6982674991594470,626,9268083,8997881,899789,8098092
16665,Violeta Quiles,56,2135700,3545824718494836,381,4487834,2124743,213,2124530
16666,Christy Gavory,64,2615000,8048623466842477,473,5506982,2115784,21158,2094626
16667,Mille Gejl,29,986000,3567869038295936,108,1331885,1273793,12738,1261055
16668,Makamae Gomera-Stevens,42,4574000,7454633793615234,492,7690747,6226776,0,6226776
16669,Chasity Grant,36,1283400,7467745198890857,168,2199136,617574,618,616956
16670,Malgorzata Grec,53,1186000,7162664388312485,257,2670770,2336002,233601,2102401
16671,Marion Haelewyn,47,4068200,9143874433736117,471,7098450,1109995,111,1109884
16672,Madison Hammond,44,623000,9457540747324914,182,1667362,678382,678382,0
16673,Shania Hayles,59,1933400,5043056348448492,381,4547392,4027896,0,4027896
16674,Janina Hechler,53,2008500,7785813354627036,326,4015829,1604146,160415,1443731
16675,Angharad James,34,1002700,7872161514973871,131,1496624,739568,73957,665611
16676,Katie Johnson,64,395900,5163025196244844,230,1781545,1544431,1545,1542886
16677,Lisa Josten,47,1605600,5683392158279220,283,3282233,1715899,17159,1698740
16678,Kanteh,38,4311600,5604388256668543,447,7407576,6360214,6361,6353853
16679,Isa Kardinaal,31,2468100,3188484268029690,257,3963324,587438,5875,581563
16680,Sarah Kassi,34,327100,4638233336138805,93,646814,66607,0,66607
16681,Missy Bo Kearns,45,2468500,7685312087924954,341,4396548,2108015,2109,2105906
16682,Leanne Kiernan,36,4014800,3682033066185619,421,6413957,123805,123805,0
16683,Gabrielle Lambert,22,2621700,8787869847021439,234,3850359,531414,5315,526099
16684,Alexandria Lamontagne,48,3749400,3043861779335066,417,5700400,3172834,0,3172834
16685,Landulaze,42,739300,9118970208379193,155,1449417,34702,3471,31231
16686,Mimmi Larsson,30,1725400,5161259556401774,158,2539267,2266031,227,2265804
16687,Elisa Launay,41,712000,3386376027221882,151,1448607,407430,408,407022
16688,Rose Lavaud,69,1263300,6195594478210166,409,3912045,1975988,1975988,0
16689,Rachael Laws,70,4668600,4689327601501767,700,8858789,263890,263890,0
16690,Anna Leat,31,2437400,8586501504667357,254,4013134,3569622,357,3569265
16691,Marie-Charlotte Léger,43,1142200,4980189059553660,204,2261536,1661370,0,1661370
16692,Fiona Liaigre,46,2840600,5581714536107024,370,4922282,1927071,0,1927071
16693,Lisa Lichtfus,51,3557100,5208198922901824,469,6384423,1264175,12642,1251533
16694,Jordyn Listro,47,3634900,4049403118797800,468,6903891,684804,0,684804
16695,Jimena Lopez,53,3903700,5001794207533314,536,7613371,5644757,5644757,0
16696,Sandy MacIver,24,3215300,5104412326704161,269,4678888,1855011,186,1854825
16697,Kaylan Marckese,63,2377600,3897903789214422,487,5373907,1161383,0,1161383
16698,Morgane Martins,22,2158600,8772293735578677,193,2836214,1956449,0,1956449
16699,Saskia Matheis,65,3520000,6657953333347286,585,7347202,1922015,19221,1902794
16700,Noko Matlou,67,1466200,8182828127054749,353,3790252,2197774,21978,2175796
16701,Jasmine Matthews,43,4061200,7887510031455972,448,6285907,974500,0,974500
16702,Esther Mbakem-Niaro,59,1943800,9487481408451191,348,4092849,3432358,0,3432358
16703,Tara McKeown,37,1927700,9623190817076627,254,3421270,305309,0,305309
16704,Naomi Megroz,41,2913800,4045443500216507,387,5260763,3562536,0,3562536
16705,Gift Monday,57,2067500,6978980412546319,357,4247319,1829312,182932,1646380
16706,Meikayla Moore,38,882000,9146391323350125,143,1484368,526215,52622,473593
16707,Cosette Morché,64,1385300,6952651610820691,342,3468326,1991407,0,1991407
16708,Yasmin Mrabet,26,1632400,7977288742737146,178,2480092,62433,0,62433
16709,Angel Mukasa,58,2916500,6660900979236790,458,5916787,3159915,315992,2843923
16710,Satara Murray,47,3348000,3535742884414324,431,5659124,3069637,30697,3038940
16711,Shannon O'Brien,63,688600,8902943716973788,291,2553602,1894551,1894551,0
16712,Ria Öling,30,3627600,9831997534928149,333,5303038,905816,9059,896757
16713,Regina Otu,24,406400,8580196955806151,48,371739,344012,3441,340571
16714,Célina Ould Hocine,26,1871100,3854965402790965,156,2416832,921387,921387,0
16715,Jasmina Pal,35,4788800,4808928925802433,477,7290067,2373663,238,2373425
16716,Aurore Paprzycki,65,3531000,5365856692565709,588,7177151,3484444,349,3484095
16717,Lucy Parker,30,4057300,3358837486587490,398,6264720,98411,985,97426
16718,Alison Peniguel,50,3476500,7786523178812624,416,5647174,2723407,2723407,0
16719,Paula Perea,37,4322500,4546527103734746,421,7138295,4124301,0,4124301
16720,Catalina Pérez,25,3124800,8533934610825962,278,4791689,3949903,3950,3945953
16721,Katharina Piljić,39,561300,6623285102996913,158,1307111,88488,0,88488
16722,Julia Pollak,68,3417400,8712904706613384,599,6917950,5634822,564,5634258
16723,Berta Pujadas,32,2468700,5905917109702027,258,3598153,1956576,195658,1760918
16724,Mariasun Quiñones,33,3531800,6944071816458580,366,5646402,620888,62089,558799
16725,Nina Richard,67,1175500,5032871046109347,339,3218241,875653,87566,788087
16726,Annalena Rieke,25,3043700,5071878173734182,255,4304848,1542088,155,1541933
16727,Bruninha,66,648500,6507046509495592,317,2816043,2035836,0,2035836
16728,Jasmin Sehan,43,3485300,8787057692206028,456,6656201,3488531,0,3488531
16729,Marie-Morgane Sieber,37,3803100,8607024839469522,365,5769169,3488101,3488101,0
16730,Caroline Siems,48,3757700,3110688022187304,454,6382522,2361145,236115,2125030
16731,Catarina Amado,61,3848900,7461319479942192,476,6582831,4498320,0,4498320
16732,Ana Seiça,33,4968500,8054305014327664,492,7417108,3741969,375,3741594
16733,Teninsoun Sissoko,41,4826300,9104277735254883,541,8286248,1677484,16775,1660709
16734,Havana Solaun,59,499600,7615613827159502,253,2245628,490719,490719,0
16735,Soldevila,23,2420700,4281820415344210,212,3349445,1895581,190,1895391
16736,Lucy Staniforth,66,3978900,7485678540601591,586,8263732,4971871,0,4971871
16737,Beke Sterner,48,4402400,5652944322222041,499,7544104,5617139,5618,5611521
16738,Zoé Stiévenart,47,955100,9215605362394851,211,2206375,222936,0,222936
16739,Kinga Szemik,30,1496600,4096652322219592,142,2204904,2048206,2048206,0
16740,Katriina Talaslahti,36,2086100,5221258196371810,270,3547489,83031,8304,74727
16741,Laurie Teinturier,40,3574900,8416004438092506,413,6160623,4897162,490,4896672
16742,Meriame Terchoun,37,1509400,4318755922423999,174,2386416,309226,310,308916
16743,Elisabeth Terland,31,3353900,5787871082212214,332,5181721,2971881,0,2971881
16744,Amelie Thöle,43,3646200,6657667418132501,411,5772612,147397,0,147397
16745,Alyssa Thompson,36,1193400,9084799879778276,201,2309825,1107022,11071,1095951
16746,Sam Tierney,62,1850900,3269003451718507,405,4189721,1830531,1831,1828700
16747,Taryn Torres,44,3452500,3701518262654618,345,5300767,2528718,252872,2275846
16748,Michele Vasconcelos,31,3449800,6152924972033577,309,5034959,1444076,145,1443931
16749,Mallory Weber,44,2740900,7597531852898248,355,4919432,4646127,0,4646127
16750,Laura Wienroither,44,2627600,4582271661098792,359,4663743,3894274,3895,3890379
16751,Julia Zigiotti,59,2714300,3461233013008917,485,5478233,964000,9640,954360
16752,Adriana Achcińska,41,1375900,9289093992152133,217,2427967,2261243,226125,2035118
16753,Marie-Yasmine Alidou,38,2992600,4073337736162067,294,4714769,1830321,184,1830137
16754,Michelle Alozie,50,4344100,6295929632097768,559,8020831,4698012,4699,4693313
16755,Lydia Andrade,37,4831500,6950676908091485,427,6674452,2442608,244261,2198347
16756,Halimatu Ayinde,64,4396900,9302564169441745,579,8634912,6949162,6949162,0
16757,Romy Baraniak,33,2426000,9461097176198435,258,3988437,2650424,2650424,0
16758,Kara Bathmann,45,638700,8968659146516479,166,1516236,985639,9857,975782
16759,Hillary Beall,47,3340800,8114085062238160,376,5430950,3579114,358,3578756
16760,Vanessa Bernauer,33,2446800,6502735392365992,262,3952212,2675827,2675827,0
16761,Jenna Bike,40,2000700,7953252207352980,254,3438363,2567523,256753,2310770
16762,Julie Blakstad,62,929100,7212650834307859,282,2609241,1578975,15790,1563185
16763,Ninon Blanchard,51,3354600,6247938640918924,436,5835806,3065232,307,3064925
16764,Jassina Blom,48,1788400,3452182312978401,266,3556561,32977,0,32977
16765,Jordyn Bloomer,35,655500,7022724563212759,143,1442839,1020860,102086,918774
16766,Anneke Borbe,60,4492800,7113078327512441,594,7970615,5730522,573053,5157469
16767,Federica Cafferata,33,2734100,8631624146717955,264,4072686,2947960,0,2947960
16768,Ainoa,58,4196900,5872508009041335,568,7583578,4528194,0,4528194
16769,Marta Cintra,54,591600,8777780906236643,228,2088876,452453,0,452453
16770,Oluwatosin Demehin,60,2836200,6747578194916602,439,5583797,5290755,0,5290755
16771,Claudia Dickey,31,3059200,7354587777573192,301,4685170,223259,22326,200933
16772,Rieke Dieckmann,49,3242000,5545683608485345,434,5964856,1587772,1587772,0
16773,Kim Dubs,45,2011500,6420359213897409,348,4282027,771767,772,770995
16774,Laureta Elmazi,22,1647200,8404284238312066,140,2288487,1025341,0,1025341
16775,Alexandra Emmerling,55,4048400,5470843878549252,499,6927069,5291194,529120,4762074
16776,Samantha Fisher,38,4249700,6234196492274802,409,7076284,4412403,4413,4407990
16777,Natasha Flint,65,3743500,4488648461993243,519,7147908,1337961,1338,1336623
16778,Sabrina Flores,26,2819400,6905446504961479,222,3703973,2758203,2758203,0
16779,Sarah Freutel,70,3079500,9691005795489476,535,6447675,5379692,537970,4841722
16780,Vanessa Fudalla,70,1186500,8779951376214801,382,3709528,3397525,33976,3363549
16781,Rachel Furness,39,393000,4532378101573568,126,1018603,21553,21553,0
16782,Sílvia Rebelo,31,3875700,7224111488455043,382,5552820,796702,0,796702
16783,Andrea Gavrić,45,4957000,7663322974230373,475,7366174,3275850,0,3275850
16784,Anna Gerhardt,70,2519500,7714153165502825,500,5832926,977920,9780,968140
16785,Lisanne Gräwe,43,2550000,9796782603821759,368,4671455,4053869,40539,4013330
16786,Sarah Griffith,43,1258700,5534350756822209,236,2531029,1652708,16528,1636180
16787,Sheila,31,4076900,3512634815296291,377,6158597,3176969,0,3176969
16788,Synne Skinnes Hansen,24,2683700,7750311258236639,199,3684812,1049904,104991,944913
16789,Emma Harries,40,4652900,7983745530163745,504,7658245,3598582,359859,3238723
16790,Abigail Harrison,30,4380200,8546384577778209,380,6535682,4305032,430504,3874528
16791,Lucy Hope,70,4977300,9412450934316212,691,9392715,2159947,216,2159731
16792,Océane Hurtré,69,3193700,9129887596020185,572,6504372,5825678,58257,5767421
16793,Brittany Isenhour,43,1581500,4762105759846946,214,2589891,1691388,1691388,0
16794,Laurel Ivory,28,4672700,5304145817672131,436,6986965,3713114,37132,3675982
16795,Uchenna Kanu,30,2403300,5449931340692239,234,3356706,522621,0,522621
16796,Devon Kerr,58,2338800,6675271848473608,394,5113185,1461061,147,1460914
16797,Rebecca Knaak,68,2056700,5611873948117056,465,4926777,3095845,0,3095845
16798,Camilla Küver,59,1058100,3466714178646284,298,2973303,440294,4403,435891
16799,Lee Young Ju,64,2975900,3579416064753222,489,5875692,2500988,2501,2498487
16800,Nastassja Lein,63,3148300,9892188834534825,442,6069727,4818496,0,4818496
16801,Eva Llamas,61,1482300,3475978463662913,393,4123886,846527,84653,761874
16802,María Llompart,54,3969600,5987545530272637,514,7099715,3516747,351675,3165072
16803,Vicky López,67,309300,9689732846446508,293,2156889,1018479,0,1018479
16804,Rikke Madsen,41,825100,6504668275420312,197,1802967,685459,6855,678604
16805,Tuana Mahmoud,67,3725700,3103393878610994,533,7168651,5866152,5866152,0
16806,Andreia Faria,50,1193000,6275386939595006,274,2765928,2124013,0,2124013
16807,Addie McCain,24,4081900,6487501485140577,372,6500576,2406682,241,2406441
16808,Charlène Meyong,43,3486700,3957127014165237,415,6113309,2223202,0,2223202
16809,Anna Moorhouse,55,2513800,6234790779620921,358,4782302,4405714,0,4405714
16810,Wifi,37,818300,6593054000126385,180,1750345,843229,844,842385
16811,Ffion Morgan,61,2010800,3111602000118728,364,3979669,1219690,0,1219690
16812,Lily Nabet,68,2318300,9262759721104482,461,5511662,4279346,4280,4275066
16813,Hanna Németh,23,2406900,5791404822174242,217,3430720,1789467,0,1789467
16814,Monique Ngock,68,1108000,5383337901901113,389,3486862,2098339,210,2098129
16815,Lena Nuding,63,1608200,9465751917948188,385,3901163,2389826,0,2389826
16816,Aimee Palmer,30,776600,9738896430486703,123,1211002,1078769,0,1078769
16817,Poppy Pattinson,49,1821500,4780666209684296,288,3412714,2369912,237,2369675
16818,Lea Paulick,51,1779500,7630847234716715,308,3420303,1526561,152657,1373904
16819,Marine Perea,60,335500,9442275258673410,266,1909866,1604207,161,1604046
16820,Cindy Perrault,29,392000,5153776467850637,100,825506,322492,3225,319267
16821,Julie Pian,52,4867600,4785822246669122,604,8751834,3131356,3132,3128224
16822,Viktoria Pinther,37,3911600,7578769191860660,432,6796788,1732009,174,1731835
16823,Taylor Porter,31,2303600,6700307221188025,208,2952482,1133897,1134,1132763
16824,Ella Powell,41,461500,8134990298471315,167,1364387,1155653,115566,1040087
16825,Louna Ribadeira,46,3773800,6631088895441998,413,5761152,680177,681,679496
16826,Paula Romero,41,1035300,6034257820082858,211,2301582,1769709,0,1769709
16827,Cecilía Rán Rúnarsdóttir,49,4659400,8570721761240208,455,6674316,2180756,2180756,0
16828,Noelia Salazar,39,3616300,8328181880429468,419,5903285,3243980,0,3243980
16829,Andrea Falcón,61,4624300,6679526641576629,639,8701758,1392435,13925,1378510
16830,Pauleta Sancho,56,1032300,3354387511057859,247,2580771,2452529,0,2452529
16831,Cecilie Sandvej,42,2331300,9999954899124721,314,4299845,3498301,3498301,0
16832,Amelie Schuster,39,2031900,7970921595014742,282,3294572,3263429,3264,3260165
16833,Jaedyn Shaw,36,4739800,5347244789786804,481,7849231,1193328,1193328,0
16834,Bénédicte Simon,59,2029800,4129026730231923,378,4506128,2930037,294,2929743
16835,Lúcia Alves,29,2859500,5572151437831882,267,4552882,1130761,0,1130761
16836,Maja Sternad,38,433900,6302503165339332,115,887176,730038,73004,657034
16837,Mylaine Tarrieu,39,4301400,6147692087624135,454,7001321,5563552,557,5562995
16838,Kenni Thompson,66,1832800,6139960912744530,409,4813930,681808,682,681126
16839,Berglind Björg Þorvaldsdóttir,52,3349700,4559786391976052,422,5520800,1160689,11607,1149082
16840,Christy Ucheibe,49,3557200,9923292313892605,458,6705655,4644152,464416,4179736
16841,Bruna,51,3510900,5417305322826627,475,6151684,2545325,0,2545325
16842,Viviana Villacorta,42,1376500,7456588247411929,231,2758154,1539009,154,1538855
16843,Selina Vobian,37,2491300,9468403535328955,292,4038505,3991311,39914,3951397
16844,Laura Vogt,22,2410600,6459199371464385,189,3089030,2330140,234,2329906
16845,Martyna Wiankowska,41,4813100,4771267817099568,457,7607544,5625171,5625171,0
16846,Verena Wieder,38,3557200,6595411362458598,341,5193801,1198665,1199,1197466
16847,Jenna Winebrenner,23,1689300,6071596756512289,118,2050722,236089,237,235852
16848,Dóra Zeller,50,3210200,9215352857288620,425,6299628,3094611,3094611,0
16849,Ainhoa Alguacil,26,2503700,9852636787189730,209,3626029,2665139,267,2664872
16850,Joelle Anderson,37,4249300,7222779879767215,465,6764885,3994502,399451,3595051
16851,Anaëlle Anglais,30,3801200,4362789295125446,323,5373392,3906079,0,3906079
16852,Naomie Bamenga,22,3616900,8842682901593493,299,4948561,163978,164,163814
16853,Kiara Beck,37,1156000,8571802767507181,148,1896721,328392,0,328392
16854,Natalie Beckman,26,606200,9406705268788124,90,894953,45563,45563,0
16855,Guro Bergsvand,53,4905400,5956832338767948,605,8682692,3857931,0,3857931
16856,Hannah Betfort,29,2180900,4735862562642103,223,3105462,1447427,0,1447427
16857,Kerstin Bogenschütz,31,653200,5968307133271560,106,1096300,291185,0,291185
16858,Barbara Brecht,37,2520200,5554438871964880,268,3796080,1951756,1951756,0
16859,Esmee Brugts,42,922200,7525380601142102,237,2235072,2114938,0,2114938
16860,Solène Champagnac,24,3238500,3854961701628342,280,4479095,1918943,0,1918943
16861,Mikayla Cluff,57,516900,9936333416069795,214,1841512,1787221,179,1787042
16862,Lotta Cordes,65,4205000,6100674179132082,559,8352424,7522916,7522916,0
16863,Yana Daniëls,26,3202500,4653178735539658,264,4773747,506080,5061,501019
16864,Julia Debitzki,68,3710700,9990649929065628,501,6641292,2793368,0,2793368
16865,Hillary Diaz,70,838500,3887238305940906,294,2482206,1469093,14691,1454402
16866,Vanessa Diehm,44,3094100,3068037315387369,414,5233391,2886626,2886626,0
16867,Petra Divišová,53,1658300,6076332204070206,316,3439236,1981832,1981832,0
16868,Julie Doyle,64,1432600,3192132890398014,375,3977230,2146519,21466,2125053
16869,Maria Edwards,68,3977200,4096506249998363,644,8712318,321284,322,320962
16870,Maddie Elwell,49,869800,4471974138521535,200,2031442,1796054,1796054,0
16871,Sophie Fournier,56,1606800,5398709157958947,291,3606636,1415552,0,1415552
16872,Sonia Majarín,28,926800,9894439205170884,124,1419508,988131,98814,889317
16873,Maryne Gignoux,30,396700,6280957207139331,90,691256,624000,624,623376
16874,Luisa Guttenberger,41,2160000,6112858320077140,258,3538755,407039,40704,366335
16875,Elvira Herzog,62,908300,4970107163884679,251,2461180,1355786,0,1355786
16876,Marie Höbinger,41,4257800,3098556123127057,461,6770444,4745702,4745702,0
16877,Rebecca Holloway,33,4354300,5914440903331051,410,6318493,3270947,3270947,0
16878,Rofiat Imuran,69,756100,6177760748720052,346,3112011,2704692,2705,2701987
16879,Sarah Jankovska,55,953500,9403630012411027,288,2894643,2580317,0,2580317
16880,Emma Jansson,37,1684000,3518078182312763,209,2831148,1495994,149600,1346394
16881,Jelena Karličić,34,4693900,9992135231346395,438,7479645,4636795,0,4636795
16882,Sam Kerr,28,319400,9326889503529810,58,367853,177431,0,177431
16883,Kristin Krammer,70,439600,6921965980781674,379,3103868,3014040,0,3014040
16884,Kathrine Kühl,26,2240900,4979512423820634,197,3237505,828920,82892,746028
16885,Savannah Madden,34,2949300,5868841572160343,276,4449955,1612282,16123,1596159
16886,Ena Mahmutovic,27,3251000,4140837370811478,276,4891046,273255,0,273255
16887,Marina Martí,45,3705000,4478952849347669,435,6272279,3773371,3773371,0
16888,Olivia Mbala,55,345700,8362659128373977,229,1847453,195060,1951,193109
16889,Phoebe McClernon,23,1213200,3782630532428568,102,1418736,573581,5736,567845
16890,Teresa Mérida,36,2750400,5264058306489806,351,4712983,760606,0,760606
16891,Ari Mingueza,33,4889600,4400424846644553,423,7538307,4648108,4648108,0
16892,María Molina,57,582800,9768140667934301,229,2063178,575620,57562,518058
16893,Marlene Müller,53,1327600,9321840006689605,318,3101824,1185143,118515,1066628
16894,Esther Okoronkwo,30,1962400,7002568569660153,202,2961861,2321800,232180,2089620
16895,Xènia Pérez,62,2219700,8525624778358959,393,4493644,596546,596546,0
16896,Alayah Pilgrim,61,1017000,6568772520656530,287,2664837,53386,0,53386
16897,Allegra Poljak,25,2461300,9659896351634225,214,3576627,43771,0,43771
16898,Gabby Provenzano,41,4866700,6072285518437500,505,8029555,7244287,72443,7171844
16899,Gio Queiroz,31,3446000,9503439390048969,313,5303923,4415796,4415796,0
16900,Maïwen Renard,23,3690500,6742339619323041,314,5005600,4510055,4511,4505544
16901,Izzy Rodriguez,49,4384000,3002960645425088,527,7226839,4522303,0,4522303
16902,Fatma Sakar,53,1625900,6838953920598013,270,3044520,476127,47613,428514
16903,Delanie Sheehan,64,1520700,5028769342530830,360,3704188,1124485,113,1124372
16904,Marissa Sheva,47,510100,8301480780397949,211,1724499,1022459,0,1022459
16905,Kysha Sylla,47,1374000,7588379266742851,244,2624652,137390,13739,123651
16906,Frankie Tagliaferri,41,745700,3620640856419494,165,1680528,567487,56749,510738
16907,Lena Uebach,50,4784300,5046446857544790,492,8187068,316806,317,316489
16908,Roos van der Veen,44,4175200,6778053058134464,435,6613686,1464186,1465,1462721
16909,Rosa van Gool,63,2179300,9888392203465757,390,4543868,903848,903848,0
16910,Soraya Verhoeve,43,4335100,8365856054405271,450,7263471,6740941,0,6740941
16911,Ricarda Walkling,22,482700,7049638407678591,28,270412,222886,0,222886
16912,Clare Wheeler,43,1032800,5622885673248345,174,2001517,1106894,1107,1105787
16913,Reena Wichmann,60,2660300,5943219564537191,441,5807134,799578,79958,719620
16914,Shae Yáñez,26,3960900,7768343063480171,313,5462224,3066837,3067,3063770
16915,Aleksandra Zaremba,60,1024900,7130064579824538,323,3227720,286815,287,286528
16916,Yolanda Aguirre,42,2419800,4461029629893052,316,4408295,1409406,14095,1395311
16917,Arola Aparicio,36,4634900,8252485116157206,408,6984432,5886908,0,5886908
16918,Olivia Athens,70,4180200,5233751646199550,595,7635572,4483840,449,4483391
16919,Lorena Azzaro,55,1562700,9571222580669523,311,3424351,3213708,3213708,0
16920,Yewande Balogun,33,2944800,4159223260372069,269,4050969,899453,899453,0
16921,Morgane Belkhiter,46,2128100,7144904241932147,283,3637273,2576858,2577,2574281
16922,Inès Benyahia,61,1360900,6365171832459332,349,3822714,3488987,3489,3485498
16923,CJ Bott,69,4263000,6651012246848408,687,8948790,6861612,0,6861612
16924,Emilie Bragstad,51,2895200,4565950507277872,433,5413317,5321334,5322,5316012
16925,Ryanne Brown,25,3174900,7068453138355801,282,4581248,4012013,4012013,0
16926,Mia Büchele,33,1979400,4509694656278537,260,3350663,3120786,0,3120786
16927,Nayluisa Cáceres,23,3391000,6571066101807815,259,4428257,2008951,0,2008951
16928,Klára Cahynová,43,3142100,6038828156781174,402,5384612,2828935,28290,2800645
16929,Marley Canales,64,4788200,8392511504807976,597,8726730,3848891,0,3848891
16930,Estela Carbonell,44,4581900,9548947099339066,480,7803355,2606891,261,2606630
16931,Marjorie Boilesen,41,1737300,8984081018528093,239,2870038,620514,620514,0
16932,Sydney Collins,57,4588200,5263526807732644,559,8437216,1031176,10312,1020864
16933,Caitlin Cosme,70,1838100,5402262874617297,376,4300742,3692784,369279,3323505
16934,Cristina Cubedo,30,1042100,4418455827175363,102,1336215,926978,9270,917708
16935,Chardonnay Curran,26,4320900,6505714751008457,402,6450463,1768177,176818,1591359
16936,Ana Carol,64,3169800,4003026645054066,524,6485891,1892715,189272,1703443
16937,Laura Donhauser,27,4884900,4582688452807008,378,7019854,458355,458355,0
16938,Sinead Farrelly,42,4332400,4085063306206085,502,7219919,5953040,5954,5947086
16939,Kayla Fischer,43,3188600,9226566119137046,373,5206322,2737588,273759,2463829
16940,Claudia Florentino,41,2149700,8073951835396313,262,3434778,701431,0,701431
16941,Megan Foley,60,1240800,5874741114088693,285,2819065,2264206,0,2264206
16942,Magnaba Folquet,32,3432700,5102772634356691,362,5375774,2221475,2221475,0
16943,Gemma Font,55,2871800,6216829392932020,437,5332188,1400623,0,1400623
16944,Mairead Fulton,34,3510900,3088899694204374,368,5581493,4006174,401,4005773
16945,Parker Goins,43,4954800,5092009797524293,481,7817393,4400791,4400791,0
16946,Emily Gray,31,4298500,7914170546596472,393,6673531,3376280,3376280,0
16947,Meret Günster,53,525700,5413670150315191,200,1784482,74025,0,74025
16948,Sofia Hagman,51,334200,5626553881837206,170,1254727,939285,940,938345
16949,Jenny Hipp,35,1688800,6081295021766995,239,2884607,626224,62623,563601
16950,Patrícia Hmírová,51,4816600,5040515067180519,503,7709973,1683528,1684,1681844
16951,Isabelle Hoekstra,50,1134500,3375726921665365,244,2609325,400119,0,400119
16952,Haley Hopkins,39,678300,8075123972499324,147,1418825,587266,5873,581393
16953,Thaïs Hurni,22,777600,6170232458011984,57,766300,137977,137977,0
16954,Jill Janssens,67,1182100,5145563775397899,326,3132658,1078511,0,1078511
16955,Ellie Jean,67,4158400,3915040387308101,617,8137465,6749312,6749312,0
16956,Samantha Jerabek,61,4681200,9771373900065639,561,8115027,6445992,64460,6381532
16957,Laury Jésus,66,4467300,4008566142259658,596,7945286,206690,207,206483
16958,Mathilde Kack,23,3429100,7563834505216527,272,5098715,3700741,37008,3663733
16959,Julia Kappenberger,51,2653500,6798492531871779,408,5430663,3884079,38841,3845238
16960,Frederike Kempe,39,4080400,6821339618481681,426,6731607,1183380,1183380,0
16961,Sarah Klotz,37,4437800,7391808345338456,450,7342732,5436214,0,5436214
16962,Inès Konan,46,4688500,4471646013053271,532,7751174,7261382,0,7261382
16963,Civana Kuhlmann,50,4484800,5687691143622480,563,8124173,2912574,0,2912574
16964,Brenna Lovera,39,371100,8974210732840463,139,1096376,542665,542665,0
16965,Emily Madril,52,4657700,3639603944057238,548,7865649,2831706,2831706,0
16966,Julia Magerl,38,4003300,6784611524816021,462,6509367,3229683,3230,3226453
16967,Taylor Malham,33,2419000,6210559759088762,259,3967352,1297008,12971,1284037
16968,Alyssa Malonson,37,4701300,7537642119734013,493,8204357,5712814,571282,5141532
16969,Jessica Martínez,54,1939900,6044456789285999,341,3972010,2614922,2614922,0
16970,Jessica May,67,4630400,7904188388376100,691,9505573,5341583,534159,4807424
16971,Paige Metayer,54,1059700,6436031182133892,266,2769453,1245688,1245688,0
16972,Christin Meyer,55,963200,3023437127708152,286,2526918,1912025,0,1912025
16973,Raquel Morcillo,47,4976900,9574249772399025,587,8481168,1636866,1636866,0
16974,Noémie Mouchon,30,4004400,3912938824221057,430,6936983,3530227,354,3529873
16975,Lisa Fjeldstad Naalsund,43,553900,7878872567271391,183,1626087,948011,0,948011
16976,Isabella Obaze,60,3990200,5042205897384604,544,7260278,1766463,177,1766286
16977,Irene Oguiza,62,2364000,6110191705339199,433,5133756,3356438,33565,3322873
16978,Kaitlyn Parcell,67,1079600,3291882762264593,331,3178722,728902,72891,656011
16979,Amaia Peña,67,2254800,7613591155371071,410,4849350,1467571,1468,1466103
16980,Océane Picard,39,1136500,9651722986092092,196,2051432,1053286,105329,947957
16981,Kiki Pickett,64,989700,5243356631328762,354,3195098,843292,84330,758962
16982,Elli Pikkujämsä,46,1638100,3117303103275720,244,3199613,1156883,115689,1041194
16983,Alice Pinguet,59,2401900,3231258187991386,412,4928322,4528261,452827,4075434
16984,Aldrith Quintero,63,3501600,6547373425590878,527,6401172,575987,5760,570227
16985,Gianna Rackow,56,4785000,6205706820820947,580,8785831,4689946,4690,4685256
16986,Emma Ramírez,29,4014300,5314119670969634,384,5839506,1837924,184,1837740
16987,Marion Rey,58,2244000,9602133130216839,419,4880678,3812460,0,3812460
16988,Anaïs Ribeyra,23,3995100,8147932899361492,337,5854656,2716483,27165,2689318
16989,Clau Blanco,44,4521200,4483025078393837,513,7874105,276746,0,276746
16990,Jessy Danielle Roux,65,3495500,8153058516852583,555,7282810,4501097,0,4501097
16991,Josefine Schaller,33,3392500,7327412683108185,355,4890797,2064279,0,2064279
16992,Lara Schmidt,52,611300,8930224222789162,259,2110331,1979818,1979818,0
16993,Gabriela Šlajsová,47,4408800,7697809644470640,508,7538356,3275561,3276,3272285
16994,Gema Soliveres,36,3694700,7424757961558416,412,5892648,756917,757,756160
16995,Kattalin Stahl,22,4631800,9351640341151491,342,5929208,4867778,487,4867291
16996,Dejana Stefanović,70,710800,9660705041626520,360,3002990,1464731,147,1464584
16997,Riley Tanner,62,3937200,4205215104567092,576,7568098,5978771,5979,5972792
16998,Chloé Tapia,43,2294900,6461753125914433,314,4218236,774280,774280,0
16999,Cameron Tucker,22,4467300,8905196824464025,371,6491139,4177949,4178,4173771
17000,Amber Tysiak,39,4319500,6101841639908115,433,7066018,5609829,560983,5048846
17001,Itxaso,56,2861100,7113218434939715,477,6143110,5654985,566,5654419
17002,Dionne van der Wal,67,880200,8979391983619039,311,2815779,247641,2477,245164
17003,Elba Vergés,27,4375600,6345095601945343,391,6469175,5608359,5608359,0
17004,Denisa Veselá,43,1819700,5663883138521217,269,3135490,2461921,2461921,0
17005,Mary Alice Vignola,48,4817500,4598536794214082,525,8240099,662230,6623,655607
17006,Sophie Weidauer,30,3612300,8045677005079886,365,5692398,5627621,5627621,0
17007,Michelle Weiß,30,4291300,3320802965755206,457,7289348,6098900,610,6098290
17008,Katja Wienerroither,31,4893600,9236900675105512,387,7006336,298013,2981,295032
17009,Olivia Wingate,60,3465700,6760398503169368,480,6354385,1022915,1023,1021892
17010,Oliwia Woś,54,1853900,9871346465427107,361,4173298,1500815,150082,1350733
17011,Zaneta Wyne,30,2751100,7902511415911852,296,4135721,590910,5910,585000
17012,Rebecca Adamczyk,52,1734300,3561867215185678,282,3494273,1242318,1242318,0
17013,Anna Aehling,36,1805500,6521934270104317,226,2729531,846253,0,846253
17014,Roberta Aprile,33,1215400,3360877653568571,141,1868017,1580584,159,1580425
17015,Izzy Atkinson,27,2676300,9487433018957679,265,4174625,3840956,0,3840956
17016,Eve Boettcher,66,994400,5801589903607584,358,3261237,2292445,22925,2269520
17017,Berta Bou,43,3536400,6150551137649357,457,6553356,5536126,553613,4982513
17018,Ellie Brazil,36,587000,6089165580366885,105,937019,854577,0,854577
17019,Chiara Bücher,48,804700,4081516354878507,231,2336701,251762,0,251762
17020,Scarlett Camberos,42,3033900,5237976789608738,355,5071368,1029343,0,1029343
17021,Dorine Nina Chuigoué,41,3366300,4246626436780264,428,6138666,5535057,554,5534503
17022,Grace Clinton,30,744300,4182358303112579,98,1009722,313378,3134,310244
17023,Michelle Cooper,32,4957300,7314301330440918,450,7594305,109969,110,109859
17024,Elena De Toro,62,714000,3031982550599709,324,2974793,1348861,1348861,0
17025,Laura Dick,62,2841900,8969498921119336,530,6431068,4404232,441,4403791
17026,Laís Araújo,60,3212000,6905314599548322,528,6873689,1101765,111,1101654
17027,Nicole Douglas,32,3650600,3923101046861581,332,5507331,2003823,0,2003823
17028,Annika Enderle,47,4022500,7189525392894674,504,7307899,2177124,21772,2155352
17029,Garazi,26,2230100,3163185903416066,213,3432014,3229341,3230,3226111
17030,Felicitas Fee Kockmann,45,1005100,9024570352706901,211,2219984,423123,4232,418891
17031,Lara Felix,22,1767200,7640981065309176,127,2129759,626757,0,626757
17032,Kim Fellhauer,44,2108700,5881866540778811,274,3794635,3108550,0,3108550
17033,Mel Filis,43,2305400,9949822941789241,325,4268376,2353813,235382,2118431
17034,Lisa Forrest,43,794900,4594274169587337,164,1649436,1472670,1473,1471197
17035,Núria Garrote,56,1414000,7417127728410511,291,3282181,1245596,1246,1244350
17036,Anna Gasper,66,4143100,3824466463041307,594,8384341,4768120,0,4768120
17037,Kit Graham,27,3286500,9612773434311879,284,4703284,108356,109,108247
17038,Enora Guillois,50,639300,6250602829132711,225,2023423,419115,0,419115
17039,Mackenzie Hawkesby,52,2574800,7311496597803228,414,4889771,2755974,2756,2753218
17040,Sandra,34,4556300,5612770310115538,405,6975989,3759842,37599,3722243
17041,Penelope Hocking,56,2992500,9874639895476559,457,6115131,2648248,2649,2645599
17042,Sara Holmgaard,69,1408000,7677817896415706,373,3907226,3370979,338,3370641
17043,Carlotta Imping,25,4180300,6686492553933755,337,5958350,2153469,0,2153469
17044,Vivian Kaspar,62,2075100,8980809372246524,413,4656548,1614703,1615,1613088
17045,Julia Kassen,25,1737500,8237078119688956,153,2456562,1792291,0,1792291
17046,Lisann Kaut,50,3448800,5140972964992574,445,6481667,4135432,4135432,0
17047,Viktoria Kazakevich,47,1865600,3135603691108240,288,3740468,987147,9872,977275
17048,Alika Keene,68,369600,9908766455088076,324,2673416,76806,0,76806
17049,Milicia Keijzer,24,2587700,6612731711306075,199,3299453,2926520,29266,2897254
17050,Kinga Kozak,40,4140300,6497623198499376,418,7033482,379297,379297,0
17051,Victoria Krug,28,569000,8326037883529345,66,678200,580750,5808,574942
17052,Demi Lambourne,24,2294400,5269188839006819,193,3279513,1905600,191,1905409
17053,Anaële Le Moguédec,35,3752900,9671467053084990,402,6127152,2265164,226517,2038647
17054,Pia Lucassen,63,3378700,7655850110316061,458,5829251,4694388,469439,4224949
17055,Franziska Mai,54,1542900,7253011393886632,273,3208657,330594,0,330594
17056,Alina Mailbeck,67,2544600,8392389017484868,532,5931152,4486039,449,4485590
17057,Aoife Mannion,24,4626300,4290606787862355,385,6383239,3136979,3137,3133842
17058,Anna Margraf,45,4920700,7687514300088516,543,8270266,7314681,0,7314681
17059,Lucia Martínez,40,4515700,3053588711499909,507,7838362,2741935,0,2741935
17060,Laura Martínez,46,2469100,7318180933120801,328,4317681,3335223,3336,3331887
17061,Amanda Mbadi,40,1855500,6050951559718968,263,3268740,2928222,0,2928222
17062,Kayla McKenna,67,4633600,5070726668218358,682,9479551,8027227,8028,8019199
17063,Júlia Mora,34,4473600,3441705312403926,460,6850439,5453968,546,5453422
17064,Chloe Mustaki,41,2639200,5661858937861262,325,4600402,1704104,1705,1702399
17065,Natalie Muth,46,1115300,7556335007736936,233,2441343,2260338,2260338,0
17066,Chloé N'Gazi,48,3982100,3741890789934250,457,6292975,3487960,3487960,0
17067,Marjolen Nekesa Wafula,60,3780800,6640034821644992,568,7342429,2286908,2287,2284621
17068,Morgane Nicoli,47,2293100,8033596277771861,353,4240038,904431,90444,813987
17069,Jenna Nighswonger,43,1948200,5585005153058052,291,3652736,935608,936,934672
17070,Léa Notel,52,1960000,5696968200141386,321,3964205,3368317,337,3367980
17071,Sara Ortega,48,1461900,6203268316053572,279,2891846,2417110,0,2417110
17072,Mackenzie Pluck,29,3296400,7937771080997752,286,4749024,2466103,246611,2219492
17073,Emily Ramsey,65,2372400,5452872070930088,494,5294532,2865327,0,2865327
17074,Jade Rastocle,23,4915200,8137820637084152,454,7813408,4278619,0,4278619
17075,Reyna Reyes,64,1953900,3985464089428752,401,4458099,467601,46761,420840
17076,Jayde Riviere,64,3592200,6065237088645435,521,6667996,4328682,0,4328682
17077,Clara Robbins,57,1328200,3509883186192972,285,3005943,2616808,261681,2355127
17078,Gisela Robledo,46,3556600,8255727738518796,408,6355867,2919758,0,2919758
17079,Charlize Rule,25,2428800,8915302596042329,206,3529887,2398256,0,2398256
17080,Rebekka Salfelder,36,4543600,8999654000975629,425,6994691,5790727,580,5790147
17081,Hawa Sangaré,70,1384000,8544441125440215,360,3649033,2122549,212255,1910294
17082,Izarne Sarasola,22,3366500,4736388272861156,284,4556347,2939328,0,2939328
17083,Remy Siemsen,42,1395300,7812320964862491,207,2378148,1586943,158695,1428248
17084,Emma Snerle,44,2921100,3990354977007152,397,5585755,4757280,475728,4281552
17085,Elise Isolde Stenevik,65,2096000,7616239091390214,411,4776383,397776,39778,357998
17086,Cori Sullivan,29,2827600,5265387915588171,240,4012068,2737698,0,2737698
17087,Martina Šurnovská,50,4700000,7396857154875855,480,7309343,6285382,629,6284753
17088,Amy Turner,43,3329400,4639374216915947,394,5297369,3242107,324211,2917896
17089,Vita van der Linden,70,3423300,5983192801211035,590,7027289,2364507,237,2364270
17090,Claire Walsh,29,579600,3694677581478411,101,958983,597380,0,597380
17091,Carlotta Wamser,28,375100,3390863084901624,47,378445,206220,206220,0
17092,Charlotte Wardlaw,26,855300,3147405096002109,84,992188,234123,0,234123
17093,Chloe Warrington,47,2901700,7908208961702780,345,4541798,1519738,0,1519738
17094,Anna Wellmann,58,3750900,3315512650071939,511,7262874,2407573,0,2407573
17095,Jessica Ziu,27,2331000,9674062883912148,183,2906066,1022690,103,1022587
17096,Maite Zubieta,62,566500,6145284777909857,296,2581209,502504,0,502504
17097,Mara Alber,46,3229600,3899215389210609,418,5184805,2262509,2263,2260246
17098,Alina Axtmann,59,443600,6133373363727563,217,1801682,1243626,125,1243501
17099,Paulina Bartz,62,3679200,3372044522288886,570,6905180,2456216,24563,2431653
17100,Faustine Bataillard,31,578700,7042801407692564,109,1008527,180848,1809,179039
17101,Natalia Bidas,35,4971400,4720616958955898,522,8535694,1878962,0,1878962
17102,Tess Boade,60,2520600,4219577721805456,402,4956689,586383,58639,527744
17103,Lou Bogaert,64,4506300,4936083397133301,637,9333340,3939804,3940,3935864
17104,Lyza Bosselmann,27,2296400,5800489954533429,237,3346152,2602537,2602537,0
17105,Lauren Brzykcy,68,4842300,7884650004866190,678,8870560,4933664,494,4933170
17106,Carla Camacho,51,2508800,5908902287217431,380,4751608,802707,0,802707
17107,Tiffany Cameron,50,3581400,6295808008400679,432,6654348,1305767,1306,1304461
17108,Carmen Carbonell,37,1791700,3222252764627761,240,3093734,1343822,0,1343822
17109,Eartha Cumings,53,892000,6903556410178977,305,2733907,652463,65247,587216
17110,Chiara D'Angelo,66,4073100,8253051345944549,626,7973504,5826068,58261,5767807
17111,Isabella D'Aquila,70,1049800,8595877814138780,363,3382261,602572,60258,542314
17112,Gina Ebels,39,1269400,8119090606560098,230,2729096,2563205,0,2563205
17113,Hannah Etzold,57,1673300,5897880751586690,388,4081084,1902605,191,1902414
17114,Daniela Silva,65,819000,9895681198094619,321,2987835,2364673,2365,2362308
17115,Jorja Fox,30,2276400,9756716446049302,247,3861713,596013,597,595416
17116,Rocío,44,3383100,6584502480819840,369,5035533,1648784,165,1648619
17117,Josie Green,64,2387600,3809631792767053,471,5135615,3656194,36562,3619632
17118,Sophie Hirst,36,2023200,6627665776164386,253,3626605,202910,202910,0
17119,Miku Ito,22,2675500,6529697755887030,208,3546993,1597605,160,1597445
17120,Hannah Johann,69,2229000,8546141166396142,486,5627118,4019724,4020,4015704
17121,Kedie Johnson,31,1972900,3870240049259934,219,2984410,2060284,206029,1854255
17122,Carrie Jones,58,2710000,4007299257844540,466,5670237,2077674,20777,2056897
17123,Weronika Kaczor,59,1296000,6395234685084668,281,2965412,2815648,2815648,0
17124,Lauren Kozal,59,1603000,6076489740410360,376,4159360,3238788,32388,3206400
17125,Francisca Lara,50,4213500,6320946570965813,482,7204176,5482316,0,5482316
17126,Patricia Larqué,36,4126500,8799246093510878,393,6310757,651140,65114,586026
17127,Claire Lelarge,35,638500,9673483293890471,111,1115278,301921,3020,298901
17128,Sofie Lundgaard,26,1634800,3158781598224658,174,2606956,2473929,24740,2449189
17129,Inès Marques,46,1972300,5561103342329304,270,3485414,1497384,1497384,0
17130,Brianna Martinez,27,2341100,6271937317202423,200,3022211,271037,2711,268326
17131,Garazi,50,2244500,9122947878678483,380,4963232,4859022,485903,4373119
17132,Sophie Nachtigall,59,4108100,6495035668272428,542,7493893,1395629,1395629,0
17133,Jade Nassi,22,4656400,4986745238817623,396,6799667,5634608,0,5634608
17134,Bárbara Olivieri,24,4356200,4036058422486460,393,6347686,1523222,15233,1507989
17135,Livia Peng,26,4526800,7369033724437214,326,5818496,4914669,492,4914177
17136,Mia Persson,25,830500,7392315257715879,107,1219755,75610,75610,0
17137,Marie Petiteau,60,3750900,3348995676729760,517,7130667,3203439,32035,3171404
17138,Rhiannon Roberts,35,4388100,9762144633989622,383,6116027,2649988,0,2649988
17139,Gabrielle Robinson,70,1585700,9192750044486543,382,3969835,2095879,210,2095669
17140,Jeleaugh Rosa,54,479100,6425148565517029,232,1809271,222930,223,222707
17141,María Ruiz,68,4261000,6209502437721331,620,7702522,1125987,113,1125874
17142,Kristen Scott,58,2019300,3563650367914656,371,4344918,2564326,256433,2307893
17143,Maëlle Seguin,40,2638500,9998514674136145,363,4736680,652998,652998,0
17144,Lena Silano,27,4626700,5145073004971827,373,6572632,1071986,0,1071986
17145,Jordan Silkowitz,38,1802800,8831239027934665,211,2917961,380927,0,380927
17146,Kim Sindermann,22,793100,6186331697979867,58,790757,97931,97931,0
17147,Alexa Spaanstra,32,341500,3254472708218337,86,585036,486511,4866,481645
17148,Madeleine Steck,55,4900100,4511436133768854,592,8644367,3382361,3383,3378978
17149,Emily Syme,46,4113600,3849044531266915,420,6637094,1409409,140941,1268468
17150,Maisie Symonds,51,1371900,5002979363305012,311,3218425,2404239,240424,2163815
17151,Javiera Toro,64,991700,4360076350038959,346,3003071,1463981,1463981,0
17152,Nikita Tromp,40,3705500,7925671857905465,393,5396734,4378305,437831,3940474
17153,Élisabeth Tsé,50,4696100,7681469674817234,543,7875410,1803218,181,1803037
17154,Mirari Uria,53,2594800,5604278519881010,369,4586435,83430,0,83430
17155,Naroa,42,4528800,3414736901604227,480,7683468,6201290,6202,6195088
17156,Lina von Schrader,55,4910500,8211205183290022,604,9081383,3585776,359,3585417
17157,Sandra Walbeck,30,4866800,4754081103121382,492,7451562,4653210,0,4653210
17158,Ilayda Acikgöz,39,1651200,5072945044386405,215,2896629,2267674,0,2267674
17159,Dilara Acikgöz,67,3993000,7494564131450647,556,7457417,4692855,4692855,0
17160,Julia Aguado,64,309300,4877062809870348,250,1994686,1965943,197,1965746
17161,Amanda Allen,59,3467000,5790079584063285,505,6657619,6176515,617652,5558863
17162,Angelina Anderson,51,3793000,7435266898778834,511,7017286,5160602,51607,5108995
17163,Laurine Baga,43,2042500,9711030721790018,274,3570281,3119071,311908,2807163
17164,Nele Bauereisen,52,4373000,3559246267750507,531,7570124,7277695,0,7277695
17165,Cyrine Ben Rabah,34,518600,7813929271276874,126,1077619,554546,55455,499091
17166,Messiah Bright,43,3396000,9164137590039532,398,5609139,4910707,4910707,0
17167,Shana Chossenotte,59,1614000,3368662281711085,328,3404728,3403943,3404,3400539
17168,Jenna Clark,49,1970400,4364641959367655,299,3703824,155839,1559,154280
17169,Sierra Enge,34,2002800,5869252700676837,226,3131559,2739020,273902,2465118
17170,Sami Feller,70,2871900,6987050002140162,472,5615955,1428988,14290,1414698
17171,Yenifer Giménez,54,1671000,8633662517320265,334,3438961,2740323,2741,2737582
17172,Vanessa Haim,65,4285800,5363556167620085,626,8419888,6812431,0,6812431
17173,Jyllissa Harris,53,3357000,6033395515255254,461,5836321,4864132,4864132,0
17174,Shae Holmes,70,3550900,4669876326054527,500,6669982,2020732,0,2020732
17175,Korina Janez,25,2152600,7517939387915175,146,2585135,2533234,254,2532980
17176,Emely Joester,54,1646900,3508112452236248,307,3384307,994534,99454,895080
17177,Sanja Kovačević,54,2338000,8532529562303975,400,4880263,2319767,2319767,0
17178,Emma Kusch,65,3464400,6012218986472838,513,6446838,2691828,0,2691828
17179,Julia Landenberger,62,3362400,4391267565014086,505,6030266,3939706,39398,3900308
17180,Cristina Librán,29,348600,5863613469889844,93,699368,579240,580,578660
17181,Bárbara López,37,762000,5396949622616932,183,1880872,1446618,14467,1432151
17182,Irene Miguélez,22,500600,3955419393087618,52,476148,475879,0,475879
17183,Elena Mühlemann,45,4689800,5334089627952277,529,7617339,6537568,0,6537568
17184,Amy Muir,30,4788400,6887158233985270,454,7339130,847491,848,846643
17185,Laura Muller,26,625000,5183930169531887,69,726246,38725,38725,0
17186,Anna Oskarsson,52,1593400,5247162904562304,322,3383693,347834,34784,313050
17187,Lena Pauels,36,1981000,7823860370508391,228,3166524,892364,0,892364
17188,María Pérez,63,1545800,9196971210919232,366,3873945,174359,17436,156923
17189,Eva Van Deursen,70,4802300,3256433924786504,722,9681470,6659893,6659893,0
17190,Jella Veit,45,660500,3816781720738885,204,1752830,1347885,0,1347885
17191,Agnes Beever-Jones,37,1426400,5848656650796043,174,2329632,689334,690,688644
17192,Rylan Childers,60,4187500,3941227218040831,508,7685083,7083091,709,7082382
17193,Shannon Cooke,31,1396300,4919642235738696,149,1923384,791815,791815,0
17194,Anouk Denton,32,3915400,3103547691077394,403,6275120,4125426,413,4125013
17195,Emma Francart,57,507500,6913941192869312,264,2107678,1433750,1434,1432316
17196,Elze Huls,61,2233400,3397150008783438,416,5005389,3559870,3559870,0
17197,Mathilde Janzen,38,1103800,8211565436732649,175,2037605,1364103,136411,1227692
17198,Fenna Kalma,50,3455200,9324355434807972,429,6350256,1913130,19132,1893998
17199,Janou Levels,42,4564300,5920130590611213,510,7202662,6576613,65767,6510846
17200,Tere,43,2606800,8866314944102122,345,4941488,3462836,0,3462836
17201,Lorena Navarro,35,1220400,3774734657901716,200,2297987,154170,15417,138753
17202,Courtney Nevin,51,4168100,8605134981186181,508,6904255,4299423,0,4299423
17203,Beatriz Nogueira,30,3613900,7449272441560488,377,5365826,669084,6691,662393
17204,Paulina Nyström,38,4502800,9301326533353918,445,7232264,2954069,296,2953773
17205,Marina Rivas,62,2423500,3664239112854992,438,5446816,267589,0,267589
17206,Marleen Schimmer,70,4268200,9606309575243950,570,8189096,897811,8979,888832
17207,Ally Schlegel,22,3547700,7531698702809812,255,4392951,1800728,1800728,0
17208,Lilith Schmidt,51,4319000,9818295449935611,538,7676784,2723773,0,2723773
17209,Gina Schüller,40,2988900,8021177729032400,359,5200688,4208126,4208126,0
17210,Iris Stiekema,53,3245500,9584914377604689,417,5856355,4735286,0,4735286
17211,Manssita Traoré,51,1799700,7161810713987412,325,3757514,3573721,358,3573363
17212,María Valle,49,4600600,4080664469020325,500,7579966,1602576,0,1602576
17213,Jonna van de Velde,31,4545300,8998348364823328,405,6712931,3971520,0,3971520
17214,Nerea Vicente,66,3611400,4314377235086792,582,7331802,406693,4067,402626
17215,Sofie Zdebel,44,2666800,4517545488638035,367,4855220,4807225,4807225,0
17216,Carmen Álvarez,66,3771100,9759286441010606,587,7635441,7574641,758,7573883
17217,Brooke Aspin,43,2278400,6146856631529266,313,4298196,321206,32121,289085
17218,Viola Avduli,53,2914800,3863884749722088,390,5580362,3782001,37821,3744180
17219,Emma Bissell,49,778800,5100966927540895,234,2322129,2155441,21555,2133886
17220,Hannah Cain,67,4395200,8931755609286835,586,8242471,709727,0,709727
17221,Giovanna DeMarco,27,3515400,6019260568260726,275,5155856,4323721,433,4323288
17222,Victoria Ezebinyuo,55,1655200,7422645050839824,393,4119352,2786666,2786666,0
17223,Martina Fernández,23,4396300,8351406908514507,401,6361324,1763376,0,1763376
17224,Lindsi Jennings,30,871800,8940288024588008,111,1293739,527201,527201,0
17225,Naomi Layzell,39,4039500,9370013185019876,468,7383395,6463732,6463732,0
17226,Simone Magill,41,569100,4970810823530251,189,1761344,1150918,11510,1139408
17227,Nina Ngueleu,48,414500,9133961156961586,218,1641287,1559151,15592,1543559
17228,Wassilah Pacaud,52,741100,3647029338932442,216,2071849,508642,508642,0
17229,Amy Rodgers,58,3505800,9658464925661140,440,6061360,4368509,4369,4364140
17230,Jessie Stapleton,34,3787800,8682263298078751,408,5865886,35709,358,35351
17231,Miriaél Taylor,55,1617100,5277383172582441,319,3523949,2487978,249,2487729
17232,Océane Toussaint,45,2637000,6120467938001620,330,4474472,406187,4062,402125
17233,Carolina Vilão,50,3594600,8617667078125700,460,6379717,4487043,0,4487043
17234,Lucy Watson,34,1579800,6042370797279894,213,2620101,2555039,2556,2552483
17235,Emily Whelan,43,2017600,8771661923845785,284,3462637,2673004,268,2672736
17236,Clara Wibaut,57,1945400,5572291245860968,390,4498053,913974,9140,904834
17237,Nadja Burkard,48,2741500,3347165283474040,363,4801644,688532,0,688532
17238,Madelyn Desiano,34,2027600,5503976927762831,209,2903610,833947,8340,825607
17239,Pilar Garrote,55,2324000,6155518455692756,355,4142391,2004927,0,2004927
17240,Amandine Herbert,41,4129100,9724924489129910,447,6924081,2877866,28779,2849087
17241,Sophie Jones,50,2158000,6717359852671680,381,4325677,105007,105007,0
17242,Ruby Mace,66,4813500,4213795773975089,671,8660170,3379186,33792,3345394
17243,Olivia McLoughlin,41,4985600,7041579011670958,568,8702317,6215336,6215336,0
17244,Annabel Schasching,57,2928900,8451036485926256,440,5850361,5171057,0,5171057
17245,Imane Touriss,34,1487200,6534740377556801,182,2234596,942489,0,942489
17246,Regina van Eijk,63,3227300,6264065368572074,494,6126531,3931307,3931307,0
17247,Summer Yates,40,1496200,6345916680801220,234,2682843,1815977,1816,1814161
17248,Taylor Beitz,39,2345500,9364530814833294,320,4216582,2956785,29568,2927217
17249,Noemi Benz,28,4424100,6569218162579626,399,6434987,4084953,4085,4080868
17250,Emilie Bernhardt,64,2316400,7745921232400138,404,4950878,848995,0,848995
17251,Jasmine Bull,28,4709700,6415763410809505,427,7076071,6592611,65927,6526684
17252,Ivonne Chacón,40,3411400,7094444032671032,396,5514404,3836817,3836817,0
17253,Adèle Connesson,32,3688100,3078067638518812,344,5656143,82222,823,81399
17254,Marie Dehri,40,3788200,4374752266669243,410,6424010,1426305,0,1426305
17255,Núria Escoms,66,3291600,3246408407679626,565,6677802,5432237,0,5432237
17256,Bascu,31,3191800,7493577553683745,299,4979617,2074864,208,2074656
17257,Claire Falknor,51,4772600,5689320087037785,530,7995121,4906214,4907,4901307
17258,Nerea Gantxegui,31,2462500,6635829014677156,258,3617763,1287191,12872,1274319
17259,Missy Goodwin,35,3751200,4019647724908757,392,6192967,2699621,2699621,0
17260,Vera Rico,65,4645500,4716995103856947,693,8931213,4650450,0,4650450
17261,Alejandra Serrano,22,320100,3954947361783366,18,75515,36299,36299,0
17262,Bea Sprung,35,2762300,7466776544966422,275,4073244,2274719,227472,2047247
17263,Katie Startup,30,427900,3754392622678808,79,616057,70345,70345,0
17264,Sandra Villafañe,55,1314300,9701145156966852,290,2937308,1577631,158,1577473
17265,Jesse Woolley,70,3550400,5955435989779619,605,7395145,2025133,2025133,0
17266,Lou Autin,34,4721900,9417827341900111,474,7801818,4256787,426,4256361
17267,Mia Eickmann,51,2805800,5798263753786201,413,5269404,3554766,0,3554766
17268,Elena Gil,38,3369700,4099407559059752,359,5374774,2740800,0,2740800
17269,Teyah Goldie,60,841900,9493785049433334,287,2726965,916316,0,916316
17270,Lucía Gómez,46,3567200,7642716327329865,431,6068650,3881655,3882,3877773
17271,Sara López,60,2984600,6960505796362810,479,6126728,3869752,3870,3865882
17272,Thais Reiss,59,4734400,8863258497454821,637,8817662,5133289,5133289,0
17273,Marina Scholz,29,1343600,9215381556249382,148,2149323,1878365,187837,1690528
17274,Paula Vizoso,27,3388700,5200649875141380,306,5442375,4937572,0,4937572
17275,Daniela Arques,53,664900,6269257582598600,265,2228544,331495,331495,0
17276,Sophie Baggaley,38,920500,6428812521164569,181,1735261,982098,0,982098
17277,Loreen Bender,62,1178400,5232662872982213,317,3069316,2080936,2080936,0
17278,Aude Bizet,56,3168200,9608777365660545,460,6105433,3466904,347,3466557
17279,Léa Bourgain,27,3609100,4884456361136923,307,5490225,5242019,5242019,0
17280,Erin Clachers,60,447300,3486225338121763,305,2367524,998654,100,998554
17281,Maria Gabaldón,54,4767600,5232912465910392,534,8560687,1236514,1237,1235277
17282,Vero Herrera,36,400300,8487732484717101,120,945792,203785,2038,201747
17283,Amaia Martínez,28,327000,7639535222222496,53,363145,176893,1769,175124
17284,Serena Queirós,50,4414500,6202990972620519,533,7252335,942131,943,941188
17285,Evie Rabjohn,46,2280900,3965377464799835,277,3935289,1109944,11100,1098844
17286,Kristýna Růžičková,54,2124900,8058700611508075,308,3809433,91934,91934,0
17287,Sanadri,29,2706200,8855245345734734,250,3957110,1236211,0,1236211
17288,Liced Serna,29,2672900,8262355465643387,253,4117486,1459227,14593,1444634
17289,Jessica Simpson,37,3329900,7397923726601934,337,4845520,4427432,44275,4383157
17290,Louann Archier,41,2856900,6762662027893518,360,4966896,604103,6042,598061
17291,Jonna Brengel,62,387400,4202111264770700,264,2227705,181598,0,181598
17292,Khiara Keating,30,625300,5759170517105884,106,1052832,809769,0,809769
17293,Lucy Parry,33,2019400,9986051086049808,231,3278912,132290,132290,0
17294,Valéryane Policnik,53,2567300,8793271375467248,387,4878691,1515701,1515701,0
17295,Laura Pucks,23,4286800,6260217831499492,329,6163279,3484080,348408,3135672
17296,Melina Walheim,27,1932200,6791596978771914,186,2725106,1853098,186,1852912
17297,Kenzie Weir,30,1362700,4537716553026530,142,1920424,289332,290,289042
17298,Mia Werner,29,1071200,3907792328654542,130,1638677,604255,0,604255
17299,Zoe Werner,23,4025100,5288160806183306,328,6109479,216823,0,216823
17300,Féerine Belhadj,52,312100,9357310714771889,181,1429368,230529,0,230529
17301,Soledad Belotto,22,4171000,5935611870054833,285,5670175,3877921,0,3877921
17302,Chancelle Effa Effa,33,1803800,7558878403628870,199,2843545,1244828,0,1244828
17303,Liana Joseph,31,2371800,7430917336330089,248,3761558,104567,10457,94110
17304,Anne Moll,69,1625600,3237811363434384,444,4603873,4596908,45970,4550938
17305,Lily Reimöller,61,1282300,6652488542904243,350,3842874,3208149,321,3207828
17306,Alba Ruiz,57,4914100,7585911381074605,633,9077707,8258045,0,8258045
17307,Kyra Spitzner,29,2012800,7210561215381366,172,2717277,2607650,260765,2346885
17308,Ophélie Chaudier,36,380700,7604561972526270,106,890992,822194,0,822194
17309,María Jiménez,27,2321600,4514584118188558,217,3455291,1751055,1751055,0
17310,Alice Marques,53,2057700,5176994822991991,321,3769890,994534,99454,895080
17311,Lidia Sánchez,23,1089900,5387871402006902,86,1337298,105032,0,105032
17312,Hannah Silcock,32,3534900,9115970162678680,368,5489869,2727512,273,2727239
17313,Chiara Hahn,63,4896800,5484449767177578,592,8181288,5593128,55932,5537196
17314,Eleanor Heeps,25,728200,3987319440870505,64,794268,9923,993,8930
17315,Gracie Pearse,25,2884600,4229383119627607,259,4221300,3864262,387,3863875
17316,Monique Robinson,31,4333200,6691584087780579,435,6387993,1719332,1720,1717612
17317,Wassa Sangare,62,1361100,8449503293500289,357,3796223,1484002,14841,1469161
17318,Julie Swierot,68,1562000,9396979401012392,459,4281591,3542856,0,3542856
17319,Alexane Gery,24,4312100,8520539907016555,334,5918064,4547229,0,4547229
17320,Tereza Fuchsová,37,2576600,4199331786110332,299,3983707,1467203,14673,1452530
17321,Kateřina Vithová,36,2701900,7328791966530860,282,4262993,4047190,0,4047190
17322,Lucie Bendová,59,4579600,5291984612004631,595,8354437,2161343,0,2161343
17323,Aleigh Gambone,35,1508800,8450869590240302,209,2669507,1338986,1339,1337647
17324,Joy Lysser,44,928500,3176890049956119,245,2503990,1776143,178,1775965
17325,Soraya Wulff,24,4900000,8463936467743179,447,7112732,3393228,0,3393228
